chr	start	end	id	score	size	phits	ghits	ohits	type
1	11149	11522	MACS_peak_1	2188.98	373	0	0	0	intergen
1	74437	74818	MACS_peak_3	52.67	381	0	0	0	intergen
1	91267	91646	MACS_peak_4	732.21	379	0	0	1	other
1	104792	105111	MACS_peak_5	311.24	319	0	0	1	other
1	105360	105727	MACS_peak_6	201.59	367	0	0	1	other
1	138946	139307	MACS_peak_7	492.78	361	0	0	0	intergen
1	140190	140427	MACS_peak_8	1080.42	237	0	0	0	intergen
1	267835	268241	MACS_peak_9	793.16	406	0	0	1	other
1	281471	281675	MACS_peak_10	381.61	204	0	0	1	other
1	281924	282291	MACS_peak_11	201.59	367	0	0	1	other
1	498799	499036	MACS_peak_12	651.74	237	0	0	1	other
1	495392	495629	MACS_peak_13	376.34	237	0	0	1	other
1	494148	494509	MACS_peak_14	458.95	361	0	0	1	other
1	449527	449927	MACS_peak_15	412.5	400	1	0	1	promoter
1	435592	435937	MACS_peak_16	163.66	345	0	0	1	other
1	434322	434758	MACS_peak_17	62.51	436	0	0	1	other
1	430164	430427	MACS_peak_19	251.36	263	0	0	1	other
1	402518	402803	MACS_peak_20	1013.15	285	0	0	1	other
1	369811	370080	MACS_peak_22	127.5	269	0	0	1	other
1	357228	357623	MACS_peak_23	1112.78	395	0	0	1	other
1	586000	586395	MACS_peak_24	1722.91	395	0	0	0	intergen
1	638271	638708	MACS_peak_27	402.39	437	0	0	1	other
1	665905	666168	MACS_peak_28	329.3	263	0	0	1	other
1	670571	670916	MACS_peak_29	168.95	345	0	0	1	other
1	684503	684903	MACS_peak_30	412.5	400	1	0	1	promoter
1	709694	710032	MACS_peak_31	129.29	338	0	0	1	other
1	729024	729415	MACS_peak_32	281.41	391	0	0	2	other
1	730298	730535	MACS_peak_33	383.96	237	0	0	2	other
1	737113	737350	MACS_peak_34	833.25	237	0	0	2	other
1	740529	740766	MACS_peak_35	797.19	237	0	0	2	other
1	754453	754823	MACS_peak_36	194.41	370	0	0	2	other
1	788681	788880	MACS_peak_37	102.63	199	0	0	2	other
1	790647	791115	MACS_peak_39	172.15	468	0	0	2	other
1	791244	791720	MACS_peak_40	197.74	476	0	0	2	other
1	857883	858216	MACS_peak_41	793.64	333	0	0	1	other
1	1443392	1443724	MACS_peak_42	220.37	332	0	0	0	intergen
1	1681979	1682119	MACS_peak_43	275.54	140	0	1	0	gen
1	2174377	2174590	MACS_peak_44	596.79	213	0	1	0	gen
1	2364351	2364639	MACS_peak_45	103.45	288	0	1	0	gen
1	3254892	3255248	MACS_peak_46	80.17	356	0	1	0	gen
1	3621301	3621482	MACS_peak_47	1569.18	181	1	0	0	promoter
1	3724546	3724726	MACS_peak_48	746.04	180	0	1	0	gen
1	3801606	3801829	MACS_peak_49	1180.64	223	0	0	0	intergen
1	3849254	3849393	MACS_peak_50	1043.77	139	0	1	0	gen
1	5075519	5075919	MACS_peak_52	504.65	400	0	0	0	intergen
1	5115830	5116135	MACS_peak_53	184.68	305	0	0	0	intergen
1	5745899	5746114	MACS_peak_55	746.04	215	0	0	0	intergen
1	5825012	5825390	MACS_peak_56	129.87	378	0	0	0	intergen
1	6343512	6343735	MACS_peak_57	712.32	223	0	1	0	gen
1	6404702	6405010	MACS_peak_58	473.53	308	0	0	0	intergen
1	6742514	6742846	MACS_peak_59	542.96	332	0	0	0	intergen
1	6998275	6998617	MACS_peak_60	420.18	342	0	1	0	gen
1	7042813	7043094	MACS_peak_61	453.96	281	0	1	0	gen
1	7070426	7070703	MACS_peak_62	456.44	277	0	1	0	gen
1	7414707	7415085	MACS_peak_63	65.66	378	0	1	0	gen
1	7647244	7647522	MACS_peak_64	709.17	278	0	1	0	gen
1	7667423	7667884	MACS_peak_65	825.38	461	0	1	0	gen
1	7808412	7808703	MACS_peak_66	312.33	291	0	1	0	gen
1	7967141	7967350	MACS_peak_67	780.06	209	0	1	0	gen
1	8031286	8031506	MACS_peak_68	564.54	220	0	0	1	other
1	8277747	8277980	MACS_peak_69	538.37	233	0	0	0	intergen
1	8561116	8561391	MACS_peak_70	1128.24	275	0	1	0	gen
1	8823296	8823434	MACS_peak_71	831.96	138	0	0	0	intergen
1	9116053	9116446	MACS_peak_73	953.02	393	0	1	0	gen
1	9181304	9181568	MACS_peak_74	590.39	264	0	0	1	other
1	9206690	9206956	MACS_peak_75	201.59	266	0	0	0	intergen
1	9536450	9536671	MACS_peak_76	432.48	221	1	0	0	promoter
1	9624718	9624853	MACS_peak_77	1143.32	135	0	0	0	intergen
1	10428138	10428392	MACS_peak_79	596.79	254	2	0	0	promoter
1	10507521	10507787	MACS_peak_80	463.44	266	0	1	0	gen
1	11086620	11086991	MACS_peak_81	228.35	371	0	1	0	gen
1	11337637	11337810	MACS_peak_82	780.06	173	0	0	0	intergen
1	11642461	11642648	MACS_peak_83	901.33	187	0	1	1	gen
1	11954303	11954502	MACS_peak_84	809.56	199	0	1	0	gen
1	12106890	12107269	MACS_peak_85	402.61	379	0	1	0	gen
1	12936314	12936672	MACS_peak_86	1314.22	358	1	0	0	promoter
1	13265113	13265430	MACS_peak_88	1220.3	317	0	0	0	intergen
1	13277046	13277283	MACS_peak_89	516.86	237	1	0	0	promoter
1	13354644	13354867	MACS_peak_90	712.32	223	0	0	0	intergen
1	13543934	13544206	MACS_peak_92	449.74	272	0	0	0	intergen
1	13828894	13829124	MACS_peak_93	831.63	230	0	0	0	intergen
1	14417988	14418139	MACS_peak_94	511.88	151	0	1	0	gen
1	14727361	14727593	MACS_peak_95	197.5	232	0	1	0	gen
1	15323590	15323850	MACS_peak_96	725.38	260	0	1	0	gen
1	15638419	15638555	MACS_peak_97	1358.26	136	0	1	0	gen
1	15792102	15792307	MACS_peak_98	1087.07	205	0	0	0	intergen
1	15833231	15833580	MACS_peak_99	416.71	349	0	0	0	intergen
1	16573281	16573628	MACS_peak_100	113.5	347	0	1	0	gen
1	16579145	16579445	MACS_peak_101	815.33	300	0	1	0	gen
1	16585441	16585741	MACS_peak_102	927.4	300	0	1	0	gen
1	16591715	16592067	MACS_peak_103	694.41	352	0	1	0	gen
1	16609153	16609369	MACS_peak_104	1054.55	216	0	1	0	gen
1	16621066	16621402	MACS_peak_105	734.45	336	0	0	1	other
1	16624931	16625296	MACS_peak_106	1474.76	365	0	0	1	other
1	16656596	16656896	MACS_peak_107	335.48	300	0	0	1	other
1	16684807	16685127	MACS_peak_108	1029.07	320	0	0	1	other
1	16750571	16750871	MACS_peak_109	562.58	300	0	1	1	gen
1	16951709	16951925	MACS_peak_110	580.62	216	0	1	0	gen
1	17419828	17420134	MACS_peak_111	439.28	306	0	1	0	gen
1	17485336	17485603	MACS_peak_112	418.12	267	0	0	0	intergen
1	18100559	18100799	MACS_peak_113	645.81	240	0	0	0	intergen
1	18502737	18502987	MACS_peak_114	288.88	250	0	0	0	intergen
1	18510434	18510621	MACS_peak_115	901.33	187	0	0	0	intergen
1	18581534	18581794	MACS_peak_116	725.38	260	0	0	0	intergen
1	18820837	18821164	MACS_peak_117	546.09	327	0	0	0	intergen
1	20100972	20101209	MACS_peak_118	814.37	237	0	0	0	intergen
1	20151504	20151801	MACS_peak_119	127.5	297	0	0	0	intergen
1	20259500	20259637	MACS_peak_120	1420.82	137	0	0	0	intergen
1	20522317	20522622	MACS_peak_121	497.03	305	0	0	0	intergen
1	20665211	20665513	MACS_peak_122	506.92	302	1	0	0	promoter
1	20907867	20908219	MACS_peak_123	86.75	352	0	1	0	gen
1	21084691	21084943	MACS_peak_124	565.32	252	0	1	0	gen
1	21179782	21180257	MACS_peak_125	554.67	475	0	0	0	intergen
1	21370443	21370860	MACS_peak_126	611.54	417	0	0	0	intergen
1	21694568	21694710	MACS_peak_127	384.6	142	0	1	0	gen
1	21701360	21701500	MACS_peak_128	1136.75	140	0	1	0	gen
1	22674250	22674416	MACS_peak_129	831.63	166	0	0	0	intergen
1	22889272	22889574	MACS_peak_130	441.54	302	0	1	0	gen
1	23228552	23228765	MACS_peak_131	149.72	213	0	0	0	intergen
1	23703589	23703906	MACS_peak_132	552.5	317	0	0	0	intergen
1	23772166	23772389	MACS_peak_133	564.54	223	0	0	1	other
1	24390073	24390417	MACS_peak_134	784.68	344	0	1	0	gen
1	24527260	24527498	MACS_peak_135	1264.23	238	0	1	0	gen
1	24635290	24635555	MACS_peak_136	464.09	265	1	0	0	promoter
1	24766373	24766608	MACS_peak_137	329.35	235	0	1	0	gen
1	24830757	24831122	MACS_peak_138	362.15	365	0	1	0	gen
1	24898172	24898424	MACS_peak_139	613.82	252	1	0	0	promoter
1	25289966	25290310	MACS_peak_140	419.18	344	0	2	0	gen
1	25403058	25403409	MACS_peak_141	415.73	351	0	1	0	gen
1	25412607	25412946	MACS_peak_142	482.54	339	0	1	0	gen
1	25507792	25508094	MACS_peak_143	92.78	302	0	0	0	intergen
1	25508540	25508743	MACS_peak_144	145.08	203	0	0	0	intergen
1	25796891	25797192	MACS_peak_145	442.11	301	1	0	0	promoter
1	25998208	25998383	MACS_peak_146	780.06	175	0	0	0	intergen
1	26035916	26036263	MACS_peak_147	417.69	347	1	1	0	promoter
1	26164253	26164508	MACS_peak_148	596.79	255	1	0	0	promoter
1	26332914	26333053	MACS_peak_149	1309.64	139	0	1	0	gen
1	26363858	26364154	MACS_peak_150	566.68	296	1	0	0	promoter
1	26399602	26399961	MACS_peak_151	734.33	359	0	0	0	intergen
1	26488429	26488729	MACS_peak_152	427.96	300	0	0	0	intergen
1	26602213	26602642	MACS_peak_153	767.78	429	0	0	0	intergen
1	26878026	26878314	MACS_peak_154	700.62	288	1	0	0	promoter
1	26997648	26997903	MACS_peak_155	596.79	255	1	0	0	promoter
1	27198031	27198201	MACS_peak_156	879.24	170	0	0	0	intergen
1	27284810	27285064	MACS_peak_157	1317.49	254	0	1	0	gen
1	27556759	27557047	MACS_peak_158	572.35	288	0	1	0	gen
1	27669177	27669561	MACS_peak_159	754.42	384	1	0	0	promoter
1	27672268	27672610	MACS_peak_160	420.18	342	0	0	1	other
1	28006676	28006885	MACS_peak_161	558.17	209	0	1	0	gen
1	28409805	28409994	MACS_peak_162	1129.71	189	0	1	0	gen
1	28640868	28641158	MACS_peak_163	448.52	290	0	1	0	gen
1	28695856	28696077	MACS_peak_164	237.59	221	0	1	0	gen
1	28792787	28793014	MACS_peak_165	695.57	227	0	0	0	intergen
1	28851828	28852132	MACS_peak_166	142.05	304	0	1	0	gen
1	28877234	28877530	MACS_peak_167	542.62	296	0	0	0	intergen
1	29245878	29246105	MACS_peak_168	695.57	227	0	1	0	gen
1	29269746	29269934	MACS_peak_169	695.57	188	0	1	0	gen
1	29773907	29774291	MACS_peak_170	972.38	384	0	0	1	other
1	29997287	29997662	MACS_peak_171	79.24	375	0	0	0	intergen
1	30309150	30309540	MACS_peak_173	89.02	390	0	0	0	intergen
1	30455010	30455318	MACS_peak_174	137.06	308	0	0	0	intergen
1	30496063	30496516	MACS_peak_175	78.44	453	0	0	0	intergen
1	30567745	30568051	MACS_peak_176	270.85	306	0	0	0	intergen
1	31663926	31664194	MACS_peak_178	462.14	268	0	1	0	gen
1	32066055	32066199	MACS_peak_179	392.74	144	0	0	1	other
1	32109480	32109695	MACS_peak_180	799.34	215	1	0	0	promoter
1	32215701	32216058	MACS_peak_181	399.64	357	1	1	0	promoter
1	32520352	32520710	MACS_peak_182	2805.6	358	0	1	0	gen
1	32524193	32524648	MACS_peak_183	260.52	455	0	1	0	gen
1	32581070	32581419	MACS_peak_184	887.47	349	0	2	0	gen
1	33194427	33194562	MACS_peak_185	1079.97	135	0	0	0	intergen
1	33675304	33675683	MACS_peak_186	57.46	379	0	1	0	gen
1	33833315	33833647	MACS_peak_187	62.38	332	0	1	0	gen
1	34096997	34097399	MACS_peak_188	75.85	402	0	1	0	gen
1	34255973	34256306	MACS_peak_189	123.2	333	0	0	0	intergen
1	34419803	34420106	MACS_peak_190	561.84	303	0	0	0	intergen
1	34549226	34549468	MACS_peak_191	501.16	242	0	0	0	intergen
1	34852702	34853018	MACS_peak_193	808.09	316	0	1	0	gen
1	34866417	34866631	MACS_peak_194	596.79	214	1	0	0	promoter
1	34955907	34956285	MACS_peak_195	69.86	378	0	0	0	intergen
1	35025363	35025700	MACS_peak_196	603.02	337	0	2	0	gen
1	35260765	35261082	MACS_peak_197	578.24	317	0	0	0	intergen
1	35274610	35274745	MACS_peak_198	702.09	135	0	1	0	gen
1	36149559	36149840	MACS_peak_199	453.96	281	0	1	0	gen
1	36544545	36545008	MACS_peak_200	534.92	463	0	0	0	intergen
1	36650540	36650742	MACS_peak_201	645.81	202	0	0	0	intergen
1	37209335	37209637	MACS_peak_202	75.54	302	0	0	0	intergen
1	37919368	37919591	MACS_peak_203	866.35	223	0	1	0	gen
1	37970423	37970740	MACS_peak_204	76.3	317	0	1	0	gen
1	37971799	37972153	MACS_peak_205	175.85	354	0	1	0	gen
1	38562619	38562757	MACS_peak_206	960.73	138	0	0	0	intergen
1	38683478	38683612	MACS_peak_207	1666.76	134	0	0	0	intergen
1	39606234	39606628	MACS_peak_208	563.18	394	0	0	0	intergen
1	39799809	39800062	MACS_peak_209	470.06	253	0	0	1	other
1	39853286	39853582	MACS_peak_210	445	296	0	1	0	gen
1	39973476	39973831	MACS_peak_211	631.61	355	0	0	0	intergen
1	40024462	40024653	MACS_peak_212	856.26	191	0	0	0	intergen
1	40032338	40032595	MACS_peak_213	542.24	257	0	0	0	intergen
1	40084765	40084944	MACS_peak_214	954.29	179	0	1	0	gen
1	40183026	40183264	MACS_peak_215	662.31	238	0	1	0	gen
1	40197729	40197933	MACS_peak_216	511.85	204	0	1	0	gen
1	40246699	40247020	MACS_peak_217	429.01	321	1	0	0	promoter
1	40367185	40367479	MACS_peak_218	50.35	294	0	1	0	gen
1	40668937	40669328	MACS_peak_219	1006.73	391	0	0	0	intergen
1	40948983	40949226	MACS_peak_220	645.81	243	0	0	0	intergen
1	41083838	41084267	MACS_peak_221	119.37	429	0	1	0	gen
1	41117203	41117439	MACS_peak_222	1326.27	236	0	1	0	gen
1	41854835	41855216	MACS_peak_223	157.92	381	0	1	0	gen
1	41993606	41993974	MACS_peak_225	182.81	368	0	1	0	gen
1	42095347	42095730	MACS_peak_226	95.04	383	0	0	0	intergen
1	42233273	42233628	MACS_peak_227	54.01	355	0	1	0	gen
1	42344333	42344653	MACS_peak_228	306.6	320	0	0	0	intergen
1	42494973	42495307	MACS_peak_229	81.46	334	0	1	0	gen
1	42709055	42709277	MACS_peak_230	1528.09	222	0	0	0	intergen
1	43917396	43917753	MACS_peak_231	721.05	357	0	2	0	gen
1	44036678	44037052	MACS_peak_232	637.63	374	0	0	1	other
1	44092243	44092471	MACS_peak_233	655.31	228	0	0	1	other
1	44361463	44361747	MACS_peak_234	452.13	284	0	0	0	intergen
1	44595241	44595456	MACS_peak_235	596.79	215	0	1	0	gen
1	44653006	44653253	MACS_peak_236	485.56	247	0	1	0	gen
1	44796097	44796570	MACS_peak_238	2431.95	473	1	0	0	promoter
1	44835911	44836262	MACS_peak_239	531.49	351	0	1	0	gen
1	45300383	45300572	MACS_peak_240	695.57	189	0	1	0	gen
1	45512650	45512867	MACS_peak_241	901.33	217	1	1	0	promoter
1	45725860	45726154	MACS_peak_242	219.32	294	0	1	0	gen
1	46015846	46016224	MACS_peak_243	53.46	378	0	1	0	gen
1	46016957	46017238	MACS_peak_244	79.34	281	0	1	0	gen
1	46017307	46017645	MACS_peak_245	84.4	338	0	1	0	gen
1	46223513	46223790	MACS_peak_246	564.42	277	0	0	0	intergen
1	46406366	46406745	MACS_peak_247	515.71	379	0	1	0	gen
1	46442689	46442993	MACS_peak_248	440.4	304	0	0	1	other
1	46504793	46505219	MACS_peak_249	77.66	426	1	0	0	promoter
1	46584140	46584526	MACS_peak_250	511.95	386	0	1	0	gen
1	46693899	46694325	MACS_peak_251	202.06	426	0	1	0	gen
1	46725333	46725589	MACS_peak_252	729.14	256	0	0	0	intergen
1	46776361	46776668	MACS_peak_253	823.18	307	0	1	0	gen
1	46836200	46836564	MACS_peak_254	142.05	364	0	0	0	intergen
1	46876073	46876350	MACS_peak_255	928.78	277	0	0	1	other
1	47086402	47086625	MACS_peak_256	224.58	223	0	1	0	gen
1	47091575	47091853	MACS_peak_257	779.89	278	0	1	0	gen
1	47126294	47126599	MACS_peak_258	135.19	305	0	0	1	other
1	47179185	47179396	MACS_peak_259	596.79	211	1	0	0	promoter
1	47192897	47193225	MACS_peak_260	427.34	328	0	0	0	intergen
1	47380145	47380380	MACS_peak_261	468.75	235	0	0	0	intergen
1	47424399	47424684	MACS_peak_262	451.52	285	0	0	0	intergen
1	47436491	47436764	MACS_peak_263	713.56	273	1	0	0	promoter
1	47604366	47604735	MACS_peak_264	123.08	369	0	0	0	intergen
1	47960962	47961335	MACS_peak_265	66.19	373	0	1	0	gen
1	48093651	48093928	MACS_peak_266	335.88	277	0	0	0	intergen
1	48109392	48109686	MACS_peak_267	446.16	294	0	0	1	other
1	48152025	48152237	MACS_peak_268	76.89	212	0	0	1	other
1	48154711	48155056	MACS_peak_269	74.95	345	0	0	1	other
1	48155236	48155588	MACS_peak_270	72.64	352	0	0	1	other
1	48155803	48156169	MACS_peak_271	91.4	366	0	0	1	other
1	48171000	48171207	MACS_peak_272	332.68	207	0	0	1	other
1	49008592	49009038	MACS_peak_274	56.9	446	0	1	0	gen
1	49010280	49010649	MACS_peak_275	51.87	369	0	1	0	gen
1	49011054	49011425	MACS_peak_276	134.63	371	0	1	0	gen
1	49096280	49096670	MACS_peak_277	223.95	390	0	1	1	gen
1	49119051	49119407	MACS_peak_278	148.58	356	0	1	1	gen
1	49259219	49259637	MACS_peak_279	69.43	418	0	1	1	gen
1	49259866	49260178	MACS_peak_280	75.22	312	0	1	1	gen
1	49260314	49260727	MACS_peak_281	55.18	413	0	1	1	gen
1	49261575	49261891	MACS_peak_282	110.45	316	0	1	1	gen
1	49262360	49262721	MACS_peak_283	112.48	361	0	1	1	gen
1	49286396	49286711	MACS_peak_284	58.47	315	0	1	0	gen
1	49287723	49288194	MACS_peak_285	114.16	471	0	1	0	gen
1	49741705	49742010	MACS_peak_286	180.31	305	0	1	0	gen
1	49830778	49831115	MACS_peak_287	157.23	337	0	1	0	gen
1	49877165	49877526	MACS_peak_288	181.72	361	0	1	0	gen
1	49937811	49938179	MACS_peak_289	94.54	368	0	1	0	gen
1	50684255	50684388	MACS_peak_291	1396.21	133	0	1	0	gen
1	50864358	50864796	MACS_peak_292	54.03	438	0	1	0	gen
1	50929492	50929774	MACS_peak_293	453.35	282	0	1	0	gen
1	51024430	51024801	MACS_peak_294	87.62	371	0	0	0	intergen
1	51088510	51088765	MACS_peak_295	596.79	255	0	0	0	intergen
1	51189345	51189678	MACS_peak_296	542.34	333	0	0	0	intergen
1	51192140	51192480	MACS_peak_297	421.18	340	0	0	0	intergen
1	51296903	51297132	MACS_peak_298	695.57	229	0	1	0	gen
1	51769102	51769394	MACS_peak_299	447.34	292	0	1	0	gen
1	52389841	52390056	MACS_peak_300	596.79	215	0	1	0	gen
1	52690456	52690641	MACS_peak_301	650.69	185	0	1	0	gen
1	52748176	52748461	MACS_peak_302	451.52	285	0	1	0	gen
1	52891920	52892301	MACS_peak_304	290.35	381	1	1	0	promoter
1	53361250	53361485	MACS_peak_305	421.83	235	0	0	1	other
1	53854906	53855078	MACS_peak_306	1358.7	172	1	0	0	promoter
1	53959706	53959945	MACS_peak_307	620.13	239	0	1	0	gen
1	55022011	55022325	MACS_peak_308	301.54	314	0	0	0	intergen
1	55702099	55702383	MACS_peak_310	704	284	0	0	1	other
1	56367442	56367872	MACS_peak_311	76.22	430	0	1	1	gen
1	56579622	56579967	MACS_peak_312	418.68	345	0	1	0	gen
1	56642139	56642394	MACS_peak_313	229.22	255	1	1	0	promoter
1	56681227	56681582	MACS_peak_314	127.15	355	0	1	0	gen
1	56820985	56821361	MACS_peak_315	760.2	376	0	0	0	intergen
1	56937857	56938250	MACS_peak_316	748.06	393	0	1	0	gen
1	57606434	57606833	MACS_peak_317	1269.36	399	0	1	0	gen
1	58162978	58163286	MACS_peak_318	684.39	308	0	1	0	gen
1	58374250	58374547	MACS_peak_319	50.92	297	0	1	0	gen
1	58494474	58494765	MACS_peak_320	65.03	291	0	2	0	gen
1	58582578	58582947	MACS_peak_321	58.05	369	0	0	0	intergen
1	58770782	58771186	MACS_peak_322	81.72	404	0	0	1	other
1	59001088	59001254	MACS_peak_323	831.63	166	0	0	1	other
1	59253754	59254110	MACS_peak_324	94.4	356	0	0	1	other
1	59380066	59380423	MACS_peak_325	137.75	357	0	1	0	gen
1	59592231	59592570	MACS_peak_326	138.61	339	0	1	0	gen
1	59612226	59612569	MACS_peak_327	123.63	343	0	1	0	gen
1	59699305	59699496	MACS_peak_328	1061.85	191	0	1	0	gen
1	59947388	59947648	MACS_peak_329	725.38	260	0	0	0	intergen
1	59971299	59971755	MACS_peak_330	707.33	456	0	0	0	intergen
1	60002396	60002680	MACS_peak_331	93.4	284	0	1	0	gen
1	60197784	60198103	MACS_peak_333	432.12	319	0	0	0	intergen
1	60281408	60281634	MACS_peak_335	913.87	226	0	0	0	intergen
1	60379319	60379721	MACS_peak_336	76.98	402	0	0	0	intergen
1	60466007	60466412	MACS_peak_337	104.33	405	0	0	0	intergen
1	60491304	60491550	MACS_peak_338	181.54	246	0	0	0	intergen
1	60494446	60494875	MACS_peak_339	127.77	429	0	0	0	intergen
1	60512803	60513157	MACS_peak_340	100.02	354	0	0	0	intergen
1	60645224	60645536	MACS_peak_341	88.29	312	0	0	0	intergen
1	60782131	60782289	MACS_peak_342	393.44	158	0	0	1	other
1	61659127	61659448	MACS_peak_343	431.05	321	0	0	0	intergen
1	61852249	61852446	MACS_peak_344	662.31	197	0	1	0	gen
1	61925195	61925347	MACS_peak_345	948.91	152	0	1	0	gen
1	62135829	62136087	MACS_peak_346	2384.8	258	0	1	0	gen
1	62144223	62144528	MACS_peak_347	560.48	305	0	1	0	gen
1	62650379	62650613	MACS_peak_348	125.55	234	0	1	0	gen
1	63240507	63240918	MACS_peak_349	76.72	411	0	0	1	other
1	63241557	63241905	MACS_peak_350	53.89	348	0	0	1	other
1	63387051	63387271	MACS_peak_351	1472.89	220	0	1	0	gen
1	63575180	63575531	MACS_peak_352	629.58	351	0	1	0	gen
1	64246422	64246727	MACS_peak_353	686.76	305	0	1	0	gen
1	64269086	64269403	MACS_peak_354	677.44	317	0	0	0	intergen
1	64675873	64676087	MACS_peak_355	1264.23	214	0	1	0	gen
1	64719364	64719497	MACS_peak_356	1396.21	133	0	0	0	intergen
1	64740425	64740673	MACS_peak_357	261.67	248	1	0	0	promoter
1	64798160	64798456	MACS_peak_358	103.45	296	0	1	0	gen
1	65060008	65060331	MACS_peak_359	672.92	323	0	0	0	intergen
1	65431195	65431404	MACS_peak_360	613.04	209	0	2	0	gen
1	65453176	65453548	MACS_peak_361	72.11	372	0	1	0	gen
1	65453964	65454258	MACS_peak_362	69	294	0	1	0	gen
1	65672147	65672526	MACS_peak_364	69.76	379	0	0	0	intergen
1	66187747	66188199	MACS_peak_365	76.73	452	0	1	0	gen
1	66200838	66201103	MACS_peak_366	84.4	265	0	1	0	gen
1	66459443	66459648	MACS_peak_367	690.17	205	0	0	0	intergen
1	66492274	66492476	MACS_peak_368	814.37	202	0	0	0	intergen
1	66765043	66765342	MACS_peak_369	380.3	299	0	1	0	gen
1	66823993	66824321	MACS_peak_370	79.66	328	0	1	0	gen
1	66824450	66824701	MACS_peak_371	103.13	251	0	1	0	gen
1	66957460	66957713	MACS_peak_372	470.06	253	0	1	0	gen
1	66995959	66996365	MACS_peak_373	739.13	406	1	0	0	promoter
1	67213247	67213460	MACS_peak_374	596.79	213	0	2	0	gen
1	67214480	67214700	MACS_peak_375	564.54	220	0	2	0	gen
1	67549916	67550264	MACS_peak_376	76.3	348	0	0	0	intergen
1	67709881	67710177	MACS_peak_377	380.3	296	0	1	0	gen
1	67766154	67766420	MACS_peak_378	588.83	266	0	1	0	gen
1	68116619	68116943	MACS_peak_380	429.45	324	0	1	1	gen
1	68734381	68734730	MACS_peak_381	61.75	349	0	0	1	other
1	68880268	68880649	MACS_peak_382	63.13	381	0	0	1	other
1	68927425	68927754	MACS_peak_383	63.79	329	0	0	1	other
1	68963696	68963961	MACS_peak_384	306.6	265	0	0	0	intergen
1	69097941	69098315	MACS_peak_386	63.46	374	0	0	1	other
1	69117208	69117567	MACS_peak_387	52.99	359	0	0	1	other
1	69395484	69395745	MACS_peak_388	436.82	261	0	0	0	intergen
1	69536898	69537142	MACS_peak_389	160.58	244	0	0	0	intergen
1	69915994	69916283	MACS_peak_392	2199.84	289	0	1	0	gen
1	70098299	70098636	MACS_peak_393	56.38	337	0	1	0	gen
1	70132345	70132614	MACS_peak_394	243.49	269	0	1	0	gen
1	70239596	70239850	MACS_peak_395	596.79	254	0	1	0	gen
1	70311529	70311821	MACS_peak_396	1835.72	292	0	1	0	gen
1	70487983	70488224	MACS_peak_397	936.57	241	0	0	0	intergen
1	70782905	70783039	MACS_peak_398	1666.76	134	0	0	1	other
1	70966036	70966220	MACS_peak_399	729.14	184	0	1	0	gen
1	71119838	71120155	MACS_peak_400	93.4	317	0	0	1	other
1	71503987	71504231	MACS_peak_401	501.16	244	0	1	0	gen
1	71519140	71519565	MACS_peak_403	141.52	425	0	1	0	gen
1	71521761	71522002	MACS_peak_404	238.86	241	0	1	0	gen
1	71892970	71893344	MACS_peak_405	84.01	374	0	1	0	gen
1	72037765	72038148	MACS_peak_406	513.56	383	0	1	0	gen
1	72828135	72828540	MACS_peak_407	127.15	405	0	0	2	other
1	72901010	72901441	MACS_peak_408	100.11	431	0	0	0	intergen
1	72901468	72901888	MACS_peak_409	67.33	420	0	0	0	intergen
1	73291595	73291950	MACS_peak_410	95.51	355	0	0	0	intergen
1	73330343	73330718	MACS_peak_411	111.49	375	0	0	1	other
1	73674794	73675243	MACS_peak_412	465.3	449	0	0	1	other
1	73971754	73972172	MACS_peak_413	495.64	418	0	0	0	intergen
1	74228846	74229154	MACS_peak_415	380.3	308	0	2	0	gen
1	74500408	74500743	MACS_peak_416	84.4	335	0	3	0	gen
1	74771992	74772260	MACS_peak_417	587.27	268	0	0	0	intergen
1	74882596	74882873	MACS_peak_418	148.68	277	0	0	0	intergen
1	74901517	74901762	MACS_peak_419	117.08	245	0	0	0	intergen
1	75053265	75053520	MACS_peak_420	470.06	255	0	0	0	intergen
1	75323067	75323438	MACS_peak_421	75.01	371	0	1	0	gen
1	75381998	75382285	MACS_peak_422	514.54	287	0	1	0	gen
1	75477454	75477879	MACS_peak_423	183.93	425	0	1	0	gen
1	75479370	75479732	MACS_peak_424	51.84	362	0	1	0	gen
1	75518552	75518777	MACS_peak_425	712.32	225	0	1	0	gen
1	75634976	75635384	MACS_peak_426	164.26	408	0	0	0	intergen
1	75644964	75645332	MACS_peak_427	81.45	368	0	0	1	other
1	75680094	75680400	MACS_peak_428	101	306	0	0	1	other
1	75680522	75680825	MACS_peak_429	66.53	303	0	0	1	other
1	75699734	75700078	MACS_peak_430	75.26	344	0	0	1	other
1	75708416	75708549	MACS_peak_431	1098.16	133	0	0	1	other
1	75782828	75783195	MACS_peak_432	150.31	367	1	1	0	promoter
1	75842459	75842786	MACS_peak_433	611.86	327	0	1	0	gen
1	75906341	75906627	MACS_peak_434	602.79	286	0	1	0	gen
1	75962510	75962768	MACS_peak_435	389.76	258	0	0	1	other
1	76342849	76343048	MACS_peak_436	685.59	199	0	1	0	gen
1	76605399	76605598	MACS_peak_437	627.67	199	0	1	0	gen
1	76973311	76973613	MACS_peak_438	441.54	302	0	1	0	gen
1	77367657	77367954	MACS_peak_439	825.22	297	0	1	0	gen
1	77402689	77403097	MACS_peak_440	103.15	408	0	1	0	gen
1	77403257	77403684	MACS_peak_441	84.25	427	0	1	0	gen
1	77512553	77512797	MACS_peak_442	108.03	244	0	1	0	gen
1	77899165	77899478	MACS_peak_443	103.45	313	0	1	0	gen
1	77900841	77901162	MACS_peak_444	214.38	321	0	1	0	gen
1	78116703	78117061	MACS_peak_445	103.45	358	0	1	0	gen
1	78130812	78131057	MACS_peak_446	896.52	245	0	1	0	gen
1	78188116	78188368	MACS_peak_447	88.17	252	0	0	0	intergen
1	78462175	78462307	MACS_peak_449	1116.4	132	0	1	0	gen
1	78580010	78580471	MACS_peak_450	81.3	461	0	0	0	intergen
1	78616559	78616809	MACS_peak_451	712.64	250	1	0	0	promoter
1	78617554	78617744	MACS_peak_452	1235.46	190	1	0	0	promoter
1	78676451	78676672	MACS_peak_453	564.54	221	0	0	0	intergen
1	78839678	78840147	MACS_peak_454	820.08	469	0	0	0	intergen
1	78845420	78845763	MACS_peak_455	79.89	343	0	0	0	intergen
1	78846076	78846344	MACS_peak_456	58.19	268	0	0	0	intergen
1	79255445	79255727	MACS_peak_457	1564.49	282	0	0	0	intergen
1	79360726	79361017	MACS_peak_458	306.6	291	0	0	0	intergen
1	79497256	79497543	MACS_peak_459	450.32	287	0	0	0	intergen
1	79505110	79505398	MACS_peak_460	833.73	288	0	0	0	intergen
1	79512739	79513104	MACS_peak_461	50.92	365	0	0	0	intergen
1	79870263	79870510	MACS_peak_462	584.42	247	0	0	0	intergen
1	80088232	80088608	MACS_peak_463	78.93	376	0	0	0	intergen
1	80217441	80217752	MACS_peak_464	556.45	311	0	0	0	intergen
1	80294436	80294650	MACS_peak_465	918.92	214	0	0	0	intergen
1	80702976	80703357	MACS_peak_467	93.4	381	0	0	0	intergen
1	80733133	80733535	MACS_peak_468	60.38	402	0	0	0	intergen
1	80948352	80948602	MACS_peak_469	52.02	250	0	0	0	intergen
1	80974503	80974769	MACS_peak_470	463.44	266	0	0	0	intergen
1	81158381	81158567	MACS_peak_471	1098.16	186	0	0	0	intergen
1	81811951	81812334	MACS_peak_472	631.92	383	0	1	0	gen
1	81858712	81859008	MACS_peak_473	445	296	0	1	0	gen
1	82255422	82255830	MACS_peak_475	131.57	408	0	0	1	other
1	83013476	83013626	MACS_peak_476	1060.6	150	0	0	1	other
1	83146074	83146294	MACS_peak_477	668.87	220	0	0	1	other
1	83168854	83169098	MACS_peak_478	136.71	244	0	0	0	intergen
1	83170020	83170362	MACS_peak_479	100.19	342	0	0	0	intergen
1	83184592	83184967	MACS_peak_480	70.59	375	0	0	0	intergen
1	83267172	83267617	MACS_peak_481	53.72	445	0	0	0	intergen
1	83268176	83268573	MACS_peak_482	84.14	397	0	0	0	intergen
1	83340014	83340404	MACS_peak_483	57.85	390	0	0	0	intergen
1	83340513	83340790	MACS_peak_484	55.16	277	0	0	0	intergen
1	83353575	83353999	MACS_peak_485	110.12	424	0	0	0	intergen
1	83674333	83674471	MACS_peak_486	1065.38	138	0	0	1	other
1	83737732	83737865	MACS_peak_487	1396.21	133	0	0	1	other
1	83905393	83905707	MACS_peak_488	944.21	314	0	1	0	gen
1	84021095	84021292	MACS_peak_489	641.55	197	0	0	0	intergen
1	84141168	84141498	MACS_peak_490	426.3	330	0	1	0	gen
1	84230950	84231171	MACS_peak_491	132.92	221	0	1	0	gen
1	84234349	84234710	MACS_peak_492	102.84	361	0	1	0	gen
1	84844517	84844726	MACS_peak_493	613.04	209	0	1	0	gen
1	84936364	84936636	MACS_peak_494	714.45	272	0	1	0	gen
1	84944946	84945343	MACS_peak_495	722.05	397	0	1	0	gen
1	85185656	85186108	MACS_peak_496	50.18	452	0	1	0	gen
1	85186768	85187116	MACS_peak_497	122.99	348	0	1	0	gen
1	85254798	85255033	MACS_peak_498	516.86	235	0	0	0	intergen
1	85346931	85347167	MACS_peak_499	187.23	236	0	1	1	gen
1	85644928	85645334	MACS_peak_500	170.56	406	1	0	0	promoter
1	85646459	85646804	MACS_peak_501	60.82	345	1	0	0	promoter
1	85754078	85754421	MACS_peak_502	107.69	343	0	1	0	gen
1	85825769	85826169	MACS_peak_503	83.78	400	0	1	0	gen
1	85828778	85829046	MACS_peak_504	72.24	268	0	1	0	gen
1	85925310	85925676	MACS_peak_505	122.66	366	0	1	0	gen
1	85932070	85932488	MACS_peak_507	55.83	418	0	1	0	gen
1	86162943	86163288	MACS_peak_508	81.72	345	0	0	0	intergen
1	86182160	86182545	MACS_peak_509	81.72	385	0	0	0	intergen
1	86275506	86275859	MACS_peak_510	77.65	353	0	0	0	intergen
1	86474118	86474507	MACS_peak_511	603.02	389	0	1	0	gen
1	86499923	86500291	MACS_peak_512	894.97	368	0	0	0	intergen
1	86797641	86797956	MACS_peak_513	660.35	315	0	0	0	intergen
1	86816335	86816793	MACS_peak_514	77.93	458	0	0	0	intergen
1	86953935	86954168	MACS_peak_515	385.14	233	0	1	0	gen
1	88346580	88346975	MACS_peak_517	105.65	395	0	0	1	other
1	88657171	88657397	MACS_peak_518	138.33	226	0	0	1	other
1	88736708	88736954	MACS_peak_519	485.56	246	0	1	0	gen
1	89388530	89388894	MACS_peak_520	115.7	364	0	0	0	intergen
1	89388927	89389307	MACS_peak_521	74.78	380	0	0	0	intergen
1	89456353	89456697	MACS_peak_522	419.18	344	0	0	0	intergen
1	90061124	90061445	MACS_peak_524	94.93	321	0	0	0	intergen
1	91001012	91001361	MACS_peak_525	57.54	349	0	1	0	gen
1	91002416	91002765	MACS_peak_526	125.87	349	0	1	0	gen
1	91099620	91099888	MACS_peak_527	229.83	268	0	0	0	intergen
1	91166165	91166455	MACS_peak_528	698.94	290	0	0	0	intergen
1	91215577	91215931	MACS_peak_530	74.66	354	0	0	0	intergen
1	91445457	91445835	MACS_peak_532	55.56	378	0	0	0	intergen
1	91459255	91459714	MACS_peak_533	1211.54	459	0	0	0	intergen
1	92232755	92233030	MACS_peak_535	94.11	275	0	1	0	gen
1	92234895	92235277	MACS_peak_536	64.38	382	0	1	0	gen
1	92538234	92538418	MACS_peak_537	829.69	184	0	1	0	gen
1	92707928	92708212	MACS_peak_538	704	284	0	1	0	gen
1	92894749	92895109	MACS_peak_539	84.06	360	0	1	0	gen
1	92895525	92895808	MACS_peak_540	85.54	283	0	1	0	gen
1	93257237	93257371	MACS_peak_542	1666.76	134	0	1	0	gen
1	93391535	93391872	MACS_peak_543	142.05	337	0	0	0	intergen
1	93402920	93403284	MACS_peak_544	55.24	364	0	0	0	intergen
1	93629452	93629714	MACS_peak_545	466.05	262	0	1	0	gen
1	93791637	93792046	MACS_peak_546	86.46	409	0	1	0	gen
1	93850836	93851104	MACS_peak_547	832.28	268	0	0	0	intergen
1	94018915	94019048	MACS_peak_548	1098.16	133	0	1	0	gen
1	94510195	94510587	MACS_peak_549	62.64	392	0	1	0	gen
1	94760483	94760895	MACS_peak_550	194.77	412	0	0	1	other
1	95043478	95043737	MACS_peak_551	726.32	259	0	1	0	gen
1	95309058	95309397	MACS_peak_553	421.69	339	0	0	0	intergen
1	96244313	96244679	MACS_peak_554	63.35	366	0	0	0	intergen
1	96245234	96245586	MACS_peak_555	72.64	352	0	0	0	intergen
1	96265267	96265552	MACS_peak_556	451.52	285	0	0	1	other
1	96591698	96591915	MACS_peak_557	528	217	0	0	0	intergen
1	96609451	96609749	MACS_peak_558	163.87	298	0	0	0	intergen
1	97084211	97084410	MACS_peak_561	627.67	199	0	1	0	gen
1	97264159	97264294	MACS_peak_562	925.76	135	0	1	1	gen
1	97289115	97289498	MACS_peak_563	75.55	383	0	1	1	gen
1	97290804	97291197	MACS_peak_564	101.16	393	0	1	1	gen
1	97319245	97319664	MACS_peak_565	63.63	419	0	1	1	gen
1	97385284	97385619	MACS_peak_566	791.99	335	0	1	0	gen
1	97556501	97556870	MACS_peak_568	53.86	369	0	1	0	gen
1	97584042	97584345	MACS_peak_569	161.03	303	0	1	0	gen
1	97942896	97943277	MACS_peak_570	643.65	381	0	1	1	gen
1	98153966	98154343	MACS_peak_572	75.69	377	0	0	0	intergen
1	98214026	98214297	MACS_peak_573	62.38	271	0	0	1	other
1	98214701	98215030	MACS_peak_574	159.56	329	0	0	1	other
1	98468083	98468480	MACS_peak_575	745.28	397	0	0	0	intergen
1	98590544	98590920	MACS_peak_576	98.1	376	0	0	0	intergen
1	98922033	98922333	MACS_peak_577	1387.53	300	0	1	0	gen
1	98991227	98991433	MACS_peak_578	784.8	206	0	1	0	gen
1	99707653	99707908	MACS_peak_579	470.06	255	1	0	0	promoter
1	100258755	100259101	MACS_peak_580	149.97	346	0	0	1	other
1	100666653	100667056	MACS_peak_581	112.08	403	0	0	0	intergen
1	100678027	100678356	MACS_peak_582	77.81	329	0	0	0	intergen
1	101373052	101373189	MACS_peak_584	1061.85	137	0	0	1	other
1	101506527	101506909	MACS_peak_585	514.09	382	0	0	0	intergen
1	101628191	101628627	MACS_peak_586	87.62	436	0	0	0	intergen
1	101811658	101811972	MACS_peak_587	202.59	314	0	1	0	gen
1	102073757	102074136	MACS_peak_588	72.27	379	0	0	0	intergen
1	102134268	102134648	MACS_peak_590	76.3	380	0	0	0	intergen
1	102343182	102343598	MACS_peak_591	100.01	416	0	0	1	other
1	102385401	102385774	MACS_peak_592	209.38	373	0	0	1	other
1	102444778	102445031	MACS_peak_593	164.73	253	0	0	0	intergen
1	102461617	102461990	MACS_peak_594	126.54	373	0	0	0	intergen
1	102702441	102702895	MACS_peak_595	190.81	454	0	0	0	intergen
1	102932401	102932663	MACS_peak_596	60.57	262	0	1	0	gen
1	103277830	103278044	MACS_peak_597	391.65	214	0	0	0	intergen
1	103461259	103461722	MACS_peak_598	586.55	463	0	0	1	other
1	104263264	104263543	MACS_peak_601	611.86	279	0	0	0	intergen
1	104659641	104660099	MACS_peak_602	69.36	458	0	0	0	intergen
1	104780552	104780733	MACS_peak_604	936.57	181	0	0	0	intergen
1	104786729	104786969	MACS_peak_605	170.71	240	0	0	0	intergen
1	104820278	104820592	MACS_peak_606	50.92	314	0	0	0	intergen
1	104938351	104938660	MACS_peak_608	70.61	309	0	0	0	intergen
1	104959965	104960127	MACS_peak_609	848.95	162	0	0	0	intergen
1	104977743	104978085	MACS_peak_610	158.81	342	0	0	0	intergen
1	105361651	105361848	MACS_peak_611	579.03	197	0	0	0	intergen
1	105576162	105576566	MACS_peak_612	60	404	0	0	0	intergen
1	105578105	105578485	MACS_peak_613	114.5	380	0	0	0	intergen
1	105948544	105948840	MACS_peak_614	102.01	296	0	0	1	other
1	106194899	106195116	MACS_peak_615	562.73	217	0	0	0	intergen
1	106210896	106211061	MACS_peak_616	460.95	165	0	0	0	intergen
1	106217883	106218299	MACS_peak_617	346.63	416	0	0	0	intergen
1	106241980	106242309	MACS_peak_618	93.4	329	0	0	0	intergen
1	106247686	106247909	MACS_peak_619	273.64	223	0	0	0	intergen
1	106252364	106252694	MACS_peak_620	941.19	330	0	0	0	intergen
1	106258406	106258770	MACS_peak_621	206.15	364	0	0	0	intergen
1	106325954	106326094	MACS_peak_622	1501.11	140	0	0	0	intergen
1	106334618	106334926	MACS_peak_623	133.84	308	0	0	0	intergen
1	106344390	106344799	MACS_peak_624	271.67	409	0	0	0	intergen
1	106349883	106350225	MACS_peak_625	3176.73	342	0	0	0	intergen
1	106391233	106391625	MACS_peak_627	826.18	392	0	0	0	intergen
1	106402003	106402411	MACS_peak_628	454.93	408	0	0	0	intergen
1	106429801	106430144	MACS_peak_629	504.2	343	0	0	0	intergen
1	106456338	106456695	MACS_peak_631	893.16	357	0	0	0	intergen
1	106488872	106489307	MACS_peak_632	1272.41	435	0	0	0	intergen
1	106534649	106534987	MACS_peak_633	519.54	338	0	0	0	intergen
1	106574048	106574484	MACS_peak_634	873.32	436	0	0	0	intergen
1	106596687	106597026	MACS_peak_635	130.56	339	0	0	0	intergen
1	106624765	106625073	MACS_peak_636	1733.47	308	0	0	0	intergen
1	106632405	106632686	MACS_peak_637	255.86	281	0	0	0	intergen
1	106639946	106640291	MACS_peak_638	1148.55	345	0	0	0	intergen
1	106642325	106642597	MACS_peak_639	233.14	272	0	0	0	intergen
1	106731993	106732373	MACS_peak_640	212.28	380	0	0	0	intergen
1	106766646	106766916	MACS_peak_641	530.67	270	0	0	0	intergen
1	106768783	106769151	MACS_peak_642	247.6	368	0	0	0	intergen
1	106772222	106772530	MACS_peak_643	803.92	308	0	0	0	intergen
1	106793196	106793532	MACS_peak_644	835.2	336	0	0	0	intergen
1	106798984	106799277	MACS_peak_645	364.81	293	0	0	0	intergen
1	106804655	106804836	MACS_peak_646	612.16	181	0	0	1	other
1	106875051	106875316	MACS_peak_647	402.21	265	0	0	0	intergen
1	106894024	106894402	MACS_peak_648	1383.87	378	0	0	0	intergen
1	106895154	106895577	MACS_peak_649	603.06	423	0	0	0	intergen
1	106897377	106897609	MACS_peak_650	689.95	232	0	0	0	intergen
1	106930905	106931223	MACS_peak_651	96.1	318	0	0	0	intergen
1	106937570	106937886	MACS_peak_652	209.78	316	0	0	0	intergen
1	106957851	106958283	MACS_peak_653	1099.07	432	0	0	0	intergen
1	106976061	106976317	MACS_peak_654	608.9	256	0	0	0	intergen
1	107059700	107060044	MACS_peak_655	235.73	344	1	0	0	promoter
1	107068225	107068576	MACS_peak_656	217.69	351	0	0	0	intergen
1	107083930	107084234	MACS_peak_657	253.11	304	0	0	0	intergen
1	107120024	107120327	MACS_peak_658	511.25	303	0	0	0	intergen
1	107127295	107127720	MACS_peak_659	352.76	425	0	0	0	intergen
1	107157707	107158043	MACS_peak_662	454.12	336	0	1	0	gen
1	107229141	107229415	MACS_peak_664	800.66	274	0	1	0	gen
1	107276581	107276958	MACS_peak_665	287.01	377	0	1	0	gen
1	107277007	107277263	MACS_peak_666	741.97	256	0	1	0	gen
1	107309624	107309948	MACS_peak_667	140.94	324	0	1	0	gen
1	107331773	107332243	MACS_peak_668	847.08	470	0	1	0	gen
1	107386841	107387118	MACS_peak_669	1051.14	277	0	1	0	gen
1	107430616	107430917	MACS_peak_670	800.2	301	0	1	0	gen
1	107529521	107529889	MACS_peak_671	394.47	368	0	0	0	intergen
1	107552408	107552575	MACS_peak_672	814.37	167	0	0	0	intergen
1	107567936	107568160	MACS_peak_673	564.54	224	1	0	0	promoter
1	107657855	107658072	MACS_peak_674	1632.23	217	0	1	0	gen
1	107782292	107782524	MACS_peak_675	387.94	232	0	1	0	gen
1	108086731	108087092	MACS_peak_677	603.02	361	0	0	0	intergen
1	108125600	108125835	MACS_peak_678	1282.94	235	0	0	0	intergen
1	108146530	108146691	MACS_peak_679	545.76	161	0	1	0	gen
1	108165543	108165916	MACS_peak_680	113.38	373	0	1	0	gen
1	108279014	108279330	MACS_peak_682	347.97	316	0	0	1	other
1	108316670	108316876	MACS_peak_683	797.18	206	0	0	1	other
1	108415050	108415328	MACS_peak_684	269.75	278	0	0	1	other
1	108512500	108512839	MACS_peak_685	1043.77	339	0	0	0	intergen
1	108523050	108523332	MACS_peak_686	272.05	282	0	0	0	intergen
1	108561703	108562111	MACS_peak_687	616.76	408	1	0	0	promoter
1	108676516	108676877	MACS_peak_688	239.82	361	0	0	0	intergen
1	108729797	108730062	MACS_peak_689	464.09	265	0	1	0	gen
1	108746332	108746612	MACS_peak_690	454.58	280	1	0	0	promoter
1	108898131	108898421	MACS_peak_692	413.6	290	0	2	0	gen
1	109027860	109028091	MACS_peak_693	678.9	231	0	1	0	gen
1	109201075	109201416	MACS_peak_694	420.68	341	0	1	0	gen
1	109263610	109263986	MACS_peak_695	760.2	376	0	1	0	gen
1	109490456	109490929	MACS_peak_696	581.45	473	1	1	0	promoter
1	109499995	109500233	MACS_peak_697	954.29	238	1	1	0	promoter
1	109546307	109546618	MACS_peak_698	1085.67	311	1	1	0	promoter
1	109640164	109640566	MACS_peak_699	620.31	402	0	0	0	intergen
1	109649757	109650076	MACS_peak_700	527.2	319	0	0	0	intergen
1	109980685	109980904	MACS_peak_702	580.62	219	1	0	0	promoter
1	110079968	110080183	MACS_peak_703	543.04	215	0	0	0	intergen
1	110196876	110197206	MACS_peak_704	426.3	330	0	1	0	gen
1	110203075	110203278	MACS_peak_705	814.37	203	0	0	0	intergen
1	110457942	110458162	MACS_peak_706	416.26	220	0	0	0	intergen
1	110460291	110460566	MACS_peak_707	1274.41	275	0	0	0	intergen
1	110496039	110496359	MACS_peak_708	550.56	320	0	0	0	intergen
1	110766145	110766415	MACS_peak_709	460.86	270	0	0	0	intergen
1	110780974	110781220	MACS_peak_710	763.02	246	0	0	0	intergen
1	110783337	110783650	MACS_peak_711	789.42	313	0	0	0	intergen
1	110808425	110808804	MACS_peak_712	72.07	379	0	0	0	intergen
1	110847840	110848044	MACS_peak_713	874.07	204	0	0	0	intergen
1	110947891	110948128	MACS_peak_714	516.86	237	1	0	1	promoter
1	111208725	111208963	MACS_peak_715	797.18	238	0	1	0	gen
1	111290910	111291120	MACS_peak_716	1290.85	210	1	0	0	promoter
1	111769591	111769832	MACS_peak_717	1098.16	241	1	0	0	promoter
1	111968914	111969122	MACS_peak_718	459.7	208	0	1	0	gen
1	111991484	111991732	MACS_peak_719	485.56	248	0	0	1	other
1	112155560	112155988	MACS_peak_721	55.51	428	0	0	0	intergen
1	112199616	112199929	MACS_peak_722	119.12	313	0	0	1	other
1	112200137	112200569	MACS_peak_723	85.5	432	0	0	1	other
1	112298680	112298949	MACS_peak_724	406.81	269	0	0	1	other
1	112340810	112341160	MACS_peak_725	69	350	0	0	1	other
1	112804116	112804493	MACS_peak_726	516.8	377	0	0	0	intergen
1	112897781	112898066	MACS_peak_727	175.74	285	0	0	0	intergen
1	113015870	113016317	MACS_peak_728	243.49	447	0	0	2	other
1	113070881	113071224	MACS_peak_729	89.02	343	1	0	1	promoter
1	113140557	113140852	MACS_peak_730	445.58	295	0	0	0	intergen
1	113342945	113343371	MACS_peak_731	94.79	426	0	0	0	intergen
1	113348526	113348679	MACS_peak_732	541.82	153	0	0	0	intergen
1	113434524	113434734	MACS_peak_733	613.04	210	0	1	0	gen
1	113474362	113474738	MACS_peak_734	122.51	376	0	1	0	gen
1	113502210	113502528	MACS_peak_735	50.5	318	0	1	0	gen
1	113513715	113514178	MACS_peak_736	75.42	463	0	1	0	gen
1	113555223	113555505	MACS_peak_737	643.11	282	0	1	0	gen
1	113565180	113565433	MACS_peak_738	2499.77	253	0	1	0	gen
1	113576931	113577149	MACS_peak_739	636.28	218	0	1	0	gen
1	113640913	113641181	MACS_peak_741	292.39	268	0	1	0	gen
1	113668439	113668717	MACS_peak_742	567.67	278	0	1	0	gen
1	113835770	113836065	MACS_peak_743	1344.81	295	0	1	0	gen
1	113851289	113851527	MACS_peak_744	315.53	238	0	1	0	gen
1	113874520	113874898	MACS_peak_745	832.59	378	1	0	1	promoter
1	113905131	113905326	MACS_peak_746	447.48	195	1	0	0	promoter
1	113949258	113949470	MACS_peak_747	856.48	212	0	1	0	gen
1	114033334	114033636	MACS_peak_749	1155.27	302	0	1	1	gen
1	114104915	114105268	MACS_peak_750	867.54	353	0	1	0	gen
1	114193580	114193869	MACS_peak_751	1069.92	289	0	0	0	intergen
1	114224994	114225388	MACS_peak_752	399.79	394	0	0	1	other
1	114282901	114283344	MACS_peak_753	942.66	443	0	0	0	intergen
1	114363365	114363614	MACS_peak_755	410.82	249	0	0	0	intergen
1	114428154	114428526	MACS_peak_756	1656.19	372	0	1	0	gen
1	114431606	114431846	MACS_peak_757	589.16	240	0	1	0	gen
1	114468513	114468879	MACS_peak_758	369.28	366	0	1	1	gen
1	114471441	114471645	MACS_peak_759	552.85	204	0	1	0	gen
1	114489037	114489430	MACS_peak_760	655.79	393	0	1	0	gen
1	114522506	114522907	MACS_peak_761	899.23	401	0	0	0	intergen
1	114558602	114559055	MACS_peak_762	907.19	453	0	0	0	intergen
1	114570367	114570602	MACS_peak_763	366.7	235	1	0	0	promoter
1	114609814	114610127	MACS_peak_764	346.5	313	0	1	0	gen
1	114620483	114620814	MACS_peak_765	500.47	331	0	1	0	gen
1	114632588	114632936	MACS_peak_766	3100	348	0	1	0	gen
1	114671496	114671811	MACS_peak_767	475.35	315	1	0	0	promoter
1	114758093	114758320	MACS_peak_768	665.93	227	0	1	0	gen
1	114765218	114765351	MACS_peak_769	820.94	133	1	0	0	promoter
1	114859766	114860062	MACS_peak_770	367.21	296	0	0	0	intergen
1	114867024	114867319	MACS_peak_771	713.3	295	0	1	0	gen
1	114956595	114956920	MACS_peak_773	1676.81	325	0	1	0	gen
1	114965375	114965620	MACS_peak_774	581.33	245	0	1	0	gen
1	114979347	114979604	MACS_peak_775	542.24	257	0	1	0	gen
1	115040477	115040824	MACS_peak_777	506.92	347	0	0	0	intergen
1	115041698	115042005	MACS_peak_778	744.6	307	0	0	0	intergen
1	115052442	115052773	MACS_peak_779	974.79	331	1	0	0	promoter
1	115112834	115113104	MACS_peak_780	716.24	270	0	0	0	intergen
1	115595888	115596126	MACS_peak_781	516.86	238	0	0	0	intergen
1	115635585	115635768	MACS_peak_782	174.78	183	0	0	0	intergen
1	115784133	115784451	MACS_peak_783	237.25	318	0	0	0	intergen
1	115840442	115840675	MACS_peak_784	666.96	233	1	0	0	promoter
1	115849852	115850078	MACS_peak_785	827.89	226	0	0	0	intergen
1	115974882	115975141	MACS_peak_786	721.05	259	1	0	0	promoter
1	116020668	116020971	MACS_peak_787	558.88	303	0	1	0	gen
1	116052725	116053025	MACS_peak_788	106.7	300	0	1	0	gen
1	116135088	116135507	MACS_peak_789	94.29	419	0	0	0	intergen
1	116152101	116152340	MACS_peak_790	797.18	239	0	0	0	intergen
1	116280850	116281287	MACS_peak_791	314.16	437	0	0	0	intergen
1	116394177	116394470	MACS_peak_792	843.52	293	0	1	1	gen
1	116436827	116437167	MACS_peak_793	534.92	340	0	0	1	other
1	116485341	116485569	MACS_peak_794	695.57	228	0	0	0	intergen
1	116499002	116499387	MACS_peak_795	603.02	385	0	0	0	intergen
1	116531261	116531590	MACS_peak_796	801.89	329	0	1	0	gen
1	116570337	116570571	MACS_peak_797	814.37	234	1	1	0	promoter
1	116574451	116574841	MACS_peak_798	1418.79	390	1	0	0	promoter
1	116581209	116581341	MACS_peak_799	1116.4	132	0	1	0	gen
1	116724308	116724685	MACS_peak_801	312.33	377	0	0	0	intergen
1	116724804	116725161	MACS_peak_802	399.64	357	0	0	0	intergen
1	116764050	116764398	MACS_peak_803	417.2	348	0	1	0	gen
1	116817654	116817951	MACS_peak_804	550.01	297	0	0	0	intergen
1	117055323	117055660	MACS_peak_805	662.69	337	1	0	1	promoter
1	117221937	117222228	MACS_peak_806	105.65	291	0	0	0	intergen
1	117312544	117312796	MACS_peak_807	761.83	252	0	0	1	other
1	117402383	117402597	MACS_peak_808	1098.16	214	0	1	0	gen
1	117512765	117513012	MACS_peak_809	629.38	247	0	1	0	gen
1	117535020	117535376	MACS_peak_810	528.58	356	0	0	0	intergen
1	117722651	117722963	MACS_peak_811	81.45	312	0	0	0	intergen
1	117725570	117726004	MACS_peak_812	686.1	434	0	0	0	intergen
1	117758907	117759177	MACS_peak_813	460.86	270	0	0	0	intergen
1	117895633	117895936	MACS_peak_814	440.97	303	0	1	0	gen
1	118151344	118151800	MACS_peak_815	590.18	456	0	1	0	gen
1	118283256	118283594	MACS_peak_816	77.29	338	0	0	0	intergen
1	118283739	118284153	MACS_peak_817	82.18	414	0	0	0	intergen
1	118350535	118350887	MACS_peak_818	187.65	352	0	0	0	intergen
1	118350938	118351290	MACS_peak_819	83.72	352	0	0	0	intergen
1	118430039	118430229	MACS_peak_821	767.82	190	0	0	0	intergen
1	118466122	118466381	MACS_peak_822	972.38	259	0	0	0	intergen
1	118856106	118856382	MACS_peak_823	71.7	276	0	0	0	intergen
1	118857378	118857742	MACS_peak_824	64.01	364	0	0	0	intergen
1	119023582	119023834	MACS_peak_825	98.27	252	0	0	0	intergen
1	119025019	119025351	MACS_peak_826	122.64	332	0	0	0	intergen
1	119078519	119078811	MACS_peak_828	829.92	292	0	1	0	gen
1	119141042	119141371	MACS_peak_829	544.83	329	0	0	1	other
1	119165971	119166206	MACS_peak_830	654.6	235	0	0	1	other
1	119275496	119275745	MACS_peak_831	763.02	249	0	0	2	other
1	119276579	119276852	MACS_peak_832	583.44	273	0	0	1	other
1	119367566	119367822	MACS_peak_833	470.06	256	1	0	0	promoter
1	119675577	119675859	MACS_peak_834	453.35	282	0	1	0	gen
1	119744028	119744414	MACS_peak_835	989.58	386	1	0	0	promoter
1	119786520	119786855	MACS_peak_836	533.47	335	0	0	0	intergen
1	119809017	119809277	MACS_peak_837	1295.79	260	0	1	0	gen
1	119870997	119871201	MACS_peak_838	1358.26	204	0	0	0	intergen
1	120020066	120020357	MACS_peak_839	454.64	291	0	1	0	gen
1	120031946	120032174	MACS_peak_840	342.97	228	0	1	0	gen
1	120053070	120053385	MACS_peak_841	210.27	315	0	1	0	gen
1	120058808	120059187	MACS_peak_842	2049.6	379	0	1	0	gen
1	120118043	120118316	MACS_peak_843	1804.99	273	0	0	0	intergen
1	143943645	143944028	MACS_peak_847	669.03	383	0	0	0	intergen
1	121481487	121481756	MACS_peak_848	114.39	269	0	0	0	intergen
1	121534597	121534843	MACS_peak_849	64.61	246	0	0	1	other
1	121579359	121579633	MACS_peak_850	127.5	274	0	0	1	other
1	121585388	121585766	MACS_peak_851	178.37	378	0	0	0	intergen
1	121590110	121590367	MACS_peak_852	469.39	257	0	0	0	intergen
1	121611305	121611641	MACS_peak_854	57.93	336	0	0	0	intergen
1	121649414	121649782	MACS_peak_856	61.29	368	0	0	0	intergen
1	121671669	121672071	MACS_peak_862	186.65	402	0	0	0	intergen
1	121677266	121677668	MACS_peak_863	84.94	402	0	0	0	intergen
1	121682864	121683337	MACS_peak_866	102.44	473	0	0	0	intergen
1	121686709	121686994	MACS_peak_867	67.03	285	0	0	0	intergen
1	121731501	121731969	MACS_peak_868	89.57	468	0	0	0	intergen
1	121733366	121733592	MACS_peak_869	77.95	226	0	0	0	intergen
1	144002397	144002736	MACS_peak_904	786.03	339	0	0	1	other
1	144969519	144969868	MACS_peak_905	55.54	349	0	1	0	gen
1	144966973	144967271	MACS_peak_906	53.71	298	0	1	0	gen
1	144046624	144046966	MACS_peak_908	327.62	342	0	0	1	other
1	145258795	145259016	MACS_peak_913	166.81	221	0	0	0	intergen
1	149136740	149136956	MACS_peak_914	394.99	216	0	0	0	intergen
1	149124297	149124599	MACS_peak_915	256.43	302	0	0	0	intergen
1	149081833	149082185	MACS_peak_916	315.5	352	0	1	0	gen
1	120442743	120443193	MACS_peak_917	1886.64	450	0	0	1	other
1	120302686	120303077	MACS_peak_918	423.29	391	0	0	2	other
1	120299377	120299773	MACS_peak_919	866.21	396	0	0	2	other
1	149024391	149024753	MACS_peak_921	383.84	362	0	1	1	gen
1	148914546	148914897	MACS_peak_923	631.41	351	0	1	0	gen
1	148911322	148911641	MACS_peak_924	1524.85	319	0	1	0	gen
1	148895786	148896066	MACS_peak_925	340.31	280	0	1	0	gen
1	148881485	148881701	MACS_peak_926	670.24	216	0	1	0	gen
1	148852356	148852606	MACS_peak_928	226.12	250	0	1	0	gen
1	148825143	148825450	MACS_peak_929	687.07	307	0	1	0	gen
1	148818825	148819152	MACS_peak_930	356.9	327	0	1	0	gen
1	148779241	148779611	MACS_peak_931	261.74	370	0	0	1	other
1	148749382	148749691	MACS_peak_933	307.98	309	1	0	0	promoter
1	148729802	148730075	MACS_peak_934	1804.99	273	0	0	0	intergen
1	146235095	146235275	MACS_peak_935	587.56	180	0	0	0	intergen
1	146218052	146218534	MACS_peak_936	1828.38	482	0	2	0	gen
1	146212418	146212842	MACS_peak_937	200.37	424	0	2	0	gen
1	146191334	146191562	MACS_peak_938	335	228	0	2	0	gen
1	146179472	146179799	MACS_peak_939	573.34	327	0	2	0	gen
1	146176895	146177135	MACS_peak_940	406.06	240	0	2	0	gen
1	146144436	146144866	MACS_peak_941	1381.65	430	1	1	0	promoter
1	146138077	146138542	MACS_peak_942	1241.95	465	0	2	0	gen
1	146013043	146013337	MACS_peak_943	730.33	294	1	0	0	promoter
1	146007277	146007557	MACS_peak_944	691.08	280	0	0	0	intergen
1	145977505	145977822	MACS_peak_945	536.57	317	0	1	0	gen
1	145846180	145846428	MACS_peak_946	485.56	248	2	0	0	promoter
1	145845415	145845778	MACS_peak_947	769.88	363	2	0	0	promoter
1	145721263	145721456	MACS_peak_948	856.26	193	1	0	0	promoter
1	145661079	145661321	MACS_peak_949	111.29	242	0	1	0	gen
1	145617453	145617688	MACS_peak_950	421.83	235	0	1	0	gen
1	148120454	148120925	MACS_peak_953	702.27	471	0	1	0	gen
1	146966420	146966794	MACS_peak_957	1254.58	374	0	1	0	gen
1	146870531	146870902	MACS_peak_958	56	371	0	0	1	other
1	146871540	146871913	MACS_peak_959	239.63	373	0	0	1	other
1	146900317	146900768	MACS_peak_960	701.25	451	0	0	1	other
1	146960077	146960449	MACS_peak_961	439.14	372	0	1	0	gen
1	146972611	146973030	MACS_peak_963	857.26	419	0	1	0	gen
1	146990071	146990264	MACS_peak_964	108.52	193	0	1	0	gen
1	147008726	147009044	MACS_peak_965	200.37	318	0	0	0	intergen
1	147098451	147098749	MACS_peak_966	265.34	298	0	0	0	intergen
1	147126674	147126944	MACS_peak_967	60.64	270	0	0	0	intergen
1	147306269	147306568	MACS_peak_968	97.7	299	0	0	1	other
1	147405322	147405775	MACS_peak_970	113.86	453	0	0	1	other
1	147443118	147443483	MACS_peak_972	226.51	365	0	0	1	other
1	147481224	147481669	MACS_peak_973	761.72	445	0	0	1	other
1	147494912	147495282	MACS_peak_974	893.29	370	0	0	1	other
1	147501387	147501620	MACS_peak_975	529.74	233	0	0	1	other
1	147641980	147642313	MACS_peak_976	603.02	333	0	1	0	gen
1	147699994	147700268	MACS_peak_977	1102.85	274	0	0	0	intergen
1	147723992	147724231	MACS_peak_978	516.86	239	0	0	0	intergen
1	147890266	147890530	MACS_peak_979	836.44	264	0	0	0	intergen
1	147892756	147893052	MACS_peak_980	1869.05	296	0	0	0	intergen
1	147930027	147930459	MACS_peak_981	388.99	432	1	0	0	promoter
1	147937862	147938082	MACS_peak_982	566.9	220	0	1	0	gen
1	147983453	147983811	MACS_peak_984	61.23	358	0	1	0	gen
1	148126714	148127069	MACS_peak_987	187.57	355	0	1	0	gen
1	148216720	148217003	MACS_peak_988	439.72	283	0	0	1	other
1	148231374	148231654	MACS_peak_989	465.75	280	0	0	1	other
1	148254961	148255338	MACS_peak_990	382.29	377	0	0	0	intergen
1	148339191	148339645	MACS_peak_991	568.02	454	0	0	2	other
1	148345686	148345958	MACS_peak_992	638.32	272	0	0	1	other
1	120874493	120874772	MACS_peak_994	190.74	279	0	0	0	intergen
1	148465664	148465797	MACS_peak_996	821.49	133	0	0	1	other
1	148517256	148517636	MACS_peak_997	406.15	380	0	0	1	other
1	149063114	149063287	MACS_peak_999	66.54	173	0	1	0	gen
1	144505358	144505630	MACS_peak_1002	201.59	272	0	0	0	intergen
1	144485382	144485684	MACS_peak_1003	774.05	302	0	0	0	intergen
1	149483178	149483506	MACS_peak_1005	133.29	328	0	1	0	gen
1	144418672	144419089	MACS_peak_1006	781.84	417	1	0	1	promoter
1	144353444	144353822	MACS_peak_1007	115.65	378	0	0	0	intergen
1	144344732	144344947	MACS_peak_1008	241.91	215	0	0	0	intergen
1	120860569	120860814	MACS_peak_1011	241.2	245	0	0	0	intergen
1	143502888	143503146	MACS_peak_1012	99.45	258	0	0	0	intergen
1	143472470	143472602	MACS_peak_1013	543.24	132	0	0	1	other
1	143466180	143466440	MACS_peak_1014	467.29	260	0	0	1	other
1	143464928	143465174	MACS_peak_1015	613.11	246	0	0	1	other
1	143709650	143710002	MACS_peak_1019	721.05	352	0	0	0	intergen
1	143778271	143778721	MACS_peak_1020	503.81	450	0	0	0	intergen
1	143805409	143805747	MACS_peak_1021	265.34	338	0	0	0	intergen
1	143944644	143945019	MACS_peak_1023	603.06	375	0	0	0	intergen
1	120855270	120855648	MACS_peak_1024	274.48	378	0	0	0	intergen
1	144578143	144578422	MACS_peak_1025	191.39	279	0	0	0	intergen
1	149792548	149792787	MACS_peak_1027	596.12	239	0	1	1	gen
1	150001870	150002221	MACS_peak_1028	464.59	351	0	1	0	gen
1	150050648	150050950	MACS_peak_1029	370.35	302	0	0	1	other
1	150068289	150068520	MACS_peak_1030	744.89	231	1	0	0	promoter
1	150072958	150073235	MACS_peak_1031	566.95	277	0	1	0	gen
1	150092629	150092854	MACS_peak_1032	615.31	225	0	1	0	gen
1	150114982	150115293	MACS_peak_1033	627.75	311	0	1	0	gen
1	150165921	150166284	MACS_peak_1034	644.81	363	0	0	0	intergen
1	150187328	150187596	MACS_peak_1035	584.2	268	0	0	0	intergen
1	150214648	150214825	MACS_peak_1036	1218.65	177	1	0	0	promoter
1	150221633	150221996	MACS_peak_1037	556.44	363	1	0	0	promoter
1	150452559	150452915	MACS_peak_1038	343.22	356	0	1	0	gen
1	150501201	150501421	MACS_peak_1039	360.97	220	0	1	0	gen
1	150532657	150532828	MACS_peak_1040	771.99	171	0	0	0	intergen
1	150560838	150561145	MACS_peak_1041	816.07	307	0	0	1	other
1	150621444	150621908	MACS_peak_1042	554.79	464	0	1	0	gen
1	150631297	150631512	MACS_peak_1043	829.69	215	0	0	0	intergen
1	150813195	150813413	MACS_peak_1045	994.28	218	1	0	0	promoter
1	150922516	150922895	MACS_peak_1046	695.87	379	1	0	0	promoter
1	150979549	150979802	MACS_peak_1047	1965.34	253	1	0	0	promoter
1	150996009	150996354	MACS_peak_1048	783.88	345	1	0	0	promoter
1	151099797	151100096	MACS_peak_1049	1143.98	299	0	1	0	gen
1	151155925	151156288	MACS_peak_1050	1180.37	363	3	0	0	promoter
1	151196176	151196572	MACS_peak_1051	1028.03	396	1	0	0	promoter
1	151251743	151252043	MACS_peak_1052	989.86	300	1	0	0	promoter
1	151534531	151535002	MACS_peak_1053	1070.32	471	0	1	0	gen
1	151594154	151594506	MACS_peak_1054	778.35	352	0	0	0	intergen
1	151641657	151641960	MACS_peak_1055	380.31	303	0	1	0	gen
1	151660232	151660364	MACS_peak_1056	1077.07	132	0	1	0	gen
1	151675593	151675946	MACS_peak_1057	216.68	353	0	1	0	gen
1	151676182	151676345	MACS_peak_1058	277.89	163	0	1	0	gen
1	151693082	151693452	MACS_peak_1059	346.45	370	0	1	0	gen
1	151888886	151889279	MACS_peak_1060	495.92	393	0	1	1	gen
1	151905398	151905534	MACS_peak_1061	1024.03	136	0	1	0	gen
1	151968027	151968392	MACS_peak_1062	1306.2	365	0	0	0	intergen
1	152001755	152002162	MACS_peak_1063	1494.02	407	0	0	1	other
1	152013546	152014025	MACS_peak_1064	860.1	479	0	0	1	other
1	152141874	152142248	MACS_peak_1065	1217.01	374	0	0	1	other
1	152374237	152374448	MACS_peak_1067	449.52	211	0	0	1	other
1	152403230	152403521	MACS_peak_1068	103.45	291	0	0	1	other
1	152433604	152434007	MACS_peak_1069	77.66	403	0	0	1	other
1	152440876	152441234	MACS_peak_1070	629.59	358	0	0	1	other
1	152451672	152451965	MACS_peak_1071	912.13	293	0	0	0	intergen
1	152458511	152458683	MACS_peak_1072	690.17	172	0	0	0	intergen
1	152460329	152460623	MACS_peak_1073	491.46	294	0	0	0	intergen
1	152480216	152480380	MACS_peak_1074	831.63	164	0	0	0	intergen
1	152490089	152490435	MACS_peak_1075	147.64	346	0	0	0	intergen
1	152735685	152736063	MACS_peak_1076	635.08	378	0	0	0	intergen
1	152871174	152871544	MACS_peak_1077	488.85	370	0	0	0	intergen
1	152955726	152956194	MACS_peak_1078	167.18	468	0	0	0	intergen
1	153124303	153124505	MACS_peak_1079	289.07	202	0	0	0	intergen
1	153143307	153143545	MACS_peak_1080	148.57	238	0	0	0	intergen
1	153223111	153223397	MACS_peak_1081	702.3	286	0	0	0	intergen
1	153229300	153229614	MACS_peak_1082	554.47	314	0	0	0	intergen
1	153352413	153352736	MACS_peak_1083	672.92	323	0	0	0	intergen
1	153355511	153355802	MACS_peak_1084	447.93	291	1	0	0	promoter
1	153364100	153364234	MACS_peak_1085	1377.21	134	0	0	0	intergen
1	153495066	153495372	MACS_peak_1086	439.28	306	0	0	0	intergen
1	153580493	153580686	MACS_peak_1087	654.75	193	0	0	0	intergen
1	153736548	153736890	MACS_peak_1088	786.29	342	0	1	0	gen
1	153797347	153797624	MACS_peak_1089	456.44	277	0	1	1	gen
1	153847650	153847851	MACS_peak_1090	554.96	201	0	1	0	gen
1	153904050	153904318	MACS_peak_1091	547.83	268	0	1	0	gen
1	153946630	153946833	MACS_peak_1092	629.38	203	1	0	0	promoter
1	154125655	154125910	MACS_peak_1093	201	255	0	1	0	gen
1	154189006	154189477	MACS_peak_1094	202.06	471	0	1	0	gen
1	154479894	154480078	MACS_peak_1095	918.92	184	0	1	0	gen
1	154534278	154534628	MACS_peak_1096	403.01	350	0	1	0	gen
1	154943865	154944161	MACS_peak_1097	445	296	1	0	0	promoter
1	154999086	154999425	MACS_peak_1098	661.26	339	1	0	0	promoter
1	155061573	155061910	MACS_peak_1099	790.35	337	2	1	0	promoter
1	155086122	155086335	MACS_peak_1100	596.79	213	0	2	0	gen
1	155161151	155161481	MACS_peak_1101	312.33	330	0	0	0	intergen
1	155193551	155193779	MACS_peak_1102	1171.45	228	1	0	0	promoter
1	155250744	155251024	MACS_peak_1103	454.58	280	1	0	0	promoter
1	155277250	155277512	MACS_peak_1104	656.83	262	1	1	0	promoter
1	155494335	155494575	MACS_peak_1105	770.24	240	0	1	0	gen
1	155633857	155634167	MACS_peak_1107	345.15	310	0	0	1	other
1	155837509	155837675	MACS_peak_1108	795.29	166	0	1	0	gen
1	155989469	155989697	MACS_peak_1109	485.73	228	0	1	0	gen
1	156066270	156066588	MACS_peak_1110	498.48	318	0	1	0	gen
1	156146009	156146394	MACS_peak_1111	512.49	385	1	0	0	promoter
1	156183544	156183904	MACS_peak_1112	269.92	360	0	0	0	intergen
1	156192255	156192473	MACS_peak_1113	363.4	218	1	0	0	promoter
1	156317526	156317853	MACS_peak_1114	637.34	327	0	1	0	gen
1	156319683	156319956	MACS_peak_1115	446.99	273	0	1	0	gen
1	156445910	156446141	MACS_peak_1116	510.52	231	0	0	0	intergen
1	156474637	156474833	MACS_peak_1117	662.31	196	0	1	0	gen
1	156584087	156584257	MACS_peak_1118	797.18	170	1	0	0	promoter
1	156719742	156719877	MACS_peak_1119	1630.94	135	1	0	0	promoter
1	157163717	157163880	MACS_peak_1120	848.95	163	0	0	0	intergen
1	157205803	157206177	MACS_peak_1121	229.83	374	0	0	0	intergen
1	157342251	157342513	MACS_peak_1122	154.06	262	0	0	0	intergen
1	157489423	157489686	MACS_peak_1123	590.92	263	0	0	0	intergen
1	157496054	157496351	MACS_peak_1124	693.18	297	0	0	0	intergen
1	157610443	157610735	MACS_peak_1126	64.66	292	0	0	0	intergen
1	157637075	157637304	MACS_peak_1127	676.95	229	0	0	1	other
1	157799338	157799682	MACS_peak_1128	186.49	344	0	0	0	intergen
1	157963731	157963967	MACS_peak_1129	1965.34	236	0	0	0	intergen
1	158308374	158308698	MACS_peak_1132	107.09	324	0	0	0	intergen
1	158387823	158388227	MACS_peak_1133	97.23	404	0	0	0	intergen
1	158736610	158736891	MACS_peak_1134	453.96	281	0	0	0	intergen
1	158761889	158762083	MACS_peak_1135	173.84	194	0	1	0	gen
1	158762556	158762997	MACS_peak_1136	51.59	441	0	1	0	gen
1	158867369	158867662	MACS_peak_1137	392.5	293	0	0	0	intergen
1	158887765	158888165	MACS_peak_1138	109.53	400	0	0	0	intergen
1	158890208	158890630	MACS_peak_1139	61.15	422	0	0	0	intergen
1	158954683	158954987	MACS_peak_1140	56.74	304	0	1	0	gen
1	159132375	159132587	MACS_peak_1143	763.02	212	0	1	0	gen
1	159161026	159161365	MACS_peak_1144	421.69	339	0	0	0	intergen
1	159198045	159198277	MACS_peak_1145	989.9	232	0	1	1	gen
1	159211647	159211887	MACS_peak_1146	516.86	240	0	0	0	intergen
1	159265315	159265664	MACS_peak_1147	129.98	349	0	0	0	intergen
1	159331775	159332162	MACS_peak_1148	137.06	387	0	0	0	intergen
1	159343638	159343894	MACS_peak_1149	470.06	256	0	0	0	intergen
1	159411865	159412202	MACS_peak_1150	131.48	337	0	0	1	other
1	159454482	159454762	MACS_peak_1151	55.24	280	0	0	1	other
1	159458471	159458814	MACS_peak_1152	120.97	343	0	0	1	other
1	159734108	159734398	MACS_peak_1153	127.15	290	0	0	0	intergen
1	159735576	159736016	MACS_peak_1154	171.32	440	0	0	0	intergen
1	160319913	160320045	MACS_peak_1156	1116.4	132	0	1	0	gen
1	160376602	160376858	MACS_peak_1157	596.79	256	0	0	0	intergen
1	160476345	160476575	MACS_peak_1158	59.92	230	0	0	0	intergen
1	160698638	160698843	MACS_peak_1159	886.06	205	0	1	1	gen
1	160726897	160727066	MACS_peak_1160	1025.76	169	0	0	0	intergen
1	160788581	160788886	MACS_peak_1161	264.16	305	0	0	0	intergen
1	160990384	160990561	MACS_peak_1163	1171.45	177	1	0	0	promoter
1	161071838	161072160	MACS_peak_1164	936.39	322	1	0	0	promoter
1	161097641	161097957	MACS_peak_1165	845.32	316	2	0	0	promoter
1	161291495	161291921	MACS_peak_1166	488.85	426	0	0	0	intergen
1	161382066	161382428	MACS_peak_1167	372.06	362	0	0	0	intergen
1	161447724	161448096	MACS_peak_1168	280.74	372	0	0	1	other
1	161455105	161455477	MACS_peak_1169	210.7	372	0	0	1	other
1	161462519	161462887	MACS_peak_1170	284.01	368	0	0	1	other
1	161469896	161470268	MACS_peak_1171	229.83	372	0	0	1	other
1	162065812	162065946	MACS_peak_1172	1359.65	134	1	0	0	promoter
1	162230228	162230484	MACS_peak_1173	470.06	256	0	1	0	gen
1	162392207	162392446	MACS_peak_1174	777.13	239	1	0	0	promoter
1	162589017	162589381	MACS_peak_1175	845.32	364	0	1	0	gen
1	162800248	162800522	MACS_peak_1176	712.68	274	0	1	0	gen
1	162854330	162854541	MACS_peak_1177	763.02	211	0	1	0	gen
1	162880256	162880731	MACS_peak_1178	77.14	475	0	0	0	intergen
1	162880774	162881175	MACS_peak_1179	108.99	401	0	0	0	intergen
1	163170959	163171323	MACS_peak_1180	409.51	364	0	1	1	gen
1	163262418	163262818	MACS_peak_1181	134.77	400	1	1	1	promoter
1	163315876	163316215	MACS_peak_1182	538.66	339	0	2	1	gen
1	163490082	163490405	MACS_peak_1183	81.72	323	0	0	0	intergen
1	163640776	163640998	MACS_peak_1184	92.71	222	0	0	0	intergen
1	163645275	163645561	MACS_peak_1185	111.91	286	0	0	0	intergen
1	163720952	163721170	MACS_peak_1186	580.62	218	0	0	0	intergen
1	163750731	163751053	MACS_peak_1187	72.88	322	0	0	0	intergen
1	164221239	164221580	MACS_peak_1188	64.24	341	0	0	0	intergen
1	164221664	164221952	MACS_peak_1189	83.45	288	0	0	0	intergen
1	164460848	164461142	MACS_peak_1190	118	294	0	0	0	intergen
1	164617951	164618136	MACS_peak_1191	901.33	185	0	1	0	gen
1	164787481	164787732	MACS_peak_1192	613.04	251	0	1	0	gen
1	165075815	165076068	MACS_peak_1193	470.06	253	0	0	0	intergen
1	165114354	165114555	MACS_peak_1194	814.37	201	0	0	0	intergen
1	165143547	165143920	MACS_peak_1195	406.81	373	0	0	0	intergen
1	165717922	165718186	MACS_peak_1196	857.82	264	0	0	0	intergen
1	165752392	165752543	MACS_peak_1197	2840.91	151	0	1	0	gen
1	165964474	165964729	MACS_peak_1198	322.82	255	0	0	0	intergen
1	165971718	165972093	MACS_peak_1199	52.24	375	0	0	0	intergen
1	166133414	166133816	MACS_peak_1201	620.31	402	0	1	0	gen
1	166240764	166241010	MACS_peak_1202	149.83	246	0	0	0	intergen
1	166243746	166244027	MACS_peak_1203	80.97	281	0	0	0	intergen
1	166246276	166246479	MACS_peak_1205	129.05	203	0	0	0	intergen
1	166314573	166314854	MACS_peak_1207	76.3	281	0	0	0	intergen
1	166655423	166655807	MACS_peak_1208	97.94	384	0	0	0	intergen
1	166707990	166708237	MACS_peak_1209	158.47	247	0	0	0	intergen
1	166739817	166740204	MACS_peak_1210	1728.83	387	0	0	0	intergen
1	166943381	166943631	MACS_peak_1211	222.96	250	0	1	0	gen
1	167066617	167066992	MACS_peak_1212	517.89	375	0	1	0	gen
1	167386719	167386914	MACS_peak_1213	662.31	195	0	1	0	gen
1	167556188	167556537	MACS_peak_1214	416.71	349	0	0	0	intergen
1	167687986	167688175	MACS_peak_1215	695.57	189	0	1	0	gen
1	167700645	167700778	MACS_peak_1216	1098.16	133	0	1	0	gen
1	167803428	167803663	MACS_peak_1217	814.37	235	0	0	0	intergen
1	167886201	167886584	MACS_peak_1218	165.11	383	0	1	0	gen
1	168348876	168349289	MACS_peak_1219	319.91	413	0	0	1	other
1	168351102	168351394	MACS_peak_1220	77.87	292	0	0	1	other
1	168353857	168354041	MACS_peak_1221	167.95	184	0	0	1	other
1	168471792	168472269	MACS_peak_1222	588	477	0	0	1	other
1	168545880	168546266	MACS_peak_1223	765.91	386	0	0	0	intergen
1	168574441	168574716	MACS_peak_1224	496.66	275	1	0	0	promoter
1	168661816	168662163	MACS_peak_1225	102.89	347	0	0	0	intergen
1	169072185	169072626	MACS_peak_1226	243.49	441	0	0	2	other
1	169089589	169089828	MACS_peak_1227	1478.82	239	0	0	1	other
1	169251711	169252060	MACS_peak_1228	90.94	349	0	1	0	gen
1	169277160	169277588	MACS_peak_1229	55.19	428	0	1	0	gen
1	169348404	169348827	MACS_peak_1230	851.9	423	0	1	0	gen
1	169354898	169355360	MACS_peak_1231	745.14	462	0	1	0	gen
1	169466319	169466568	MACS_peak_1232	613.04	249	1	0	0	promoter
1	169694271	169694609	MACS_peak_1233	1195.93	338	1	1	0	promoter
1	169699853	169700162	MACS_peak_1234	744.15	309	0	2	0	gen
1	169735406	169735736	MACS_peak_1235	265.34	330	0	2	0	gen
1	170124673	170125001	MACS_peak_1237	84.4	328	0	0	0	intergen
1	170373017	170373405	MACS_peak_1238	140.36	388	0	0	0	intergen
1	170394419	170394651	MACS_peak_1239	447.01	232	0	0	0	intergen
1	171081259	171081639	MACS_peak_1241	320.83	380	0	0	0	intergen
1	171188675	171189006	MACS_peak_1243	488.85	331	1	0	0	promoter
1	171374594	171374907	MACS_peak_1244	57.05	313	0	0	0	intergen
1	171485134	171485489	MACS_peak_1245	413.79	355	1	0	0	promoter
1	171715947	171716242	MACS_peak_1246	963.62	295	0	1	0	gen
1	171801489	171801778	MACS_peak_1247	699.78	289	0	1	0	gen
1	172041714	172041981	MACS_peak_1249	1688.42	267	0	1	0	gen
1	172090317	172090577	MACS_peak_1251	593.56	260	0	1	0	gen
1	172232664	172233032	MACS_peak_1252	167.74	368	0	1	0	gen
1	172319155	172319408	MACS_peak_1253	104.5	253	0	1	0	gen
1	172399566	172399778	MACS_peak_1254	596.79	212	0	2	0	gen
1	172806915	172807275	MACS_peak_1255	114.19	360	0	0	1	other
1	172987814	172988294	MACS_peak_1256	70.51	480	0	0	1	other
1	173026051	173026281	MACS_peak_1257	831.63	230	0	0	1	other
1	173202331	173202666	MACS_peak_1258	664.12	335	0	1	0	gen
1	173255104	173255571	MACS_peak_1259	1073.54	467	0	0	0	intergen
1	173324945	173325387	MACS_peak_1260	91.3	442	0	0	0	intergen
1	173326509	173326936	MACS_peak_1261	55.45	427	0	0	0	intergen
1	173420241	173420699	MACS_peak_1262	952.43	458	0	0	1	other
1	173614371	173614642	MACS_peak_1263	568.73	271	0	1	0	gen
1	173728998	173729373	MACS_peak_1264	101.21	375	0	1	0	gen
1	173730240	173730423	MACS_peak_1265	138.14	183	0	1	0	gen
1	173973967	173974317	MACS_peak_1266	478.89	350	0	1	0	gen
1	174114921	174115160	MACS_peak_1267	541.53	239	0	0	0	intergen
1	174217744	174218033	MACS_peak_1268	1255.49	289	0	1	0	gen
1	174227090	174227394	MACS_peak_1269	506.92	304	0	1	0	gen
1	174262666	174262958	MACS_peak_1271	829.92	292	0	1	0	gen
1	174284497	174284861	MACS_peak_1272	201.59	364	0	1	0	gen
1	174363395	174363582	MACS_peak_1273	650.69	187	0	1	0	gen
1	174501780	174502080	MACS_peak_1274	690.75	300	0	1	0	gen
1	174629950	174630410	MACS_peak_1275	73.9	460	0	1	0	gen
1	174633798	174634124	MACS_peak_1276	60.48	326	0	1	0	gen
1	174634330	174634693	MACS_peak_1277	77.21	363	0	1	0	gen
1	174690000	174690173	MACS_peak_1278	600.66	173	0	1	0	gen
1	174694400	174694675	MACS_peak_1279	63.81	275	0	1	0	gen
1	174744059	174744332	MACS_peak_1280	2071.48	273	0	1	0	gen
1	174769937	174770358	MACS_peak_1281	590.81	421	0	1	0	gen
1	174838929	174839125	MACS_peak_1282	514.01	196	0	1	0	gen
1	174847480	174847768	MACS_peak_1283	60.64	288	0	1	0	gen
1	174896185	174896555	MACS_peak_1284	55.64	370	0	1	0	gen
1	174947059	174947441	MACS_peak_1285	358.88	382	0	1	1	gen
1	174986968	174987260	MACS_peak_1286	1107.47	292	0	1	0	gen
1	175042630	175042825	MACS_peak_1287	662.31	195	0	0	0	intergen
1	175146732	175146919	MACS_peak_1288	515.24	187	0	1	0	gen
1	175154902	175155172	MACS_peak_1289	460.86	270	1	0	0	promoter
1	175175231	175175445	MACS_peak_1290	238.91	214	0	1	0	gen
1	175319767	175319958	MACS_peak_1291	695.57	191	1	0	1	promoter
1	175943571	175943715	MACS_peak_1293	863.14	144	1	0	0	promoter
1	175950195	175950451	MACS_peak_1294	596.79	256	0	1	0	gen
1	175996219	175996618	MACS_peak_1295	75.33	399	0	1	0	gen
1	176003321	176003636	MACS_peak_1296	62.38	315	0	1	0	gen
1	176005152	176005533	MACS_peak_1297	59.15	381	0	1	0	gen
1	176005772	176006084	MACS_peak_1298	81.45	312	0	1	0	gen
1	176235397	176235758	MACS_peak_1299	158.81	361	0	0	0	intergen
1	176256690	176257089	MACS_peak_1300	69.2	399	0	0	0	intergen
1	176288723	176288993	MACS_peak_1301	488.85	270	0	0	0	intergen
1	176691733	176692136	MACS_peak_1302	503.12	403	0	1	0	gen
1	176751420	176751741	MACS_peak_1303	83.35	321	0	1	0	gen
1	176843615	176844004	MACS_peak_1304	679.88	389	0	1	0	gen
1	177185337	177185586	MACS_peak_1305	485.56	249	0	1	0	gen
1	177201712	177202135	MACS_peak_1306	109.53	423	0	1	0	gen
1	177202985	177203257	MACS_peak_1307	165.95	272	0	1	0	gen
1	177362968	177363259	MACS_peak_1308	506.92	291	0	0	1	other
1	177399020	177399499	MACS_peak_1309	350.1	479	0	0	1	other
1	177403375	177403655	MACS_peak_1310	96.31	280	0	0	1	other
1	177405672	177405987	MACS_peak_1311	165.96	315	0	0	1	other
1	177638972	177639290	MACS_peak_1313	59.37	318	0	0	0	intergen
1	177694113	177694449	MACS_peak_1314	127.5	336	0	0	0	intergen
1	177695763	177696112	MACS_peak_1315	76.25	349	0	0	0	intergen
1	177844358	177844685	MACS_peak_1316	64.45	327	0	0	0	intergen
1	177844736	177845047	MACS_peak_1317	125.68	311	0	0	0	intergen
1	178344534	178344779	MACS_peak_1319	501.16	245	0	1	0	gen
1	178532347	178532553	MACS_peak_1320	629.38	206	0	1	0	gen
1	178778164	178778482	MACS_peak_1321	79.21	318	0	1	0	gen
1	178804467	178804847	MACS_peak_1322	93.4	380	0	1	0	gen
1	178805290	178805588	MACS_peak_1323	62.38	298	0	1	0	gen
1	178990924	178991277	MACS_peak_1324	72.02	353	0	0	0	intergen
1	178992905	178993258	MACS_peak_1325	158.32	353	0	0	0	intergen
1	179059964	179060129	MACS_peak_1326	752.29	165	0	1	0	gen
1	179079297	179079672	MACS_peak_1327	636.99	375	1	0	0	promoter
1	179105410	179105737	MACS_peak_1328	546.09	327	0	1	0	gen
1	179121038	179121333	MACS_peak_1329	445.58	295	0	1	0	gen
1	179193884	179194123	MACS_peak_1330	644.37	239	0	1	0	gen
1	179251774	179251979	MACS_peak_1331	1153.04	205	0	0	0	intergen
1	179344250	179344401	MACS_peak_1332	453.42	151	0	1	0	gen
1	179369842	179370075	MACS_peak_1333	424.77	233	1	0	0	promoter
1	179463628	179463929	MACS_peak_1334	75.92	301	0	1	0	gen
1	179599726	179599948	MACS_peak_1335	1019.02	222	0	1	0	gen
1	179688546	179688836	MACS_peak_1336	82.63	290	0	1	0	gen
1	180057388	180057618	MACS_peak_1337	472.7	230	0	1	0	gen
1	180168756	180169025	MACS_peak_1338	586.5	269	0	1	0	gen
1	180178922	180179144	MACS_peak_1339	1745.55	222	0	1	0	gen
1	180188231	180188487	MACS_peak_1340	470.06	256	0	1	0	gen
1	180302996	180303428	MACS_peak_1341	82.07	432	0	1	0	gen
1	180365154	180365389	MACS_peak_1342	502.51	235	0	1	0	gen
1	180415997	180416286	MACS_peak_1343	449.12	289	0	1	0	gen
1	180454157	180454526	MACS_peak_1344	138.6	369	0	1	0	gen
1	180651103	180651235	MACS_peak_1345	932.35	132	0	1	0	gen
1	180656314	180656763	MACS_peak_1346	1088.37	449	0	1	0	gen
1	180683895	180684297	MACS_peak_1347	109.53	402	0	1	0	gen
1	180686056	180686478	MACS_peak_1348	159.03	422	0	1	0	gen
1	180699429	180699694	MACS_peak_1349	98.73	265	0	1	0	gen
1	180771039	180771424	MACS_peak_1350	512.49	385	0	1	0	gen
1	180778801	180779121	MACS_peak_1351	406.81	320	0	1	0	gen
1	180781922	180782329	MACS_peak_1352	662.91	407	0	1	0	gen
1	180866961	180867267	MACS_peak_1353	70.26	306	0	1	0	gen
1	181018280	181018657	MACS_peak_1355	312.33	377	0	1	0	gen
1	181166719	181166941	MACS_peak_1356	831.64	222	0	0	0	intergen
1	181189916	181190287	MACS_peak_1357	913.62	371	0	0	0	intergen
1	181213895	181214028	MACS_peak_1358	1365.09	133	0	0	0	intergen
1	181424984	181425230	MACS_peak_1360	1208.41	246	0	1	0	gen
1	181479189	181479471	MACS_peak_1361	1264.83	282	0	1	0	gen
1	181685176	181685308	MACS_peak_1362	1116.4	132	0	1	0	gen
1	181886075	181886461	MACS_peak_1363	81.72	386	0	0	0	intergen
1	182446714	182447052	MACS_peak_1365	523.37	338	0	1	0	gen
1	182508701	182509050	MACS_peak_1366	204.27	349	0	1	0	gen
1	182595705	182595929	MACS_peak_1367	482.68	224	1	0	0	promoter
1	182784642	182784853	MACS_peak_1368	1116.4	211	1	0	0	promoter
1	182962565	182962866	MACS_peak_1369	563.21	301	0	0	0	intergen
1	182980543	182980833	MACS_peak_1370	121.69	290	0	0	0	intergen
1	183297270	183297419	MACS_peak_1372	1472.64	149	0	1	0	gen
1	183609347	183609506	MACS_peak_1373	1098.16	159	0	0	0	intergen
1	183655437	183655723	MACS_peak_1375	396.67	286	0	1	0	gen
1	184338295	184338586	MACS_peak_1376	107.36	291	0	0	0	intergen
1	184339969	184340356	MACS_peak_1377	150.01	387	0	0	0	intergen
1	184431909	184432241	MACS_peak_1378	142.61	332	0	1	0	gen
1	184551036	184551364	MACS_peak_1379	545.46	328	0	1	0	gen
1	184563381	184563656	MACS_peak_1380	457.69	275	0	1	0	gen
1	184691860	184692081	MACS_peak_1381	729.14	221	1	0	0	promoter
1	184783215	184783653	MACS_peak_1382	402.46	438	0	0	0	intergen
1	184851022	184851355	MACS_peak_1384	73.9	333	0	1	0	gen
1	185001929	185002226	MACS_peak_1385	136.65	297	0	0	1	other
1	185004424	185004669	MACS_peak_1386	63.24	245	0	0	1	other
1	185170467	185170714	MACS_peak_1387	629.38	247	0	1	0	gen
1	185378474	185378763	MACS_peak_1388	127.5	289	0	0	0	intergen
1	185379092	185379377	MACS_peak_1389	103.77	285	0	0	0	intergen
1	185559966	185560160	MACS_peak_1390	819.6	194	0	0	1	other
1	185640432	185640723	MACS_peak_1391	107.36	291	0	0	0	intergen
1	185641557	185641831	MACS_peak_1392	214.48	274	0	0	0	intergen
1	185720641	185720938	MACS_peak_1395	550.01	297	0	0	0	intergen
1	185813347	185813663	MACS_peak_1396	808.09	316	0	1	0	gen
1	185951834	185952183	MACS_peak_1397	137.17	349	0	1	0	gen
1	186158003	186158328	MACS_peak_1398	103.41	325	0	1	0	gen
1	186256665	186257038	MACS_peak_1399	100.22	373	0	0	0	intergen
1	186257410	186257721	MACS_peak_1400	69.97	311	0	0	0	intergen
1	186305019	186305389	MACS_peak_1401	640.22	370	0	1	0	gen
1	186325248	186325544	MACS_peak_1402	1393.1	296	0	1	0	gen
1	186404334	186404724	MACS_peak_1403	866.05	390	1	1	0	promoter
1	186482651	186482905	MACS_peak_1404	580.75	254	0	0	0	intergen
1	186642592	186642883	MACS_peak_1405	143.24	291	0	0	0	intergen
1	186809245	186809601	MACS_peak_1406	84.4	356	0	0	0	intergen
1	186817511	186817803	MACS_peak_1407	534.92	292	0	0	0	intergen
1	186827540	186827688	MACS_peak_1408	686.78	148	1	0	0	promoter
1	186985998	186986212	MACS_peak_1409	726.99	214	0	1	0	gen
1	187051665	187051906	MACS_peak_1410	588.69	241	0	0	0	intergen
1	187265044	187265337	MACS_peak_1411	696.46	293	0	0	1	other
1	187332130	187332521	MACS_peak_1412	92.15	391	0	0	1	other
1	187432346	187432622	MACS_peak_1413	603.02	276	0	0	1	other
1	187476762	187476986	MACS_peak_1414	712.32	224	0	0	1	other
1	187602693	187603058	MACS_peak_1416	57.89	365	0	0	1	other
1	187603140	187603434	MACS_peak_1417	142.72	294	0	0	1	other
1	187606623	187606825	MACS_peak_1418	635.58	202	0	0	1	other
1	187611148	187611372	MACS_peak_1419	435.1	224	0	0	1	other
1	187830683	187830957	MACS_peak_1420	105.8	274	0	0	0	intergen
1	187890012	187890189	MACS_peak_1421	748.7	177	0	0	0	intergen
1	188009002	188009224	MACS_peak_1422	461.43	222	0	0	0	intergen
1	188163655	188163882	MACS_peak_1423	548.55	227	0	0	0	intergen
1	188727222	188727579	MACS_peak_1424	1011.46	357	0	0	0	intergen
1	188754139	188754496	MACS_peak_1426	115.17	357	0	0	0	intergen
1	188754958	188755302	MACS_peak_1427	68.93	344	0	0	0	intergen
1	188786019	188786425	MACS_peak_1428	617.94	406	0	0	0	intergen
1	188942341	188942618	MACS_peak_1429	534.92	277	0	0	1	other
1	188942845	188943136	MACS_peak_1430	403.4	291	0	0	1	other
1	189210239	189210622	MACS_peak_1431	57.96	383	0	0	0	intergen
1	189327831	189328162	MACS_peak_1432	63.13	331	0	0	0	intergen
1	189414316	189414682	MACS_peak_1433	171.76	366	0	0	0	intergen
1	189448209	189448630	MACS_peak_1434	953.02	421	0	0	0	intergen
1	189511910	189512139	MACS_peak_1435	533.53	229	0	0	0	intergen
1	189646425	189646805	MACS_peak_1437	633.81	380	0	0	0	intergen
1	189992114	189992339	MACS_peak_1438	686.79	225	0	0	1	other
1	190031933	190032190	MACS_peak_1439	398.3	257	0	0	0	intergen
1	190054378	190054603	MACS_peak_1440	712.32	225	0	0	0	intergen
1	190299544	190299827	MACS_peak_1441	121.29	283	0	1	1	gen
1	190327313	190327461	MACS_peak_1442	1026.39	148	0	1	1	gen
1	190373817	190374037	MACS_peak_1443	564.54	220	0	1	0	gen
1	190385580	190386016	MACS_peak_1444	205.84	436	0	1	0	gen
1	190433572	190433768	MACS_peak_1445	827.89	196	0	1	0	gen
1	190453635	190453856	MACS_peak_1446	456.51	221	0	1	0	gen
1	190734095	190734542	MACS_peak_1447	93.25	447	0	0	1	other
1	190957591	190957821	MACS_peak_1448	532.66	230	0	0	1	other
1	190969363	190969625	MACS_peak_1449	588.86	262	0	0	1	other
1	191089100	191089286	MACS_peak_1450	676.7	186	0	0	1	other
1	191232553	191232753	MACS_peak_1451	793.98	200	0	0	0	intergen
1	191388573	191388897	MACS_peak_1452	806.6	324	0	0	0	intergen
1	191434117	191434541	MACS_peak_1453	492.72	424	0	0	0	intergen
1	191750808	191751165	MACS_peak_1454	845.32	357	0	0	0	intergen
1	191776383	191776639	MACS_peak_1455	376.28	256	0	0	0	intergen
1	192094665	192094982	MACS_peak_1457	54.21	317	0	0	0	intergen
1	192215053	192215352	MACS_peak_1458	127.5	299	0	0	1	other
1	192311326	192311603	MACS_peak_1459	1125.73	277	0	0	1	other
1	192430192	192430478	MACS_peak_1460	437.62	286	0	0	1	other
1	192474073	192474366	MACS_peak_1461	828.97	293	0	0	1	other
1	192484329	192484530	MACS_peak_1462	223.12	201	0	0	1	other
1	192502074	192502423	MACS_peak_1463	58.76	349	0	0	1	other
1	192532314	192532638	MACS_peak_1464	65.45	324	0	0	2	other
1	192610090	192610483	MACS_peak_1465	1004.98	393	0	0	1	other
1	192795789	192796012	MACS_peak_1466	870.43	223	0	0	1	other
1	192865716	192865849	MACS_peak_1467	1686.4	133	0	0	1	other
1	193183105	193183424	MACS_peak_1469	811.38	319	1	1	0	promoter
1	193254733	193255107	MACS_peak_1470	1059.4	374	0	0	0	intergen
1	193371815	193371947	MACS_peak_1471	1116.4	132	0	0	0	intergen
1	193406930	193407188	MACS_peak_1472	727.26	258	0	0	0	intergen
1	193428491	193428794	MACS_peak_1473	142.05	303	0	0	0	intergen
1	193622745	193622895	MACS_peak_1474	829.46	150	0	0	0	intergen
1	193867472	193867822	MACS_peak_1475	534.31	350	0	0	0	intergen
1	194017575	194017799	MACS_peak_1476	122.15	224	0	0	0	intergen
1	194098973	194099305	MACS_peak_1477	488.85	332	0	0	0	intergen
1	194899419	194899780	MACS_peak_1479	312.33	361	0	0	1	other
1	195345183	195345412	MACS_peak_1480	548.55	229	0	0	0	intergen
1	195551369	195551647	MACS_peak_1481	82.89	278	0	0	0	intergen
1	195556759	195556975	MACS_peak_1482	321.75	216	0	0	0	intergen
1	195602027	195602331	MACS_peak_1483	603.02	304	0	0	0	intergen
1	195608829	195609156	MACS_peak_1484	522.11	327	0	0	0	intergen
1	195801702	195802151	MACS_peak_1485	181.92	449	0	0	0	intergen
1	195890087	195890436	MACS_peak_1486	654.27	349	0	0	0	intergen
1	195916154	195916527	MACS_peak_1487	201.59	373	0	0	0	intergen
1	195961509	195961833	MACS_peak_1488	416.21	324	0	0	0	intergen
1	196137158	196137304	MACS_peak_1489	2060.3	146	0	0	0	intergen
1	196162054	196162238	MACS_peak_1490	1012.44	184	0	0	0	intergen
1	196182823	196183107	MACS_peak_1491	816.25	284	0	0	0	intergen
1	196219487	196219872	MACS_peak_1492	53.61	385	0	0	0	intergen
1	196317868	196318219	MACS_peak_1493	652.89	351	0	1	0	gen
1	196372915	196373284	MACS_peak_1494	406.81	369	0	1	0	gen
1	196471512	196471800	MACS_peak_1495	488.85	288	0	1	0	gen
1	196594878	196595128	MACS_peak_1496	745.79	250	0	1	0	gen
1	196723294	196723646	MACS_peak_1497	652.21	352	0	1	0	gen
1	196743290	196743527	MACS_peak_1498	893.03	237	0	1	0	gen
1	196752896	196753072	MACS_peak_1499	670.5	176	0	0	0	intergen
1	196827855	196828114	MACS_peak_1500	745.06	259	0	1	0	gen
1	196837579	196837788	MACS_peak_1501	839.71	209	0	0	0	intergen
1	196877294	196877608	MACS_peak_1502	337.07	314	0	0	1	other
1	196881426	196881740	MACS_peak_1503	208.44	314	0	0	1	other
1	197180312	197180754	MACS_peak_1504	597.62	442	0	1	0	gen
1	197215161	197215296	MACS_peak_1505	900.67	135	0	0	0	intergen
1	197327894	197328126	MACS_peak_1506	532.66	232	0	1	0	gen
1	197399999	197400332	MACS_peak_1507	1236.43	333	0	1	0	gen
1	197526815	197527134	MACS_peak_1508	880.59	319	0	1	0	gen
1	197615148	197615422	MACS_peak_1509	488.85	274	0	1	0	gen
1	197619104	197619365	MACS_peak_1510	860.98	261	0	1	0	gen
1	197709846	197710272	MACS_peak_1512	60.03	426	0	1	0	gen
1	197713679	197713993	MACS_peak_1513	369.05	314	0	1	0	gen
1	197739627	197739834	MACS_peak_1514	756.91	207	0	1	0	gen
1	198250462	198250896	MACS_peak_1515	118.84	434	0	1	0	gen
1	198433484	198433756	MACS_peak_1516	488.85	272	0	0	0	intergen
1	198465494	198465896	MACS_peak_1517	506.92	402	0	0	0	intergen
1	198508941	198509185	MACS_peak_1518	501.16	244	0	0	0	intergen
1	198743266	198743519	MACS_peak_1519	176.62	253	0	1	0	gen
1	198756490	198756838	MACS_peak_1520	403.99	348	0	1	0	gen
1	198771590	198771811	MACS_peak_1521	557.29	221	0	0	0	intergen
1	198792070	198792410	MACS_peak_1522	312.33	340	0	0	0	intergen
1	198798783	198799053	MACS_peak_1523	460.86	270	0	0	0	intergen
1	199463598	199463948	MACS_peak_1524	416.22	350	0	0	0	intergen
1	199470527	199470921	MACS_peak_1525	94.22	394	0	0	0	intergen
1	199552088	199552267	MACS_peak_1526	682.16	179	0	0	0	intergen
1	199684702	199685027	MACS_peak_1528	671.43	325	0	0	0	intergen
1	200061920	200062255	MACS_peak_1529	645.54	335	0	1	0	gen
1	200103709	200103999	MACS_peak_1530	435.23	290	0	1	0	gen
1	200139977	200140208	MACS_peak_1531	483.43	231	0	1	0	gen
1	200187942	200188332	MACS_peak_1532	57.86	390	0	0	0	intergen
1	200307330	200307798	MACS_peak_1534	1203.54	468	0	0	1	other
1	200397733	200397867	MACS_peak_1535	1546.53	134	0	0	2	other
1	200558905	200559318	MACS_peak_1536	663.59	413	0	1	0	gen
1	200622188	200622563	MACS_peak_1537	847.25	375	1	0	0	promoter
1	200797280	200797640	MACS_peak_1538	178.5	360	0	1	0	gen
1	200802936	200803207	MACS_peak_1539	722.93	271	0	1	0	gen
1	200837974	200838268	MACS_peak_1540	552.11	294	0	1	0	gen
1	200885278	200885555	MACS_peak_1541	380.3	277	0	0	0	intergen
1	200903650	200903938	MACS_peak_1542	334.82	288	0	1	0	gen
1	201042977	201043320	MACS_peak_1543	1025.23	343	1	0	0	promoter
1	201114182	201114356	MACS_peak_1544	724.87	174	1	0	0	promoter
1	201149500	201149755	MACS_peak_1545	602.09	255	0	1	0	gen
1	201234797	201235218	MACS_peak_1546	67.19	421	0	0	0	intergen
1	201254609	201254825	MACS_peak_1547	1805.04	216	0	0	0	intergen
1	201408326	201408503	MACS_peak_1548	972.07	177	1	0	0	promoter
1	201448095	201448377	MACS_peak_1549	1119.53	282	0	0	0	intergen
1	201513013	201513344	MACS_peak_1550	1317.25	331	0	0	1	other
1	201559560	201559886	MACS_peak_1551	670.69	326	0	0	1	other
1	201602549	201602891	MACS_peak_1552	312.33	342	0	0	0	intergen
1	202063633	202063916	MACS_peak_1553	601.91	283	0	0	0	intergen
1	202070843	202071042	MACS_peak_1554	809.56	199	0	0	0	intergen
1	202119014	202119250	MACS_peak_1555	440.38	236	1	0	0	promoter
1	202135245	202135440	MACS_peak_1556	1043.77	195	1	0	0	promoter
1	202192755	202193046	MACS_peak_1558	530.85	291	1	0	0	promoter
1	202236328	202236622	MACS_peak_1559	446.16	294	0	1	0	gen
1	202332073	202332229	MACS_peak_1560	808.51	156	1	0	0	promoter
1	202336140	202336337	MACS_peak_1561	399.74	197	1	0	0	promoter
1	202380198	202380501	MACS_peak_1562	558.67	303	0	1	0	gen
1	202464213	202464517	MACS_peak_1563	501.47	304	0	1	0	gen
1	202501371	202501584	MACS_peak_1564	763.02	213	0	1	0	gen
1	202571777	202572066	MACS_peak_1565	1255.49	289	0	1	0	gen
1	202614478	202614743	MACS_peak_1566	301.35	265	0	1	0	gen
1	202661229	202661448	MACS_peak_1567	573.21	219	0	1	0	gen
1	202719725	202719997	MACS_peak_1568	366.02	272	1	0	0	promoter
1	202852277	202852679	MACS_peak_1569	487.83	402	0	0	1	other
1	202970844	202970977	MACS_peak_1570	733.5	133	0	0	0	intergen
1	202999327	202999594	MACS_peak_1571	449.45	267	0	0	0	intergen
1	203022950	203023252	MACS_peak_1572	799.29	302	1	1	0	promoter
1	203039381	203039679	MACS_peak_1573	330.94	298	0	1	0	gen
1	203166555	203166728	MACS_peak_1574	1434.33	173	1	1	0	promoter
1	203172225	203172472	MACS_peak_1575	485.56	247	1	0	0	promoter
1	203234592	203234956	MACS_peak_1576	178.37	364	0	1	0	gen
1	203258946	203259177	MACS_peak_1577	138.64	231	0	1	0	gen
1	203260849	203261079	MACS_peak_1578	123.06	230	0	1	0	gen
1	203261381	203261741	MACS_peak_1579	147.8	360	0	1	0	gen
1	203267292	203267539	MACS_peak_1580	468.37	247	0	1	0	gen
1	203269136	203269352	MACS_peak_1581	1079.97	216	0	1	0	gen
1	203338501	203338742	MACS_peak_1582	1535.04	241	1	0	0	promoter
1	203340160	203340370	MACS_peak_1583	613.04	210	1	0	0	promoter
1	203342565	203342789	MACS_peak_1584	564.54	224	1	0	0	promoter
1	203358313	203358556	MACS_peak_1585	239.85	243	0	0	0	intergen
1	203385326	203385521	MACS_peak_1586	741.54	195	0	0	0	intergen
1	203393101	203393353	MACS_peak_1587	75.51	252	0	0	0	intergen
1	203487709	203488092	MACS_peak_1588	858.72	383	0	1	0	gen
1	203504489	203504970	MACS_peak_1589	935.65	481	0	1	0	gen
1	203593703	203593890	MACS_peak_1590	783.55	187	0	0	0	intergen
1	203612742	203612875	MACS_peak_1591	1241.54	133	0	0	0	intergen
1	203751800	203752037	MACS_peak_1592	375.48	237	0	0	0	intergen
1	203830819	203831066	MACS_peak_1593	160.74	247	0	2	0	gen
1	203861180	203861615	MACS_peak_1594	1877.72	435	1	0	0	promoter
1	203871054	203871271	MACS_peak_1595	1239.92	217	0	0	0	intergen
1	203918520	203918868	MACS_peak_1596	117.31	348	0	0	0	intergen
1	203980965	203981300	MACS_peak_1597	410.5	335	0	0	0	intergen
1	203984358	203984595	MACS_peak_1598	282.93	237	0	0	0	intergen
1	204127633	204127922	MACS_peak_1599	1255.49	289	1	0	0	promoter
1	204162396	204162852	MACS_peak_1600	1785.49	456	0	1	0	gen
1	204169782	204170043	MACS_peak_1601	818.32	261	0	1	0	gen
1	204214135	204214541	MACS_peak_1602	993.79	406	1	0	0	promoter
1	204258474	204258694	MACS_peak_1603	729.14	220	0	1	0	gen
1	204268573	204268706	MACS_peak_1604	1396.21	133	0	1	0	gen
1	204366845	204367099	MACS_peak_1605	511.33	254	0	1	0	gen
1	204398510	204398822	MACS_peak_1606	555.79	312	1	0	1	promoter
1	204431337	204431769	MACS_peak_1607	845.4	432	0	1	1	gen
1	204503225	204503439	MACS_peak_1608	596.79	214	0	0	0	intergen
1	204527094	204527312	MACS_peak_1609	629.32	218	0	1	0	gen
1	204791740	204792151	MACS_peak_1610	1121.8	411	0	0	0	intergen
1	204827067	204827317	MACS_peak_1612	613.04	250	1	0	0	promoter
1	204975664	204975987	MACS_peak_1613	603.02	323	0	1	0	gen
1	205061627	205061970	MACS_peak_1614	721.05	343	0	1	0	gen
1	205122227	205122492	MACS_peak_1615	553.87	265	0	0	0	intergen
1	205141697	205142056	MACS_peak_1616	797.85	359	1	0	0	promoter
1	205256289	205256551	MACS_peak_1617	466.05	262	0	1	0	gen
1	205330810	205331074	MACS_peak_1618	464.74	264	0	0	0	intergen
1	205335593	205335927	MACS_peak_1619	603.02	334	1	0	0	promoter
1	205354351	205354659	MACS_peak_1620	1089.02	308	0	1	0	gen
1	205396920	205397334	MACS_peak_1621	760.87	414	0	1	0	gen
1	205413456	205413605	MACS_peak_1623	954.29	149	0	1	0	gen
1	205423316	205423570	MACS_peak_1624	858.55	254	0	1	0	gen
1	205528977	205529242	MACS_peak_1625	589.61	265	0	1	0	gen
1	205591834	205592085	MACS_peak_1626	703.53	251	0	1	0	gen
1	205648197	205648405	MACS_peak_1627	332.68	208	0	0	0	intergen
1	205658960	205659108	MACS_peak_1628	954.29	148	1	0	0	promoter
1	205717975	205718108	MACS_peak_1629	1201.31	133	0	1	0	gen
1	205810553	205810772	MACS_peak_1630	528	219	0	1	0	gen
1	205852203	205852464	MACS_peak_1631	440.11	261	0	0	0	intergen
1	205907789	205908120	MACS_peak_1632	417.33	331	0	0	0	intergen
1	206233274	206233613	MACS_peak_1633	495.28	339	0	1	0	gen
1	206175583	206175900	MACS_peak_1634	395.81	317	0	0	1	other
1	206032275	206032587	MACS_peak_1636	435.94	312	0	0	0	intergen
1	206331636	206331945	MACS_peak_1637	56.98	309	0	1	0	gen
1	206384890	206385231	MACS_peak_1638	264.38	341	0	1	0	gen
1	206479542	206479827	MACS_peak_1639	974.35	285	0	1	0	gen
1	206524535	206524837	MACS_peak_1641	820.61	302	0	1	0	gen
1	206546000	206546223	MACS_peak_1642	301.67	223	0	1	0	gen
1	206583756	206583992	MACS_peak_1643	814.37	236	0	2	0	gen
1	206734553	206734874	MACS_peak_1645	1074.74	321	0	0	0	intergen
1	206738982	206739270	MACS_peak_1646	572.35	288	0	0	0	intergen
1	206760118	206760259	MACS_peak_1647	553.78	141	0	0	0	intergen
1	206864937	206865251	MACS_peak_1648	554.47	314	1	0	0	promoter
1	206911150	206911469	MACS_peak_1649	1658.62	319	0	1	0	gen
1	207041299	207041607	MACS_peak_1650	178.37	308	1	1	0	promoter
1	207049985	207050191	MACS_peak_1651	573.39	206	0	2	0	gen
1	207077865	207078127	MACS_peak_1652	1292.87	262	0	1	0	gen
1	207181841	207182263	MACS_peak_1653	608.69	422	0	0	2	other
1	207220023	207220155	MACS_peak_1654	1116.4	132	0	0	0	intergen
1	207231669	207231993	MACS_peak_1655	436.19	324	0	0	0	intergen
1	207405043	207405445	MACS_peak_1656	675.5	402	0	0	1	other
1	207494940	207495078	MACS_peak_1657	1043.77	138	1	0	0	promoter
1	207499588	207499875	MACS_peak_1658	701.46	287	1	0	0	promoter
1	207620373	207620718	MACS_peak_1659	2135.63	345	0	1	0	gen
1	207654387	207654628	MACS_peak_1660	1245.57	241	0	1	1	gen
1	207698978	207699283	MACS_peak_1661	439.84	305	0	1	0	gen
1	207718981	207719342	MACS_peak_1662	103.45	361	0	1	0	gen
1	207721491	207721753	MACS_peak_1663	135.52	262	0	1	0	gen
1	207726380	207726628	MACS_peak_1664	265.58	248	0	1	0	gen
1	207734167	207734486	MACS_peak_1665	55.34	319	0	1	0	gen
1	207797374	207797607	MACS_peak_1666	972.07	233	0	0	0	intergen
1	208744683	208744911	MACS_peak_1667	342.86	228	0	0	0	intergen
1	209281378	209281791	MACS_peak_1668	59.32	413	0	0	0	intergen
1	209284065	209284296	MACS_peak_1669	314.13	231	0	0	0	intergen
1	209726268	209726580	MACS_peak_1670	470.9	312	0	1	0	gen
1	210013610	210013881	MACS_peak_1671	460.22	271	0	1	0	gen
1	210066024	210066423	MACS_peak_1672	105.65	399	0	1	0	gen
1	210374394	210374703	MACS_peak_1673	557.79	309	0	1	0	gen
1	210442001	210442405	MACS_peak_1674	115.69	404	0	1	0	gen
1	210448227	210448595	MACS_peak_1675	232.01	368	0	1	0	gen
1	210950055	210950235	MACS_peak_1676	382.98	180	0	2	0	gen
1	212070652	212070996	MACS_peak_1677	419.18	344	0	1	0	gen
1	212455918	212456230	MACS_peak_1678	1084.56	312	0	0	0	intergen
1	212630125	212630362	MACS_peak_1679	662.31	237	0	0	0	intergen
1	213074736	213075009	MACS_peak_1680	458.95	273	0	1	0	gen
1	213179857	213180057	MACS_peak_1681	645.81	200	0	1	0	gen
1	213345254	213345467	MACS_peak_1682	596.79	213	0	0	0	intergen
1	213374394	213374564	MACS_peak_1683	797.18	170	0	0	0	intergen
1	214833976	214834289	MACS_peak_1684	1198.83	313	0	0	0	intergen
1	214868560	214868844	MACS_peak_1685	140.69	284	0	0	0	intergen
1	214878894	214879230	MACS_peak_1686	62.38	336	0	0	0	intergen
1	215093367	215093734	MACS_peak_1687	315.9	367	0	1	0	gen
1	215096082	215096336	MACS_peak_1688	596.79	254	0	1	0	gen
1	215146255	215146698	MACS_peak_1689	439.97	443	0	1	0	gen
1	215441950	215442336	MACS_peak_1691	427.81	386	0	0	0	intergen
1	215443925	215444272	MACS_peak_1692	1100.48	347	0	0	0	intergen
1	215517678	215517990	MACS_peak_1693	582.02	312	0	0	0	intergen
1	215606624	215606937	MACS_peak_1694	555.13	313	0	1	0	gen
1	215682246	215682634	MACS_peak_1695	854.72	388	0	1	0	gen
1	215710373	215710757	MACS_peak_1696	1012.95	384	0	1	0	gen
1	215803961	215804333	MACS_peak_1697	161.86	372	0	1	0	gen
1	215824220	215824560	MACS_peak_1698	919.5	340	0	1	0	gen
1	215896448	215896856	MACS_peak_1699	500.59	408	0	1	1	gen
1	215951012	215951322	MACS_peak_1700	93.4	310	0	1	0	gen
1	215953502	215953877	MACS_peak_1701	91.92	375	0	1	0	gen
1	216111942	216112290	MACS_peak_1702	501.59	348	0	1	0	gen
1	216163111	216163570	MACS_peak_1703	476.53	459	0	1	0	gen
1	216460013	216460278	MACS_peak_1704	829.91	265	0	0	0	intergen
1	216490383	216490738	MACS_peak_1705	115.17	355	0	0	0	intergen
1	216539645	216540080	MACS_peak_1706	439.97	435	0	1	0	gen
1	216875496	216875796	MACS_peak_1708	611.86	300	0	1	0	gen
1	216932606	216932738	MACS_peak_1709	1028.85	132	0	1	0	gen
1	217557302	217557514	MACS_peak_1710	450.48	212	0	1	0	gen
1	217694633	217694973	MACS_peak_1711	65.49	340	0	1	0	gen
1	217747268	217747610	MACS_peak_1712	925.78	342	0	1	0	gen
1	217811587	217811827	MACS_peak_1713	440.38	240	0	1	0	gen
1	217903704	217903946	MACS_peak_1714	494.55	242	0	0	1	other
1	217911884	217912190	MACS_peak_1715	745.5	306	0	0	1	other
1	218010457	218010927	MACS_peak_1716	100.4	470	0	0	0	intergen
1	218026639	218026991	MACS_peak_1717	761.56	352	0	0	0	intergen
1	218072549	218072928	MACS_peak_1718	62.38	379	0	0	0	intergen
1	218171419	218171779	MACS_peak_1719	1772.63	360	0	0	0	intergen
1	218299503	218299788	MACS_peak_1720	603.62	285	0	1	0	gen
1	218330066	218330364	MACS_peak_1721	558.24	298	0	1	0	gen
1	218361390	218361660	MACS_peak_1723	1281.4	270	0	1	0	gen
1	218362142	218362314	MACS_peak_1724	983.72	172	0	1	0	gen
1	218426878	218427111	MACS_peak_1725	558.22	233	0	1	0	gen
1	218553305	218553553	MACS_peak_1726	461.57	248	0	0	0	intergen
1	218934946	218935277	MACS_peak_1727	923.57	331	0	0	0	intergen
1	219204687	219204957	MACS_peak_1728	531.72	270	0	1	0	gen
1	219248586	219248814	MACS_peak_1729	1166.06	228	0	0	0	intergen
1	219416759	219417126	MACS_peak_1730	522.32	367	0	0	1	other
1	219805325	219805500	MACS_peak_1731	780.06	175	0	1	0	gen
1	219844310	219844707	MACS_peak_1732	64.04	397	0	1	0	gen
1	219845012	219845383	MACS_peak_1733	106.08	371	0	1	0	gen
1	219865540	219865922	MACS_peak_1734	108.77	382	0	1	0	gen
1	219866426	219866785	MACS_peak_1735	52.75	359	0	1	0	gen
1	219922095	219922299	MACS_peak_1736	501.94	204	0	1	0	gen
1	219990991	219991297	MACS_peak_1738	439.28	306	0	1	0	gen
1	220123913	220124249	MACS_peak_1739	644.82	336	0	1	0	gen
1	220154720	220155101	MACS_peak_1740	312.33	381	0	1	0	gen
1	220189788	220190085	MACS_peak_1741	444.41	297	0	1	0	gen
1	220218684	220218946	MACS_peak_1742	1040.74	262	0	1	0	gen
1	220471005	220471298	MACS_peak_1743	488.85	293	0	0	0	intergen
1	220775256	220775582	MACS_peak_1744	1209.66	326	0	1	0	gen
1	220810176	220810441	MACS_peak_1745	589.61	265	0	1	0	gen
1	221384057	221384405	MACS_peak_1746	79.31	348	0	0	0	intergen
1	221543874	221544108	MACS_peak_1747	532.66	234	0	0	0	intergen
1	221860862	221861239	MACS_peak_1748	62.38	377	0	0	0	intergen
1	221934488	221934710	MACS_peak_1749	564.54	222	0	0	1	other
1	221979610	221979982	MACS_peak_1750	393.98	372	0	0	1	other
1	222147108	222147395	MACS_peak_1751	303.91	287	0	0	1	other
1	222280672	222280946	MACS_peak_1752	105.8	274	0	0	1	other
1	222477647	222477884	MACS_peak_1754	649.5	237	0	0	1	other
1	222873017	222873420	MACS_peak_1755	62.23	403	1	0	1	promoter
1	223027143	223027458	MACS_peak_1756	215.13	315	0	0	0	intergen
1	223090159	223090400	MACS_peak_1757	501.16	241	0	0	0	intergen
1	223169883	223170259	MACS_peak_1758	131.12	376	0	0	0	intergen
1	223282277	223282590	MACS_peak_1759	55.5	313	0	1	0	gen
1	223325374	223325629	MACS_peak_1761	596.79	255	0	1	0	gen
1	223366721	223366981	MACS_peak_1762	76.3	260	0	0	0	intergen
1	223415547	223415776	MACS_peak_1763	257.34	229	0	0	0	intergen
1	223449742	223450085	MACS_peak_1764	51.36	343	0	0	0	intergen
1	223450743	223451129	MACS_peak_1765	67.48	386	0	0	0	intergen
1	223900037	223900421	MACS_peak_1766	456.67	384	0	0	0	intergen
1	223908137	223908363	MACS_peak_1767	826.83	226	0	0	0	intergen
1	223937135	223937583	MACS_peak_1768	425.97	448	0	0	0	intergen
1	224015052	224015513	MACS_peak_1771	247.49	461	0	0	0	intergen
1	224016348	224016594	MACS_peak_1772	57.2	246	0	0	0	intergen
1	224101466	224101845	MACS_peak_1773	76.3	379	0	0	0	intergen
1	224170708	224170942	MACS_peak_1774	644.94	234	0	0	0	intergen
1	224372418	224372776	MACS_peak_1775	229.83	358	0	1	0	gen
1	224427704	224427898	MACS_peak_1776	678.9	194	0	1	0	gen
1	224941117	224941466	MACS_peak_1777	56.38	349	0	1	0	gen
1	224941598	224941898	MACS_peak_1778	69.69	300	0	1	0	gen
1	224942620	224942930	MACS_peak_1779	79.68	310	0	1	0	gen
1	225126948	225127245	MACS_peak_1780	50.02	297	0	1	0	gen
1	225269256	225269633	MACS_peak_1781	149.7	377	0	1	0	gen
1	225386500	225386822	MACS_peak_1782	62.38	322	0	1	0	gen
1	225554283	225554500	MACS_peak_1783	901.33	217	0	1	0	gen
1	225965764	225966022	MACS_peak_1784	482.41	258	0	0	0	intergen
1	226064851	226065195	MACS_peak_1785	1050.85	344	1	0	0	promoter
1	226333457	226333858	MACS_peak_1786	620.91	401	0	0	0	intergen
1	226711270	226711568	MACS_peak_1787	380.3	298	0	1	0	gen
1	226927247	226927617	MACS_peak_1788	68.3	370	0	1	0	gen
1	227555449	227555790	MACS_peak_1790	76.27	341	0	0	0	intergen
1	227946670	227946906	MACS_peak_1791	516.86	236	0	1	0	gen
1	227966818	227967164	MACS_peak_1792	297.28	346	0	0	0	intergen
1	228131037	228131313	MACS_peak_1793	710.92	276	0	0	0	intergen
1	228393492	228393763	MACS_peak_1794	584.96	271	1	0	0	promoter
1	228608906	228609206	MACS_peak_1795	54.69	300	0	0	0	intergen
1	228611834	228612139	MACS_peak_1796	74.41	305	0	0	0	intergen
1	228613258	228613740	MACS_peak_1797	103.97	482	0	0	0	intergen
1	228614053	228614367	MACS_peak_1798	72.7	314	0	0	0	intergen
1	228618535	228618849	MACS_peak_1799	78.43	314	0	0	0	intergen
1	228622970	228623297	MACS_peak_1801	74.49	327	0	0	0	intergen
1	228625212	228625526	MACS_peak_1802	77.45	314	0	0	0	intergen
1	228627451	228627765	MACS_peak_1803	70.44	314	0	0	0	intergen
1	228629027	228629379	MACS_peak_1804	70.22	352	0	0	0	intergen
1	228629693	228630050	MACS_peak_1805	89.62	357	0	0	0	intergen
1	228631934	228632248	MACS_peak_1806	68.9	314	0	0	0	intergen
1	228634174	228634501	MACS_peak_1807	101.38	327	0	0	0	intergen
1	228636399	228636726	MACS_peak_1808	65.52	327	0	0	0	intergen
1	228637999	228638275	MACS_peak_1809	53.63	276	0	0	0	intergen
1	228638640	228638967	MACS_peak_1810	103.68	327	0	0	0	intergen
1	228640871	228641198	MACS_peak_1812	103.39	327	0	0	0	intergen
1	228643112	228643439	MACS_peak_1813	105.44	327	0	0	0	intergen
1	228709698	228709936	MACS_peak_1815	70.11	238	0	0	0	intergen
1	229161118	229161253	MACS_peak_1816	1173.42	135	0	0	0	intergen
1	229227612	229227819	MACS_peak_1817	613.04	207	0	0	0	intergen
1	229453313	229453536	MACS_peak_1818	1208.41	223	0	1	0	gen
1	229675732	229676058	MACS_peak_1819	546.72	326	0	0	0	intergen
1	230269004	230269224	MACS_peak_1820	564.54	220	0	1	0	gen
1	230297677	230298048	MACS_peak_1821	66.78	371	0	0	0	intergen
1	230603141	230603476	MACS_peak_1822	209.59	335	0	0	0	intergen
1	230871959	230872108	MACS_peak_1823	3040.58	149	0	0	0	intergen
1	231052269	231052664	MACS_peak_1824	624.52	395	0	0	0	intergen
1	231121835	231122239	MACS_peak_1825	449.73	404	0	0	0	intergen
1	231756788	231757084	MACS_peak_1826	566.68	296	0	2	0	gen
1	231806750	231807043	MACS_peak_1827	568.79	293	0	2	0	gen
1	231844986	231845247	MACS_peak_1828	453.37	261	0	1	0	gen
1	232262477	232262846	MACS_peak_1829	521.2	369	0	0	0	intergen
1	232635833	232636099	MACS_peak_1830	719.85	266	0	0	0	intergen
1	233395009	233395233	MACS_peak_1831	1025.76	224	0	0	0	intergen
1	233594412	233594778	MACS_peak_1832	1165.72	366	0	0	0	intergen
1	234326705	234326851	MACS_peak_1833	972.07	146	0	0	0	intergen
1	235025891	235026156	MACS_peak_1834	464.09	265	0	0	0	intergen
1	235093852	235094168	MACS_peak_1835	1080.16	316	0	0	0	intergen
1	235353682	235353993	MACS_peak_1836	534.92	311	0	1	0	gen
1	235382682	235383102	MACS_peak_1837	73.38	420	0	2	0	gen
1	235415377	235415691	MACS_peak_1838	679.74	314	0	2	0	gen
1	235417186	235417412	MACS_peak_1839	848.95	226	0	2	0	gen
1	236035243	236035697	MACS_peak_1840	122.09	454	0	1	0	gen
1	236598011	236598247	MACS_peak_1841	516.86	236	0	1	0	gen
1	236609140	236609509	MACS_peak_1842	765.37	369	0	0	0	intergen
1	236868953	236869189	MACS_peak_1843	516.86	236	0	1	0	gen
1	237306912	237307117	MACS_peak_1844	797.18	205	0	1	0	gen
1	237915431	237915632	MACS_peak_1845	670.71	201	0	0	1	other
1	238037413	238037632	MACS_peak_1846	146.82	219	0	0	0	intergen
1	238208005	238208464	MACS_peak_1847	137	459	0	0	0	intergen
1	239198132	239198299	MACS_peak_1849	814.37	167	0	0	0	intergen
1	239405573	239405934	MACS_peak_1850	1453.45	361	0	1	0	gen
1	239444660	239444890	MACS_peak_1851	532.66	230	0	1	0	gen
1	239987225	239987420	MACS_peak_1852	662.31	195	0	0	0	intergen
1	240004217	240004610	MACS_peak_1853	1557.72	393	0	0	0	intergen
1	240664463	240664751	MACS_peak_1854	449.72	288	0	0	0	intergen
1	241244597	241244837	MACS_peak_1855	223.38	240	0	1	0	gen
1	241627575	241627791	MACS_peak_1856	580.62	216	1	1	0	promoter
1	241756676	241757101	MACS_peak_1857	402.85	425	0	1	0	gen
1	241985819	241986148	MACS_peak_1858	426.82	329	0	0	0	intergen
1	242207700	242208047	MACS_peak_1861	1198.74	347	0	1	2	gen
1	242372285	242372587	MACS_peak_1862	62.38	302	0	1	0	gen
1	242475406	242475586	MACS_peak_1863	583.31	180	0	1	0	gen
1	242485833	242486111	MACS_peak_1864	64.43	278	0	1	0	gen
1	242694924	242695286	MACS_peak_1865	410.45	362	0	0	0	intergen
1	242793291	242793674	MACS_peak_1866	513.56	383	0	0	0	intergen
1	243010876	243011142	MACS_peak_1867	748.7	266	0	0	0	intergen
1	243023549	243023832	MACS_peak_1868	420.52	283	0	0	0	intergen
1	243056490	243056881	MACS_peak_1869	405.32	391	0	0	1	other
1	243057764	243057997	MACS_peak_1870	941.56	233	0	0	1	other
1	243077257	243077638	MACS_peak_1871	189.99	381	0	0	1	other
1	243325271	243325660	MACS_peak_1872	877.79	389	0	1	0	gen
1	243492503	243492862	MACS_peak_1873	265.34	359	1	1	0	promoter
1	244011181	244011477	MACS_peak_1874	380.3	296	0	0	1	other
1	244272995	244273341	MACS_peak_1875	1102.85	346	0	0	0	intergen
1	244524921	244525234	MACS_peak_1876	124.7	313	0	1	0	gen
1	244541382	244541741	MACS_peak_1877	138.38	359	0	1	0	gen
1	244563858	244564226	MACS_peak_1878	138.64	368	0	1	0	gen
1	244620991	244621350	MACS_peak_1879	229.83	359	0	1	0	gen
1	245079056	245079294	MACS_peak_1880	1264.23	238	0	1	0	gen
1	245908727	245908989	MACS_peak_1881	466.05	262	0	1	0	gen
1	246012190	246012572	MACS_peak_1882	401.26	382	0	1	0	gen
1	246532603	246532816	MACS_peak_1883	596.79	213	0	0	0	intergen
1	246689550	246689771	MACS_peak_1884	564.54	221	0	0	0	intergen
1	246717921	246718294	MACS_peak_1885	56.93	373	0	0	0	intergen
1	246721616	246721759	MACS_peak_1886	834.89	143	1	0	0	promoter
1	247004695	247004977	MACS_peak_1887	576.71	282	0	2	0	gen
1	247125315	247125454	MACS_peak_1888	869.22	139	1	0	0	promoter
1	247576535	247576814	MACS_peak_1889	578.93	279	0	1	1	gen
1	247664724	247664978	MACS_peak_1890	856.51	254	0	0	1	other
1	247809749	247810072	MACS_peak_1892	67.96	323	1	0	0	promoter
1	247826620	247826755	MACS_peak_1893	1965.34	135	0	0	0	intergen
1	248119487	248119944	MACS_peak_1894	80.72	457	0	0	0	intergen
1	248120084	248120456	MACS_peak_1895	61.68	372	0	0	0	intergen
1	248157494	248157764	MACS_peak_1896	63.13	270	0	0	0	intergen
1	248169375	248169814	MACS_peak_1897	52.2	439	0	0	0	intergen
1	248170381	248170845	MACS_peak_1898	52.57	464	1	0	0	promoter
1	248614735	248614940	MACS_peak_1899	629.38	205	0	0	0	intergen
1	248677134	248677525	MACS_peak_1900	180.31	391	1	0	0	promoter
1	248867081	248867228	MACS_peak_1901	871.29	147	0	0	0	intergen
1	248924698	248925042	MACS_peak_1902	656.28	344	0	0	0	intergen
1	146872082	146872369	MACS_peak_9822	450.32	287	0	0	1	other
1	146838580	146839035	MACS_peak_9823	1349.79	455	0	0	1	other
1	146810196	146810578	MACS_peak_9824	401.26	382	0	0	1	other
1	146789343	146789695	MACS_peak_9825	530.91	352	0	0	1	other
1	146770253	146770516	MACS_peak_9826	465.4	263	0	0	1	other
1	146768630	146769059	MACS_peak_9827	490.32	429	0	0	1	other
1	146722463	146722779	MACS_peak_9829	433.75	316	0	0	1	other
1	146721877	146722260	MACS_peak_9830	513.56	383	0	0	1	other
1	146721255	146721612	MACS_peak_9831	412.83	357	0	0	1	other
1	146720279	146720620	MACS_peak_9832	420.68	341	0	0	1	other
1	146718202	146718582	MACS_peak_9833	515.17	380	0	0	1	other
1	146653029	146653331	MACS_peak_9834	441.54	302	0	0	1	other
1	146600358	146600632	MACS_peak_9835	458.32	274	0	0	1	other
1	146478019	146478396	MACS_peak_9836	759.47	377	0	0	1	other
1	146448553	146448930	MACS_peak_9837	1154.5	377	0	0	0	intergen
1	146428367	146428838	MACS_peak_9838	819.43	471	0	0	0	intergen
1	146411144	146411442	MACS_peak_9839	443.84	298	0	0	0	intergen
2	18713	19110	MACS_peak_9840	745.28	397	0	0	0	intergen
2	246511	246781	MACS_peak_9841	460.86	270	0	1	0	gen
2	530911	531084	MACS_peak_9842	1208.41	173	0	0	0	intergen
2	637084	637310	MACS_peak_9843	548.55	226	0	0	0	intergen
2	703306	703631	MACS_peak_9844	299.14	325	0	0	0	intergen
2	715937	716124	MACS_peak_9845	650.69	187	0	0	0	intergen
2	801816	802101	MACS_peak_9846	53.45	285	0	0	1	other
2	1255739	1255985	MACS_peak_9847	1123.91	246	0	1	0	gen
2	1342302	1342660	MACS_peak_9848	412.35	358	0	1	1	gen
2	1344445	1344926	MACS_peak_9850	467	481	0	1	1	gen
2	1506127	1506401	MACS_peak_9852	125.64	274	0	1	1	gen
2	1764620	1764950	MACS_peak_9853	60.76	330	0	0	0	intergen
2	2202781	2203155	MACS_peak_9854	142.8	374	0	1	0	gen
2	2492336	2492690	MACS_peak_9855	414.27	354	0	0	0	intergen
2	3315318	3315668	MACS_peak_9856	416.22	350	0	1	0	gen
2	3409745	3409884	MACS_peak_9858	1101.62	139	0	1	0	gen
2	3462314	3462773	MACS_peak_9859	826.72	459	0	1	0	gen
2	3959173	3959526	MACS_peak_9860	651.52	353	0	0	1	other
2	4054167	4054484	MACS_peak_9861	552.5	317	0	0	0	intergen
2	4080512	4080843	MACS_peak_9862	137.06	331	0	0	0	intergen
2	4160041	4160351	MACS_peak_9863	58.17	310	0	0	0	intergen
2	4269223	4269673	MACS_peak_9864	710.95	450	0	0	0	intergen
2	4645565	4645876	MACS_peak_9866	50.92	311	0	0	1	other
2	4647717	4648120	MACS_peak_9867	91.08	403	0	0	1	other
2	4738825	4739185	MACS_peak_9869	50.79	360	0	0	0	intergen
2	5157501	5157775	MACS_peak_9870	843.52	274	0	0	0	intergen
2	5625617	5625880	MACS_peak_9872	417.88	263	0	0	2	other
2	6651481	6651859	MACS_peak_9873	312.33	378	0	0	0	intergen
2	6897181	6897463	MACS_peak_9874	592.88	282	0	1	0	gen
2	7037802	7038009	MACS_peak_9875	613.04	207	0	1	0	gen
2	7097327	7097527	MACS_peak_9876	645.81	200	0	0	0	intergen
2	7427308	7427583	MACS_peak_9877	581.92	275	0	0	1	other
2	7829012	7829248	MACS_peak_9879	1353.39	236	0	0	0	intergen
2	8127994	8128452	MACS_peak_9880	175.93	458	0	0	2	other
2	8130702	8131096	MACS_peak_9881	88.08	394	0	0	2	other
2	8182771	8183140	MACS_peak_9882	55.92	369	0	0	2	other
2	8423404	8423604	MACS_peak_9883	913.7	200	0	0	0	intergen
2	8972610	8973054	MACS_peak_9884	87.62	444	0	1	0	gen
2	9395486	9395649	MACS_peak_9886	668.89	163	0	1	0	gen
2	9506249	9506482	MACS_peak_9887	831.63	233	0	1	1	gen
2	9557794	9557989	MACS_peak_9888	848.95	195	0	0	0	intergen
2	9931045	9931500	MACS_peak_9889	223.95	455	0	1	0	gen
2	10048583	10049007	MACS_peak_9890	727.24	424	0	1	0	gen
2	10097421	10097793	MACS_peak_9891	405.79	372	0	0	0	intergen
2	10668515	10668783	MACS_peak_9892	853.65	268	0	1	0	gen
2	10835347	10835564	MACS_peak_9893	564.92	217	0	1	0	gen
2	10859529	10859666	MACS_peak_9894	914.41	137	0	0	0	intergen
2	10996747	10996998	MACS_peak_9895	119.37	251	0	0	0	intergen
2	11028436	11028858	MACS_peak_9896	608.69	422	0	0	0	intergen
2	11124530	11124848	MACS_peak_9898	676.68	318	0	0	1	other
2	11446781	11447029	MACS_peak_9899	485.56	248	1	0	0	promoter
2	11688386	11688743	MACS_peak_9900	648.81	357	0	1	0	gen
2	11745187	11745427	MACS_peak_9901	645.81	240	0	1	0	gen
2	11779322	11779568	MACS_peak_9902	629.38	246	0	1	0	gen
2	11785001	11785245	MACS_peak_9903	501.16	244	0	1	0	gen
2	11923565	11923910	MACS_peak_9904	243.49	345	0	0	1	other
2	11998534	11998712	MACS_peak_9905	763.02	178	0	0	1	other
2	12455991	12456249	MACS_peak_9906	727.26	258	0	0	1	other
2	13030043	13030517	MACS_peak_9907	1430.48	474	0	0	1	other
2	13031026	13031414	MACS_peak_9908	406.81	388	0	0	1	other
2	13225140	13225453	MACS_peak_9909	422.13	313	0	0	1	other
2	13334181	13334646	MACS_peak_9910	553.12	465	0	0	0	intergen
2	13414501	13414663	MACS_peak_9911	770.61	162	0	0	0	intergen
2	13624686	13624957	MACS_peak_9912	488.85	271	0	0	0	intergen
2	13635488	13635820	MACS_peak_9913	67.16	332	0	0	0	intergen
2	13819706	13819943	MACS_peak_9915	799.31	237	0	0	1	other
2	13867771	13868136	MACS_peak_9916	170.69	365	0	0	1	other
2	14037157	14037392	MACS_peak_9918	516.86	235	0	0	1	other
2	14054796	14055208	MACS_peak_9919	1075.17	412	0	0	1	other
2	14100781	14101138	MACS_peak_9920	68.83	357	0	0	1	other
2	14101702	14101982	MACS_peak_9921	106.04	280	0	0	1	other
2	14407327	14407527	MACS_peak_9922	645.81	200	0	0	0	intergen
2	14444834	14445016	MACS_peak_9923	710.43	182	0	0	0	intergen
2	14851134	14851444	MACS_peak_9924	66.07	310	0	0	0	intergen
2	14853177	14853658	MACS_peak_9925	60.47	481	0	0	0	intergen
2	14903735	14904108	MACS_peak_9926	638.28	373	0	0	1	other
2	15097930	15098180	MACS_peak_9927	145.35	250	0	0	0	intergen
2	15098253	15098545	MACS_peak_9928	334.33	292	0	0	0	intergen
2	15159819	15160106	MACS_peak_9929	450.32	287	0	0	0	intergen
2	15466825	15466988	MACS_peak_9931	987.39	163	0	1	0	gen
2	15548872	15549120	MACS_peak_9932	613.04	248	0	1	0	gen
2	15848462	15848813	MACS_peak_9933	221.76	351	0	0	0	intergen
2	16234238	16234581	MACS_peak_9934	104.91	343	0	0	1	other
2	16595829	16596124	MACS_peak_9935	50.96	295	0	1	0	gen
2	16876921	16877374	MACS_peak_9936	77	453	0	0	0	intergen
2	16900292	16900706	MACS_peak_9937	733.78	414	0	0	0	intergen
2	17137251	17137618	MACS_peak_9938	972.38	367	0	0	0	intergen
2	17360860	17361234	MACS_peak_9939	158.81	374	0	0	0	intergen
2	17371153	17371518	MACS_peak_9940	227.1	365	0	0	0	intergen
2	17646133	17646481	MACS_peak_9941	533.26	348	0	1	0	gen
2	17712904	17713139	MACS_peak_9942	662.31	235	0	1	0	gen
2	17719661	17719998	MACS_peak_9943	422.7	337	0	1	0	gen
2	17851711	17852021	MACS_peak_9944	437.04	310	0	0	0	intergen
2	17904250	17904725	MACS_peak_9945	78.6	475	0	1	0	gen
2	17984032	17984436	MACS_peak_9946	53.41	404	0	1	0	gen
2	18015872	18016154	MACS_peak_9948	83.55	282	0	1	0	gen
2	18041068	18041370	MACS_peak_9949	670.5	302	0	1	0	gen
2	18140756	18141100	MACS_peak_9950	55.06	344	0	1	0	gen
2	18149754	18149973	MACS_peak_9951	729.14	219	0	1	0	gen
2	18178793	18179122	MACS_peak_9952	1066.24	329	0	1	0	gen
2	18295065	18295506	MACS_peak_9953	965.4	441	0	1	0	gen
2	18467545	18467800	MACS_peak_9954	470.06	255	0	0	0	intergen
2	18638712	18638938	MACS_peak_9955	1097.85	226	0	0	0	intergen
2	18695427	18695791	MACS_peak_9956	50.92	364	0	0	0	intergen
2	18696430	18696653	MACS_peak_9957	207.54	223	0	0	0	intergen
2	18749843	18750120	MACS_peak_9958	983.22	277	0	0	0	intergen
2	18966337	18966633	MACS_peak_9961	409.5	296	0	0	0	intergen
2	19082922	19083250	MACS_peak_9962	56.15	328	0	0	1	other
2	19170579	19170724	MACS_peak_9964	751.9	145	0	0	1	other
2	20106761	20107127	MACS_peak_9966	408.57	366	0	0	0	intergen
2	20326929	20327203	MACS_peak_9967	986.62	274	0	1	0	gen
2	20642475	20642673	MACS_peak_9968	662.31	198	0	1	0	gen
2	20661460	20661742	MACS_peak_9969	453.35	282	0	0	0	intergen
2	20672891	20673267	MACS_peak_9970	517.34	376	0	1	0	gen
2	20781725	20781936	MACS_peak_9971	763.02	211	0	1	0	gen
2	21000948	21001292	MACS_peak_9972	657.74	344	1	0	0	promoter
2	21211186	21211601	MACS_peak_9973	107.03	415	0	0	0	intergen
2	21338484	21338713	MACS_peak_9974	208.41	229	0	0	2	other
2	21475554	21475853	MACS_peak_9975	564.59	299	0	0	2	other
2	21493662	21493978	MACS_peak_9976	79.95	316	0	0	2	other
2	21754130	21754473	MACS_peak_9977	520.35	343	0	0	1	other
2	21760610	21760861	MACS_peak_9978	613.04	251	0	0	1	other
2	21882238	21882528	MACS_peak_9979	831.82	290	0	0	1	other
2	22160192	22160521	MACS_peak_9980	56.07	329	0	0	1	other
2	22161146	22161476	MACS_peak_9981	188.21	330	0	0	1	other
2	22411244	22411434	MACS_peak_9982	847.66	190	0	0	2	other
2	22500734	22501001	MACS_peak_9983	588.05	267	0	0	1	other
2	22717551	22717889	MACS_peak_9984	406.81	338	0	0	0	intergen
2	22986893	22987189	MACS_peak_9985	57.77	296	0	0	0	intergen
2	23066730	23067091	MACS_peak_9986	525.71	361	0	0	1	other
2	23224991	23225305	MACS_peak_9987	83.3	314	0	0	0	intergen
2	23225431	23225872	MACS_peak_9988	102.25	441	0	0	0	intergen
2	23228063	23228487	MACS_peak_9989	74.04	424	0	0	0	intergen
2	23351523	23351777	MACS_peak_9990	596.79	254	0	0	1	other
2	23740330	23740587	MACS_peak_9991	87.69	257	0	0	0	intergen
2	23807737	23808118	MACS_peak_9992	388.56	381	0	1	0	gen
2	23906819	23907142	MACS_peak_9993	54.07	323	0	1	0	gen
2	23908290	23908682	MACS_peak_9994	170.04	392	0	1	0	gen
2	24194422	24194879	MACS_peak_9996	105.03	457	0	1	0	gen
2	25196482	25196834	MACS_peak_9999	1464.78	352	0	0	0	intergen
2	25228108	25228332	MACS_peak_10000	276.88	224	1	0	0	promoter
2	25309483	25309884	MACS_peak_10001	559	401	0	1	0	gen
2	25361998	25362190	MACS_peak_10002	866.35	192	0	0	0	intergen
2	25397875	25398226	MACS_peak_10003	774.9	351	0	1	0	gen
2	25606819	25607129	MACS_peak_10004	437.04	310	0	1	0	gen
2	25616658	25616960	MACS_peak_10005	265.34	302	0	1	0	gen
2	25625541	25625678	MACS_peak_10006	1420.82	137	0	1	0	gen
2	26418479	26418827	MACS_peak_10008	380.3	348	0	1	0	gen
2	26605321	26605713	MACS_peak_10009	508.79	392	0	1	0	gen
2	26846321	26846511	MACS_peak_10010	1079.97	190	1	0	0	promoter
2	26926637	26927084	MACS_peak_10011	481.93	447	0	1	0	gen
2	27016975	27017177	MACS_peak_10012	645.81	202	0	1	0	gen
2	27098616	27098978	MACS_peak_10013	770.64	362	1	1	0	promoter
2	27169870	27170153	MACS_peak_10014	575.98	283	0	0	0	intergen
2	27303526	27303822	MACS_peak_10015	882.02	296	1	1	0	promoter
2	27370308	27370497	MACS_peak_10016	695.57	189	1	0	0	promoter
2	27621518	27621823	MACS_peak_10017	439.84	305	1	1	1	promoter
2	27683559	27683869	MACS_peak_10018	682.83	310	0	1	0	gen
2	27945659	27945958	MACS_peak_10019	506.92	299	0	2	0	gen
2	28026651	28026989	MACS_peak_10020	967.61	338	0	1	0	gen
2	28214323	28214633	MACS_peak_10021	813.39	310	0	1	0	gen
2	28371435	28371899	MACS_peak_10022	262.12	464	0	0	0	intergen
2	28566782	28567091	MACS_peak_10023	814.28	309	0	1	0	gen
2	28821442	28821640	MACS_peak_10024	569.68	198	0	1	0	gen
2	29085809	29086152	MACS_peak_10025	406.81	343	0	0	0	intergen
2	29093630	29093915	MACS_peak_10026	61.75	285	1	0	0	promoter
2	29238614	29238823	MACS_peak_10027	613.04	209	0	1	0	gen
2	29674614	29675044	MACS_peak_10029	130.72	430	0	1	0	gen
2	29923228	29923436	MACS_peak_10030	942.93	208	0	0	0	intergen
2	30165019	30165369	MACS_peak_10032	1044.89	350	0	0	0	intergen
2	30171942	30172227	MACS_peak_10033	600.01	285	0	0	0	intergen
2	30208354	30208683	MACS_peak_10034	929.71	329	0	0	0	intergen
2	30358018	30358327	MACS_peak_10035	178.37	309	0	0	0	intergen
2	30507952	30508311	MACS_peak_10036	367.74	359	0	1	0	gen
2	30697206	30697649	MACS_peak_10037	469.55	443	0	0	0	intergen
2	30711594	30711921	MACS_peak_10038	907.64	327	0	0	0	intergen
2	30714166	30714446	MACS_peak_10039	1136.77	280	0	0	0	intergen
2	30853094	30853367	MACS_peak_10040	161.37	273	0	0	0	intergen
2	30862126	30862378	MACS_peak_10041	1647.16	252	0	0	0	intergen
2	30907145	30907504	MACS_peak_10042	65.51	359	1	0	0	promoter
2	31038433	31038892	MACS_peak_10043	705.54	459	0	1	0	gen
2	31170182	31170524	MACS_peak_10044	536.84	342	1	0	0	promoter
2	31333646	31333913	MACS_peak_10045	854.69	267	1	0	0	promoter
2	31437321	31437604	MACS_peak_10046	59.71	283	0	0	0	intergen
2	31523947	31524187	MACS_peak_10047	1098.16	240	1	0	0	promoter
2	31619793	31620086	MACS_peak_10048	568.79	293	0	0	0	intergen
2	31837433	31837582	MACS_peak_10049	1128.57	149	0	0	0	intergen
2	31933313	31933457	MACS_peak_10050	769.86	144	0	2	0	gen
2	31969498	31969692	MACS_peak_10051	632.58	194	0	2	0	gen
2	32553902	32554134	MACS_peak_10052	532.66	232	0	1	0	gen
2	32596464	32596597	MACS_peak_10053	1291.76	133	0	1	0	gen
2	32866710	32867122	MACS_peak_10054	867.52	412	0	0	1	other
2	32939751	32940102	MACS_peak_10056	406.81	351	0	0	0	intergen
2	32940968	32941333	MACS_peak_10057	265.34	365	0	0	0	intergen
2	33086861	33087211	MACS_peak_10058	380.3	350	0	1	0	gen
2	33096074	33096304	MACS_peak_10059	517.97	230	0	1	0	gen
2	33380118	33380276	MACS_peak_10061	883.81	158	0	1	0	gen
2	33395652	33395993	MACS_peak_10062	773.86	341	0	1	0	gen
2	33583306	33583761	MACS_peak_10063	954.68	455	1	0	0	promoter
2	33826064	33826359	MACS_peak_10064	83.04	295	0	0	1	other
2	34012628	34013033	MACS_peak_10065	1127.36	405	0	0	1	other
2	34210864	34211099	MACS_peak_10066	477.27	235	0	0	2	other
2	34479220	34479435	MACS_peak_10067	239.61	215	0	0	1	other
2	34550421	34550800	MACS_peak_10068	348.12	379	0	0	1	other
2	34558451	34558824	MACS_peak_10069	155.15	373	0	0	1	other
2	34749252	34749553	MACS_peak_10071	116.72	301	0	0	0	intergen
2	35017677	35018021	MACS_peak_10072	84.4	344	0	0	1	other
2	35182550	35182776	MACS_peak_10073	290.28	226	0	0	1	other
2	35323081	35323385	MACS_peak_10074	50.13	304	0	0	0	intergen
2	35410640	35410830	MACS_peak_10075	612.96	190	0	0	0	intergen
2	35532687	35532932	MACS_peak_10077	141.95	245	0	0	0	intergen
2	35548853	35549136	MACS_peak_10078	559.99	283	0	0	0	intergen
2	35610563	35610758	MACS_peak_10079	662.31	195	0	0	0	intergen
2	35957563	35957879	MACS_peak_10081	551.21	316	0	0	0	intergen
2	36089733	36089920	MACS_peak_10082	555.36	187	0	0	0	intergen
2	36099997	36100286	MACS_peak_10083	168.98	289	0	0	0	intergen
2	36108100	36108344	MACS_peak_10084	133.18	244	0	0	0	intergen
2	36184110	36184394	MACS_peak_10086	149.79	284	0	0	0	intergen
2	36785228	36785512	MACS_peak_10087	837.6	284	0	1	0	gen
2	36826167	36826376	MACS_peak_10088	585.15	209	0	0	0	intergen
2	36918272	36918675	MACS_peak_10089	866.86	403	0	1	0	gen
2	37395971	37396217	MACS_peak_10090	485.56	246	0	0	0	intergen
2	37414518	37414851	MACS_peak_10091	665.57	333	0	0	0	intergen
2	37493881	37494191	MACS_peak_10092	77.23	310	0	0	0	intergen
2	37682809	37683042	MACS_peak_10093	532.66	233	0	1	0	gen
2	37802972	37803277	MACS_peak_10094	1119.36	305	0	0	0	intergen
2	37809496	37809757	MACS_peak_10095	377.29	261	0	0	0	intergen
2	37871501	37871634	MACS_peak_10096	1396.21	133	0	0	1	other
2	37877601	37877805	MACS_peak_10097	629.38	204	0	0	0	intergen
2	37982143	37982418	MACS_peak_10098	711.8	275	0	1	1	gen
2	38005329	38005578	MACS_peak_10099	57.18	249	0	1	1	gen
2	38006147	38006445	MACS_peak_10100	86.92	298	0	1	1	gen
2	38008472	38008828	MACS_peak_10102	82.38	356	0	1	1	gen
2	38063010	38063465	MACS_peak_10103	61.53	455	1	1	1	promoter
2	38115312	38115544	MACS_peak_10104	895.32	232	0	0	1	other
2	38370351	38370578	MACS_peak_10105	532.28	227	0	1	0	gen
2	38376737	38376890	MACS_peak_10106	918.92	153	0	1	0	gen
2	38465837	38466058	MACS_peak_10107	1043.77	221	0	0	1	other
2	38766592	38766978	MACS_peak_10108	349.84	386	0	1	0	gen
2	38923276	38923580	MACS_peak_10109	440.4	304	0	2	0	gen
2	38947695	38947942	MACS_peak_10110	629.38	247	0	1	0	gen
2	39055333	39055609	MACS_peak_10111	1422.18	276	0	1	0	gen
2	39059394	39059674	MACS_peak_10112	361.13	280	0	1	0	gen
2	39458068	39458334	MACS_peak_10113	741.64	266	0	0	1	other
2	39728931	39729116	MACS_peak_10114	1116.4	185	0	0	0	intergen
2	40013964	40014335	MACS_peak_10115	134.57	371	0	0	1	other
2	40025520	40025885	MACS_peak_10116	82.42	365	0	0	1	other
2	40234757	40235208	MACS_peak_10117	60.17	451	0	1	1	gen
2	40244565	40244760	MACS_peak_10118	848.95	195	0	1	1	gen
2	40263940	40264276	MACS_peak_10119	131.04	336	0	1	0	gen
2	40411007	40411258	MACS_peak_10120	1043.38	251	0	1	0	gen
2	40554747	40555069	MACS_peak_10121	430.51	322	0	1	0	gen
2	40782138	40782439	MACS_peak_10122	130.73	301	0	0	0	intergen
2	40948545	40948768	MACS_peak_10123	555.36	223	0	0	0	intergen
2	41145293	41145529	MACS_peak_10124	644.94	236	0	0	1	other
2	41468610	41468833	MACS_peak_10125	650.69	223	0	0	0	intergen
2	41553164	41553509	MACS_peak_10127	64.6	345	0	0	0	intergen
2	41823248	41823471	MACS_peak_10128	564.54	223	0	0	0	intergen
2	41853730	41853958	MACS_peak_10129	848.95	228	0	0	0	intergen
2	42409693	42409835	MACS_peak_10130	732.07	142	0	1	0	gen
2	42461082	42461380	MACS_peak_10131	330.94	298	0	1	0	gen
2	42561668	42561893	MACS_peak_10132	548.55	225	0	1	0	gen
2	42663141	42663398	MACS_peak_10133	469.39	257	0	1	0	gen
2	42813042	42813452	MACS_peak_10134	499.59	410	0	0	0	intergen
2	42827634	42827865	MACS_peak_10135	532.66	231	0	0	0	intergen
2	42993623	42994051	MACS_peak_10136	72.61	428	0	0	0	intergen
2	43046752	43046980	MACS_peak_10137	425.33	228	0	0	0	intergen
2	43229610	43229886	MACS_peak_10138	1574.18	276	1	0	1	promoter
2	43298388	43298743	MACS_peak_10139	451.53	355	0	1	0	gen
2	43542330	43542638	MACS_peak_10141	208.52	308	0	1	0	gen
2	43545171	43545564	MACS_peak_10142	86.4	393	0	1	0	gen
2	43577320	43577647	MACS_peak_10143	1068.34	327	0	1	0	gen
2	43677246	43677550	MACS_peak_10144	234.17	304	1	1	0	promoter
2	43866163	43866542	MACS_peak_10145	59.7	379	0	1	0	gen
2	43929097	43929398	MACS_peak_10146	689.95	301	0	1	0	gen
2	44260677	44260997	MACS_peak_10147	147.82	320	0	1	0	gen
2	44261078	44261434	MACS_peak_10148	82.65	356	0	1	0	gen
2	44389918	44390237	MACS_peak_10149	675.92	319	0	1	0	gen
2	44392365	44392702	MACS_peak_10150	422.7	337	0	1	0	gen
2	44598681	44599049	MACS_peak_10151	986.65	368	0	1	0	gen
2	45062225	45062484	MACS_peak_10152	63.43	259	0	0	0	intergen
2	45440200	45440447	MACS_peak_10153	629.38	247	0	1	0	gen
2	45450063	45450304	MACS_peak_10154	646.51	241	0	1	0	gen
2	45494642	45494962	MACS_peak_10155	675.17	320	0	1	0	gen
2	45504457	45504896	MACS_peak_10156	717.72	439	0	1	0	gen
2	45585296	45585562	MACS_peak_10157	463.44	266	0	1	0	gen
2	46062982	46063262	MACS_peak_10158	454.58	280	0	1	0	gen
2	46279961	46280262	MACS_peak_10159	149.97	301	0	0	0	intergen
2	46464489	46464814	MACS_peak_10160	547.36	325	0	0	1	other
2	46776780	46777111	MACS_peak_10161	1105.5	331	0	1	1	gen
2	47177743	47177956	MACS_peak_10162	1447.53	213	0	0	0	intergen
2	47272453	47272685	MACS_peak_10163	532.66	232	0	0	1	other
2	47388371	47388530	MACS_peak_10164	683.4	159	0	0	0	intergen
2	47911362	47911738	MACS_peak_10165	56.1	376	0	0	0	intergen
2	48106648	48106795	MACS_peak_10166	972.07	147	0	0	1	other
2	48277224	48277461	MACS_peak_10167	516.86	237	0	0	0	intergen
2	48589237	48589536	MACS_peak_10168	1388.91	299	0	2	0	gen
2	48600283	48600509	MACS_peak_10169	548.55	226	0	1	0	gen
2	48622798	48622995	MACS_peak_10170	641.55	197	0	2	0	gen
2	48742382	48742692	MACS_peak_10171	72.56	310	0	3	0	gen
2	48924314	48924634	MACS_peak_10172	81.06	320	0	0	1	other
2	48946537	48946835	MACS_peak_10173	443.84	298	0	0	1	other
2	49132863	49132998	MACS_peak_10174	1029.26	135	0	1	1	gen
2	49230485	49230807	MACS_peak_10175	644.51	322	0	0	2	other
2	49615407	49615619	MACS_peak_10176	936.57	212	0	0	0	intergen
2	49687946	49688221	MACS_peak_10177	457.69	275	0	0	0	intergen
2	50018599	50018836	MACS_peak_10178	406.23	237	0	1	0	gen
2	50121854	50122072	MACS_peak_10179	729.14	218	0	1	0	gen
2	50399734	50399931	MACS_peak_10180	399.74	197	0	1	0	gen
2	50402311	50402671	MACS_peak_10181	411.4	360	0	1	0	gen
2	50746625	50746856	MACS_peak_10182	517.97	231	0	1	0	gen
2	51314936	51315377	MACS_peak_10183	110.92	441	0	0	1	other
2	51382242	51382484	MACS_peak_10184	59.85	242	0	0	1	other
2	51557813	51558106	MACS_peak_10187	127.5	293	0	0	1	other
2	51631014	51631353	MACS_peak_10188	74.37	339	0	0	1	other
2	51682036	51682221	MACS_peak_10189	901.33	185	0	0	1	other
2	52039629	52039979	MACS_peak_10190	81.47	350	0	0	1	other
2	52274352	52274653	MACS_peak_10191	93.94	301	0	0	1	other
2	52347771	52348025	MACS_peak_10192	862.08	254	0	0	1	other
2	52389184	52389398	MACS_peak_10193	1098.16	214	0	0	2	other
2	52416296	52416675	MACS_peak_10194	484.14	379	0	0	0	intergen
2	52730698	52731038	MACS_peak_10195	201.59	340	0	0	1	other
2	52923091	52923335	MACS_peak_10196	108.52	244	0	0	0	intergen
2	53299098	53299488	MACS_peak_10197	83.7	390	0	0	0	intergen
2	53388045	53388230	MACS_peak_10198	420.03	185	0	0	0	intergen
2	53399804	53400179	MACS_peak_10199	101.62	375	0	0	0	intergen
2	53473262	53473582	MACS_peak_10200	431.58	320	0	0	0	intergen
2	54106989	54107264	MACS_peak_10202	711.8	275	0	1	0	gen
2	54161682	54162018	MACS_peak_10203	540.49	336	0	1	0	gen
2	54704788	54705049	MACS_peak_10204	1001.77	261	0	0	0	intergen
2	54757860	54758145	MACS_peak_10205	611.86	285	0	1	0	gen
2	54838632	54838868	MACS_peak_10206	516.86	236	0	1	0	gen
2	54899843	54900118	MACS_peak_10207	581.92	275	0	1	0	gen
2	54910942	54911161	MACS_peak_10208	580.62	219	0	1	0	gen
2	55014058	55014241	MACS_peak_10209	710.43	183	0	1	0	gen
2	55446883	55447250	MACS_peak_10210	60.83	367	0	0	0	intergen
2	55569078	55569447	MACS_peak_10211	521.2	369	0	1	0	gen
2	55604520	55604713	MACS_peak_10212	678.9	193	0	1	0	gen
2	55736605	55736951	MACS_peak_10213	110.65	346	0	0	0	intergen
2	55817131	55817504	MACS_peak_10214	81.72	373	0	0	0	intergen
2	55831234	55831464	MACS_peak_10215	439.17	230	0	0	0	intergen
2	55961307	55961640	MACS_peak_10216	772.36	333	0	0	1	other
2	56097565	56097939	MACS_peak_10218	69	374	0	0	1	other
2	56181726	56181904	MACS_peak_10219	954.29	178	1	0	2	promoter
2	56664105	56664473	MACS_peak_10221	80.78	368	0	0	0	intergen
2	56776344	56776632	MACS_peak_10222	114.74	288	0	0	0	intergen
2	57017100	57017439	MACS_peak_10223	209.96	339	0	0	0	intergen
2	57104722	57104860	MACS_peak_10224	1320.51	138	0	0	0	intergen
2	57149698	57150018	MACS_peak_10225	229.83	320	0	0	0	intergen
2	57191687	57192018	MACS_peak_10226	464.77	331	0	0	0	intergen
2	57381193	57381583	MACS_peak_10227	105.65	390	0	0	0	intergen
2	57422942	57423333	MACS_peak_10228	57.51	391	0	0	0	intergen
2	57423879	57424273	MACS_peak_10229	99.62	394	0	0	0	intergen
2	57463900	57464193	MACS_peak_10231	229.83	293	0	0	0	intergen
2	57556858	57557211	MACS_peak_10232	111.26	353	0	0	0	intergen
2	57559317	57559679	MACS_peak_10233	73.28	362	0	0	0	intergen
2	57611416	57611823	MACS_peak_10234	130.58	407	0	0	0	intergen
2	57612512	57612745	MACS_peak_10235	85.34	233	0	0	0	intergen
2	57759791	57760083	MACS_peak_10236	447.34	292	0	0	1	other
2	58174860	58175302	MACS_peak_10237	125.99	442	0	1	0	gen
2	58176540	58176908	MACS_peak_10238	50	368	0	1	0	gen
2	58202136	58202371	MACS_peak_10239	972.07	235	0	1	0	gen
2	58217283	58217556	MACS_peak_10240	458.95	273	0	1	0	gen
2	58309912	58310117	MACS_peak_10241	629.38	205	0	0	0	intergen
2	58367735	58368004	MACS_peak_10242	406.81	269	0	0	0	intergen
2	58386061	58386444	MACS_peak_10243	123.55	383	0	0	0	intergen
2	58470190	58470395	MACS_peak_10244	385.31	205	0	0	1	other
2	58762233	58762493	MACS_peak_10246	625.6	260	0	0	1	other
2	59146160	59146625	MACS_peak_10247	822.72	465	0	0	1	other
2	59262589	59262997	MACS_peak_10248	55.51	408	0	0	4	other
2	59480088	59480321	MACS_peak_10250	678.9	233	0	0	2	other
2	59555577	59556027	MACS_peak_10251	120.35	450	0	0	2	other
2	59558189	59558494	MACS_peak_10252	89.02	305	0	0	2	other
2	59638091	59638416	MACS_peak_10253	84.4	325	0	0	2	other
2	59639101	59639464	MACS_peak_10254	125.3	363	0	0	2	other
2	59687453	59687827	MACS_peak_10255	71.05	374	0	0	2	other
2	60190068	60190493	MACS_peak_10256	75.42	425	0	0	0	intergen
2	60203019	60203277	MACS_peak_10257	243.49	258	0	0	0	intergen
2	60224968	60225115	MACS_peak_10258	972.07	147	0	0	0	intergen
2	60794323	60794603	MACS_peak_10259	454.58	280	0	1	0	gen
2	60928335	60928623	MACS_peak_10260	74.3	288	0	1	1	gen
2	61428550	61428810	MACS_peak_10261	467.38	260	0	1	0	gen
2	61469095	61469427	MACS_peak_10262	412.03	332	0	1	0	gen
2	61625430	61625636	MACS_peak_10263	690.17	206	0	0	0	intergen
2	61848769	61849158	MACS_peak_10264	1662.16	389	0	1	0	gen
2	62022442	62022577	MACS_peak_10265	1828.2	135	0	1	0	gen
2	62423156	62423421	MACS_peak_10266	380.3	265	0	0	0	intergen
2	62610253	62610551	MACS_peak_10268	110.93	298	0	0	1	other
2	62775086	62775345	MACS_peak_10269	468.05	259	0	1	0	gen
2	62787314	62787600	MACS_peak_10270	380.3	286	0	1	0	gen
2	62837685	62838079	MACS_peak_10271	111.58	394	0	1	1	gen
2	62839936	62840235	MACS_peak_10272	79.03	299	0	1	1	gen
2	62840645	62841027	MACS_peak_10273	56.64	382	0	1	1	gen
2	62951363	62951545	MACS_peak_10274	729.14	182	0	1	0	gen
2	63088123	63088592	MACS_peak_10275	63.24	469	0	0	0	intergen
2	63089558	63089953	MACS_peak_10276	100.2	395	0	0	0	intergen
2	63091544	63091799	MACS_peak_10277	95.32	255	0	0	0	intergen
2	63215342	63215669	MACS_peak_10278	118.05	327	0	1	0	gen
2	63451911	63452360	MACS_peak_10279	79.6	449	0	1	0	gen
2	63488229	63488529	MACS_peak_10280	442.68	300	0	1	0	gen
2	63536388	63536786	MACS_peak_10281	323.22	398	0	1	0	gen
2	63544131	63544431	MACS_peak_10282	442.68	300	0	1	0	gen
2	63861682	63861980	MACS_peak_10283	565.28	298	0	1	0	gen
2	63888765	63889128	MACS_peak_10284	644.81	363	1	1	0	promoter
2	63928666	63928906	MACS_peak_10285	223.38	240	0	1	0	gen
2	64049738	64049982	MACS_peak_10286	896.52	244	0	0	0	intergen
2	64159317	64159479	MACS_peak_10287	848.95	162	0	0	1	other
2	64522613	64523094	MACS_peak_10288	1290.51	481	1	0	1	promoter
2	64646314	64646686	MACS_peak_10289	405.79	372	0	1	1	gen
2	64831781	64832019	MACS_peak_10290	662.31	238	0	0	0	intergen
2	64842897	64843322	MACS_peak_10291	1519.94	425	0	0	0	intergen
2	64843738	64844128	MACS_peak_10292	805.99	390	0	0	0	intergen
2	64894629	64894841	MACS_peak_10293	265.71	212	0	0	0	intergen
2	65169241	65169616	MACS_peak_10294	672.29	375	0	0	0	intergen
2	65640618	65640840	MACS_peak_10295	508.73	222	0	0	1	other
2	66142175	66142506	MACS_peak_10296	76.42	331	0	0	0	intergen
2	66349528	66349691	MACS_peak_10297	334	163	0	0	0	intergen
2	66349921	66350251	MACS_peak_10298	55.53	330	0	0	0	intergen
2	66392790	66393130	MACS_peak_10299	52.99	340	0	0	0	intergen
2	66394912	66395357	MACS_peak_10300	128.26	445	0	0	0	intergen
2	66399100	66399379	MACS_peak_10301	275.06	279	0	0	0	intergen
2	66429084	66429411	MACS_peak_10302	427.87	327	1	0	1	promoter
2	66610756	66611044	MACS_peak_10303	142.05	288	0	0	1	other
2	66620874	66621257	MACS_peak_10304	112.03	383	0	0	1	other
2	66718691	66719067	MACS_peak_10306	78.93	376	0	0	1	other
2	66719201	66719575	MACS_peak_10307	69.45	374	0	0	1	other
2	66719701	66720101	MACS_peak_10308	63.81	400	0	0	1	other
2	66911658	66911889	MACS_peak_10309	276	231	0	0	1	other
2	67531579	67531806	MACS_peak_10310	848.95	227	0	0	0	intergen
2	67698037	67698403	MACS_peak_10311	89.52	366	0	0	0	intergen
2	67698735	67699142	MACS_peak_10312	207.88	407	0	0	0	intergen
2	67815129	67815366	MACS_peak_10313	440.38	237	0	0	1	other
2	67846571	67846818	MACS_peak_10314	485.56	247	0	0	0	intergen
2	68031576	68031830	MACS_peak_10315	883.81	254	0	0	0	intergen
2	68282866	68283150	MACS_peak_10316	575.25	284	1	0	0	promoter
2	68292223	68292497	MACS_peak_10317	847.52	274	0	1	0	gen
2	68449593	68449935	MACS_peak_10318	308.09	342	0	0	0	intergen
2	68463329	68463592	MACS_peak_10321	462.74	263	2	0	0	promoter
2	68509389	68509724	MACS_peak_10322	128.57	335	0	1	0	gen
2	68518810	68519249	MACS_peak_10323	717.72	439	0	1	0	gen
2	68571150	68571548	MACS_peak_10324	122.09	398	0	1	0	gen
2	68595237	68595491	MACS_peak_10325	895.51	254	0	1	0	gen
2	68616257	68616624	MACS_peak_10326	63.02	367	0	1	0	gen
2	68677813	68678135	MACS_peak_10327	110.72	322	1	0	0	promoter
2	68678233	68678607	MACS_peak_10328	62.77	374	1	0	0	promoter
2	68837283	68837592	MACS_peak_10329	949.2	309	0	0	1	other
2	68876515	68876647	MACS_peak_10330	1116.4	132	0	0	0	intergen
2	68925398	68925613	MACS_peak_10331	634.18	215	0	0	1	other
2	69559761	69560082	MACS_peak_10332	431.05	321	0	1	0	gen
2	69562710	69562980	MACS_peak_10333	460.86	270	0	1	0	gen
2	69565419	69565643	MACS_peak_10334	712.32	224	0	1	0	gen
2	69817044	69817266	MACS_peak_10335	712.32	222	0	1	0	gen
2	70429912	70430234	MACS_peak_10336	59.93	322	0	0	0	intergen
2	70647945	70648176	MACS_peak_10337	831.63	231	0	1	0	gen
2	70785365	70785542	MACS_peak_10338	763.02	177	0	1	0	gen
2	70861826	70862056	MACS_peak_10339	532.66	230	0	0	0	intergen
2	70977403	70977715	MACS_peak_10340	435.94	312	1	1	0	promoter
2	71157511	71157732	MACS_peak_10341	374.94	221	0	0	0	intergen
2	71411249	71411619	MACS_peak_10342	57.98	370	0	1	0	gen
2	71871699	71872127	MACS_peak_10344	605.31	428	0	0	0	intergen
2	72018841	72019109	MACS_peak_10345	76.1	268	0	0	0	intergen
2	72228662	72229008	MACS_peak_10346	85.77	346	0	1	0	gen
2	72368601	72368916	MACS_peak_10347	77.81	315	0	1	0	gen
2	72406236	72406512	MACS_peak_10348	114.26	276	0	1	0	gen
2	72406700	72407066	MACS_peak_10349	105.57	366	0	1	0	gen
2	72407207	72407465	MACS_peak_10350	72.7	258	0	1	0	gen
2	72579659	72580019	MACS_peak_10352	411.4	360	0	1	0	gen
2	72605928	72606186	MACS_peak_10353	845.32	258	0	1	0	gen
2	72745825	72746104	MACS_peak_10354	455.19	279	0	1	0	gen
2	72770934	72771125	MACS_peak_10355	695.57	191	0	1	0	gen
2	72887907	72888129	MACS_peak_10356	564.54	222	1	0	0	promoter
2	73033300	73033492	MACS_peak_10357	866.35	192	0	1	0	gen
2	73212536	73212849	MACS_peak_10358	1083.46	313	1	0	0	promoter
2	73541382	73541805	MACS_peak_10360	63.13	423	0	1	0	gen
2	73630617	73631028	MACS_peak_10361	1395.29	411	0	0	0	intergen
2	73666336	73666692	MACS_peak_10362	153.42	356	0	0	1	other
2	73667375	73667783	MACS_peak_10363	157.17	408	0	0	1	other
2	73690624	73691069	MACS_peak_10364	1224.31	445	0	0	0	intergen
2	73724428	73724649	MACS_peak_10365	140.83	221	1	0	0	promoter
2	73753846	73754288	MACS_peak_10366	1094.3	442	0	0	0	intergen
2	73839643	73839888	MACS_peak_10367	629.38	245	0	1	0	gen
2	74129312	74129449	MACS_peak_10368	552.8	137	0	0	0	intergen
2	74147889	74148097	MACS_peak_10369	755.29	208	1	0	0	promoter
2	74250137	74250342	MACS_peak_10370	972.07	205	0	2	0	gen
2	74261536	74261887	MACS_peak_10371	531.49	351	0	2	0	gen
2	74334897	74335184	MACS_peak_10372	450.32	287	0	2	0	gen
2	74392041	74392376	MACS_peak_10373	423.72	335	1	0	1	promoter
2	74973333	74973756	MACS_peak_10374	161.97	423	0	0	0	intergen
2	74982727	74982949	MACS_peak_10375	497.26	222	0	0	0	intergen
2	74988566	74988956	MACS_peak_10376	81.3	390	0	0	0	intergen
2	75053606	75053877	MACS_peak_10377	460.22	271	0	1	0	gen
2	75064981	75065219	MACS_peak_10378	406.99	238	0	1	0	gen
2	75082381	75082720	MACS_peak_10379	70.76	339	0	1	0	gen
2	75199563	75199908	MACS_peak_10380	418.68	345	0	0	0	intergen
2	75328481	75328921	MACS_peak_10381	50.57	440	0	0	0	intergen
2	75404031	75404335	MACS_peak_10382	687.55	304	0	0	0	intergen
2	75464618	75464874	MACS_peak_10383	596.79	256	1	0	0	promoter
2	75507966	75508286	MACS_peak_10384	191.79	320	0	1	0	gen
2	75535222	75535462	MACS_peak_10385	517.04	240	0	1	1	gen
2	75677373	75677764	MACS_peak_10386	445.21	391	0	2	0	gen
2	76092825	76093147	MACS_peak_10389	50.93	322	0	0	0	intergen
2	76299584	76299926	MACS_peak_10390	78.34	342	0	0	0	intergen
2	76301447	76301768	MACS_peak_10391	50.92	321	0	0	0	intergen
2	76574449	76574814	MACS_peak_10392	106.92	365	0	0	0	intergen
2	76648411	76648856	MACS_peak_10393	57.21	445	0	0	0	intergen
2	76799725	76800051	MACS_peak_10394	66.94	326	0	1	0	gen
2	76837226	76837574	MACS_peak_10395	89.02	348	0	1	0	gen
2	76909266	76909635	MACS_peak_10396	87.41	369	0	1	0	gen
2	77093124	77093388	MACS_peak_10397	138.38	264	0	1	0	gen
2	77138511	77138877	MACS_peak_10398	103.45	366	0	1	0	gen
2	77381515	77381798	MACS_peak_10399	452.74	283	0	1	0	gen
2	77391423	77391609	MACS_peak_10400	662.76	186	0	1	0	gen
2	77550914	77551139	MACS_peak_10401	548.55	225	0	1	0	gen
2	77647473	77647821	MACS_peak_10402	106.64	348	0	0	0	intergen
2	77745591	77745860	MACS_peak_10403	461.5	269	0	0	0	intergen
2	77754197	77754519	MACS_peak_10404	123.45	322	0	0	0	intergen
2	77758455	77758787	MACS_peak_10405	118.67	332	0	0	0	intergen
2	77843175	77843534	MACS_peak_10406	223.6	359	0	0	0	intergen
2	77863588	77863856	MACS_peak_10407	1137.17	268	0	0	0	intergen
2	77955050	77955259	MACS_peak_10408	606	209	0	0	0	intergen
2	78192090	78192421	MACS_peak_10409	425.78	331	0	0	0	intergen
2	78351280	78351557	MACS_peak_10410	603.02	277	0	0	0	intergen
2	78673098	78673295	MACS_peak_10411	721.03	197	0	0	0	intergen
2	79040935	79041238	MACS_peak_10412	561.84	303	0	0	0	intergen
2	79935852	79936039	MACS_peak_10414	677.98	187	0	1	0	gen
2	80072965	80073342	MACS_peak_10415	403.51	377	0	1	0	gen
2	80095178	80095430	MACS_peak_10416	88.17	252	0	1	0	gen
2	80195006	80195422	MACS_peak_10417	612.12	416	0	1	0	gen
2	80238754	80238936	MACS_peak_10418	729.14	182	0	1	0	gen
2	80595987	80596330	MACS_peak_10419	189.06	343	0	1	1	gen
2	81221876	81222258	MACS_peak_10421	76.3	382	0	0	0	intergen
2	81360683	81360976	MACS_peak_10422	56.38	293	0	0	0	intergen
2	81841986	81842367	MACS_peak_10423	74.48	381	0	0	0	intergen
2	81844784	81845128	MACS_peak_10424	96.02	344	0	0	0	intergen
2	81845276	81845634	MACS_peak_10425	68.24	358	0	0	0	intergen
2	82135177	82135481	MACS_peak_10426	440.4	304	0	0	0	intergen
2	82244298	82244705	MACS_peak_10428	177.36	407	0	0	0	intergen
2	82295312	82295553	MACS_peak_10429	588.69	241	0	0	0	intergen
2	82721869	82722202	MACS_peak_10430	112.04	333	0	0	0	intergen
2	82987801	82988095	MACS_peak_10431	695.63	294	0	0	0	intergen
2	83092254	83092714	MACS_peak_10432	81.04	460	0	0	0	intergen
2	83148088	83148522	MACS_peak_10434	219.35	434	0	0	0	intergen
2	83149421	83149557	MACS_peak_10435	1647.16	136	0	0	0	intergen
2	83243346	83243716	MACS_peak_10436	158.81	370	0	0	0	intergen
2	83352891	83353238	MACS_peak_10439	137.17	347	0	0	0	intergen
2	83457042	83457314	MACS_peak_10440	714.45	272	0	0	0	intergen
2	83496932	83497332	MACS_peak_10441	89.02	400	0	0	0	intergen
2	83663799	83664155	MACS_peak_10442	369.16	356	0	0	0	intergen
2	83718358	83718637	MACS_peak_10443	722.05	279	0	0	0	intergen
2	83770651	83771051	MACS_peak_10444	56.86	400	0	0	0	intergen
2	83771205	83771597	MACS_peak_10445	70.6	392	0	0	0	intergen
2	83914262	83914564	MACS_peak_10446	663.82	302	0	0	0	intergen
2	83980578	83980836	MACS_peak_10447	137.66	258	0	0	0	intergen
2	84264497	84264685	MACS_peak_10449	184.62	188	0	0	0	intergen
2	84266122	84266480	MACS_peak_10450	73.33	358	0	0	0	intergen
2	84267937	84268243	MACS_peak_10451	158.81	306	0	0	0	intergen
2	84356734	84357051	MACS_peak_10452	395.81	317	0	0	0	intergen
2	84369560	84369913	MACS_peak_10453	103.51	353	0	0	0	intergen
2	84369979	84370318	MACS_peak_10454	121.16	339	0	0	0	intergen
2	84510239	84510528	MACS_peak_10455	199.81	289	0	0	0	intergen
2	84563365	84563569	MACS_peak_10456	444.58	204	0	1	0	gen
2	84631226	84631414	MACS_peak_10457	695.57	188	0	1	0	gen
2	84893664	84893903	MACS_peak_10459	644.37	239	0	1	0	gen
2	84927028	84927292	MACS_peak_10460	464.74	264	0	0	0	intergen
2	85014801	85015031	MACS_peak_10461	483.43	230	0	1	0	gen
2	85017702	85018179	MACS_peak_10462	814.88	477	0	1	0	gen
2	85212092	85212225	MACS_peak_10463	1365.09	133	0	1	0	gen
2	85266547	85266807	MACS_peak_10464	840.66	260	0	1	0	gen
2	85294022	85294160	MACS_peak_10465	2131.25	138	0	1	0	gen
2	85406602	85406986	MACS_peak_10466	473.83	384	0	1	0	gen
2	85481536	85481670	MACS_peak_10467	659.93	134	0	0	0	intergen
2	85679237	85679497	MACS_peak_10469	508.15	260	0	0	0	intergen
2	85967374	85967785	MACS_peak_10470	55.74	411	0	0	0	intergen
2	85969010	85969358	MACS_peak_10471	52.01	348	0	0	0	intergen
2	86221141	86221414	MACS_peak_10472	458.95	273	0	1	0	gen
2	86590125	86590401	MACS_peak_10473	960.3	276	0	1	1	gen
2	86888006	86888179	MACS_peak_10474	641.15	173	0	0	1	other
2	86900801	86901015	MACS_peak_10475	960.62	214	0	0	1	other
2	86958408	86958886	MACS_peak_10476	774.37	478	0	1	0	gen
2	87025799	87026275	MACS_peak_10477	721.05	476	0	0	0	intergen
2	87041608	87041890	MACS_peak_10478	737.63	282	0	0	2	other
2	87151789	87152199	MACS_peak_10479	994.75	410	0	0	1	other
2	87360831	87361165	MACS_peak_10480	372.1	334	0	0	0	intergen
2	87363413	87363666	MACS_peak_10481	634.09	253	0	0	0	intergen
2	87364916	87365296	MACS_peak_10482	404.35	380	0	0	0	intergen
2	87466765	87467054	MACS_peak_10483	699.78	289	0	0	2	other
2	87503028	87503219	MACS_peak_10484	866.35	191	0	0	2	other
2	87577501	87577776	MACS_peak_10485	846.51	275	0	0	2	other
2	87727901	87728311	MACS_peak_10486	956.45	410	0	0	2	other
2	87743660	87744136	MACS_peak_10487	721.05	476	1	0	1	promoter
2	87811025	87811503	MACS_peak_10488	785.41	478	0	1	0	gen
2	87841909	87842190	MACS_peak_10489	105.65	281	0	0	0	intergen
2	87842919	87843370	MACS_peak_10490	93.78	451	0	0	0	intergen
2	87907182	87907539	MACS_peak_10491	93.4	357	0	0	0	intergen
2	87992640	87993074	MACS_peak_10492	852.31	434	0	0	0	intergen
2	88021658	88021801	MACS_peak_10493	746.43	143	0	0	0	intergen
2	88149865	88150240	MACS_peak_10494	57.86	375	0	0	0	intergen
2	88187205	88187423	MACS_peak_10495	729.14	218	0	0	0	intergen
2	88454883	88455173	MACS_peak_10496	680.29	290	0	0	0	intergen
2	88874173	88874375	MACS_peak_10497	989.9	202	0	0	0	intergen
2	88880342	88880653	MACS_peak_10498	534.92	311	0	0	0	intergen
2	88967922	88968159	MACS_peak_10499	516.86	237	0	0	0	intergen
2	89154333	89154614	MACS_peak_10500	607	281	0	0	0	intergen
2	89160350	89160636	MACS_peak_10501	808.84	286	0	0	0	intergen
2	89231256	89231650	MACS_peak_10502	1815.39	394	0	0	0	intergen
2	89272974	89273284	MACS_peak_10504	410.6	310	0	0	0	intergen
2	89307258	89307691	MACS_peak_10505	602.54	433	0	0	0	intergen
2	89788782	89789113	MACS_peak_10507	172.18	331	0	0	0	intergen
2	89795666	89796133	MACS_peak_10509	202.43	467	0	0	0	intergen
2	89800445	89800757	MACS_peak_10510	143.66	312	0	0	0	intergen
2	89806229	89806660	MACS_peak_10512	194.2	431	0	0	0	intergen
2	89807527	89807843	MACS_peak_10513	127.94	316	0	0	0	intergen
2	89807898	89808355	MACS_peak_10514	98.68	457	0	0	0	intergen
2	89815654	89816090	MACS_peak_10517	168.04	436	0	0	0	intergen
2	89818306	89818702	MACS_peak_10518	132.65	396	0	0	0	intergen
2	89820676	89821052	MACS_peak_10519	443.45	376	0	0	0	intergen
2	89874776	89875207	MACS_peak_10525	846.12	431	0	0	0	intergen
2	89950728	89951190	MACS_peak_10526	1993.08	462	0	0	0	intergen
2	89972175	89972559	MACS_peak_10527	348.12	384	0	0	0	intergen
2	90021292	90021585	MACS_peak_10528	766.74	293	0	0	0	intergen
2	90027261	90027594	MACS_peak_10529	603.26	333	0	0	0	intergen
2	90256977	90257322	MACS_peak_10530	264.22	345	0	0	0	intergen
2	90400984	90401233	MACS_peak_10531	135.62	249	0	0	0	intergen
2	90393384	90393802	MACS_peak_10532	132.65	418	0	0	0	intergen
2	90387903	90388196	MACS_peak_10534	50.56	293	0	0	0	intergen
2	90382097	90382361	MACS_peak_10536	83.27	264	0	0	0	intergen
2	91428460	91428764	MACS_peak_10537	51.72	304	0	0	0	intergen
2	90364174	90364493	MACS_peak_10539	269.15	319	0	0	0	intergen
2	90345818	90346107	MACS_peak_10540	121.78	289	0	0	0	intergen
2	90337282	90337663	MACS_peak_10541	85.86	381	0	0	0	intergen
2	90332551	90332916	MACS_peak_10542	93.45	365	0	0	0	intergen
2	87372226	87372663	MACS_peak_10544	57.86	437	0	0	0	intergen
2	91438510	91438803	MACS_peak_10553	434.75	293	0	0	0	intergen
2	91457817	91458120	MACS_peak_10555	105.42	303	0	0	0	intergen
2	91485275	91485642	MACS_peak_10557	394.76	367	0	0	0	intergen
2	91485872	91486171	MACS_peak_10558	202.1	299	0	0	0	intergen
2	91489931	91490232	MACS_peak_10559	142.05	301	0	0	0	intergen
2	91559516	91559769	MACS_peak_10561	488.16	253	0	0	0	intergen
2	91626874	91627303	MACS_peak_10562	472.98	429	0	0	1	other
2	91628488	91628931	MACS_peak_10563	770.96	443	0	0	1	other
2	91630632	91631026	MACS_peak_10564	482.24	394	0	0	1	other
2	91700149	91700442	MACS_peak_10565	1076.96	293	0	0	1	other
2	91707579	91707808	MACS_peak_10566	518.37	229	0	0	1	other
2	91793420	91793790	MACS_peak_10567	103.14	370	0	0	0	intergen
2	91802501	91802874	MACS_peak_10568	125.35	373	0	0	0	intergen
2	91810738	91811144	MACS_peak_10569	3100	406	0	0	0	intergen
2	91816261	91816628	MACS_peak_10570	780.05	367	0	0	0	intergen
2	91824864	91825332	MACS_peak_10571	1559.49	468	0	0	0	intergen
2	91830257	91830649	MACS_peak_10572	1798.89	392	0	0	0	intergen
2	91837007	91837428	MACS_peak_10573	450.73	421	0	0	0	intergen
2	91895085	91895513	MACS_peak_10574	746.04	428	0	0	1	other
2	92015306	92015727	MACS_peak_10575	429.94	421	0	0	0	intergen
2	92022114	92022506	MACS_peak_10576	1588.26	392	0	0	0	intergen
2	92024365	92024719	MACS_peak_10577	144.41	354	0	0	0	intergen
2	92027431	92027899	MACS_peak_10578	1457.84	468	0	0	0	intergen
2	92035508	92035800	MACS_peak_10579	180.31	292	0	0	0	intergen
2	92036141	92036508	MACS_peak_10580	668.85	367	0	0	0	intergen
2	92041627	92042033	MACS_peak_10581	3100	406	0	0	0	intergen
2	92049899	92050272	MACS_peak_10582	122.53	373	0	0	0	intergen
2	92053514	92053814	MACS_peak_10583	94.35	300	0	0	0	intergen
2	92058987	92059357	MACS_peak_10584	80.06	370	0	0	0	intergen
2	92079561	92079893	MACS_peak_10585	60.74	332	0	0	0	intergen
2	92080122	92080544	MACS_peak_10586	108.93	422	0	0	0	intergen
2	92094032	92094474	MACS_peak_10592	88.69	442	0	0	0	intergen
2	94797243	94797553	MACS_peak_10600	840.76	310	0	0	1	other
2	94956923	94957141	MACS_peak_10601	556.96	218	0	0	0	intergen
2	95064571	95064904	MACS_peak_10602	526.43	333	0	0	0	intergen
2	95070753	95071124	MACS_peak_10603	506.63	371	0	0	0	intergen
2	95097430	95097875	MACS_peak_10604	90.55	445	0	1	0	gen
2	95115395	95115684	MACS_peak_10605	555.65	289	0	1	0	gen
2	95192891	95193153	MACS_peak_10606	762.37	262	0	0	0	intergen
2	95263677	95263942	MACS_peak_10607	488.85	265	0	0	0	intergen
2	95414097	95414260	MACS_peak_10608	1079.97	163	0	1	1	gen
2	95780402	95780773	MACS_peak_10609	83.56	371	0	0	0	intergen
2	96384502	96384802	MACS_peak_10613	74.03	300	0	0	0	intergen
2	96456879	96457179	MACS_peak_10614	187.16	300	0	0	0	intergen
2	96509404	96509691	MACS_peak_10615	450.32	287	0	0	0	intergen
2	96987168	96987309	MACS_peak_10616	382.33	141	0	0	0	intergen
2	97004012	97004446	MACS_peak_10617	327.36	434	0	0	0	intergen
2	97112228	97112655	MACS_peak_10618	1677.51	427	1	0	0	promoter
2	97171060	97171424	MACS_peak_10619	61.7	364	0	1	0	gen
2	97229411	97229618	MACS_peak_10620	170.73	207	0	1	0	gen
2	97305570	97305774	MACS_peak_10621	573.39	204	0	0	0	intergen
2	97402727	97402931	MACS_peak_10622	573.39	204	0	0	0	intergen
2	97590819	97591063	MACS_peak_10623	1132.66	244	0	0	0	intergen
2	97597032	97597365	MACS_peak_10624	69.11	333	0	0	0	intergen
2	97697194	97697578	MACS_peak_10625	513.02	384	0	1	0	gen
2	97885218	97885494	MACS_peak_10626	380.3	276	0	1	0	gen
2	97923524	97923889	MACS_peak_10627	488.85	365	0	1	0	gen
2	97941169	97941556	MACS_peak_10628	125.63	387	0	1	0	gen
2	98487987	98488201	MACS_peak_10629	746.04	214	0	1	0	gen
2	98569103	98569468	MACS_peak_10630	523.45	365	0	1	0	gen
2	98594839	98595286	MACS_peak_10631	75.42	447	1	0	0	promoter
2	98990956	98991366	MACS_peak_10632	172.39	410	0	0	0	intergen
2	99006387	99006822	MACS_peak_10633	97.26	435	0	1	0	gen
2	99454546	99454685	MACS_peak_10634	475.03	139	0	1	0	gen
2	99740384	99740638	MACS_peak_10635	63.04	254	0	1	0	gen
2	100029547	100029787	MACS_peak_10636	514.01	240	0	1	0	gen
2	100151851	100152203	MACS_peak_10638	93.17	352	0	0	0	intergen
2	100242884	100243245	MACS_peak_10639	525.71	361	0	0	1	other
2	100262652	100263093	MACS_peak_10640	965.4	441	0	0	0	intergen
2	101012705	101012938	MACS_peak_10641	712.11	233	0	2	0	gen
2	101016277	101016530	MACS_peak_10642	83.72	253	0	2	0	gen
2	101036638	101036922	MACS_peak_10643	575.25	284	0	1	0	gen
2	101078558	101078733	MACS_peak_10644	726.33	175	0	1	0	gen
2	101152963	101153197	MACS_peak_10645	532.66	234	0	1	1	gen
2	101205594	101205829	MACS_peak_10646	516.86	235	0	1	0	gen
2	101238243	101238464	MACS_peak_10647	1396.21	221	0	1	0	gen
2	101240598	101240976	MACS_peak_10648	516.25	378	0	1	0	gen
2	101244595	101244872	MACS_peak_10649	2192.28	277	0	1	0	gen
2	101439102	101439289	MACS_peak_10650	712.32	187	0	1	0	gen
2	102311765	102312101	MACS_peak_10651	663.41	336	2	0	0	promoter
2	102325829	102326293	MACS_peak_10652	222.1	464	0	2	0	gen
2	102327833	102328151	MACS_peak_10653	50.5	318	0	2	0	gen
2	102592615	102592963	MACS_peak_10655	654.96	348	0	0	0	intergen
2	102703762	102704041	MACS_peak_10656	455.19	279	0	1	0	gen
2	102753618	102753953	MACS_peak_10657	664.12	335	0	1	0	gen
2	103161500	103161747	MACS_peak_10658	485.56	247	0	0	1	other
2	103426356	103426828	MACS_peak_10660	202.06	472	0	0	0	intergen
2	103426923	103427309	MACS_peak_10661	733.26	386	0	0	0	intergen
2	103535786	103536065	MACS_peak_10662	100.56	279	0	0	0	intergen
2	103596939	103597162	MACS_peak_10663	564.54	223	0	0	0	intergen
2	103991661	103991861	MACS_peak_10664	1007.8	200	0	0	1	other
2	104079053	104079273	MACS_peak_10665	564.54	220	0	0	0	intergen
2	104412497	104412714	MACS_peak_10666	580.62	217	0	0	2	other
2	105206677	105206925	MACS_peak_10667	123.71	248	0	0	0	intergen
2	105287784	105287987	MACS_peak_10668	629.38	203	0	1	0	gen
2	105576406	105576632	MACS_peak_10669	548.55	226	0	0	0	intergen
2	105782341	105782621	MACS_peak_10670	578.19	280	0	1	0	gen
2	105817572	105817984	MACS_peak_10671	398.43	412	0	1	0	gen
2	106133386	106133678	MACS_peak_10672	60.53	292	0	1	0	gen
2	106136354	106136717	MACS_peak_10674	53.51	363	0	1	0	gen
2	106451795	106452223	MACS_peak_10675	746.04	428	0	1	0	gen
2	106470717	106470931	MACS_peak_10677	1619.15	214	0	0	0	intergen
2	106542577	106542963	MACS_peak_10678	511.95	386	0	1	1	gen
2	106582669	106582955	MACS_peak_10679	450.92	286	0	0	0	intergen
2	106587529	106587912	MACS_peak_10680	400.82	383	0	0	0	intergen
2	106946677	106947036	MACS_peak_10681	56.38	359	0	0	0	intergen
2	107189942	107190299	MACS_peak_10682	63.13	357	0	0	0	intergen
2	107572792	107573198	MACS_peak_10683	1281.64	406	0	0	0	intergen
2	107703329	107703680	MACS_peak_10684	380.3	351	0	0	0	intergen
2	107744219	107744601	MACS_peak_10685	514.09	382	0	0	0	intergen
2	107795576	107795987	MACS_peak_10686	137.06	411	0	0	1	other
2	107843711	107844139	MACS_peak_10688	679.82	428	0	1	0	gen
2	107845041	107845328	MACS_peak_10689	127.5	287	0	1	0	gen
2	107936846	107937084	MACS_peak_10690	516.86	238	0	0	0	intergen
2	108194966	108195162	MACS_peak_10692	458.43	196	0	0	1	other
2	108336994	108337342	MACS_peak_10694	59.91	348	0	0	1	other
2	108337884	108338230	MACS_peak_10695	119.94	346	0	0	1	other
2	108415377	108415843	MACS_peak_10696	1320.42	466	0	0	0	intergen
2	108484540	108484735	MACS_peak_10697	219.1	195	0	1	0	gen
2	108597374	108597593	MACS_peak_10698	1036.76	219	0	1	0	gen
2	108636496	108636725	MACS_peak_10699	848.95	229	0	1	0	gen
2	108646374	108646632	MACS_peak_10700	243.49	258	0	1	0	gen
2	108690020	108690296	MACS_peak_10701	430.51	276	0	0	0	intergen
2	108725090	108725551	MACS_peak_10702	497.46	461	0	1	0	gen
2	108736323	108736492	MACS_peak_10703	588.24	169	0	1	0	gen
2	108904090	108904323	MACS_peak_10704	785.95	233	0	1	0	gen
2	108928479	108928748	MACS_peak_10705	972.38	269	0	1	0	gen
2	108989215	108989495	MACS_peak_10706	578.19	280	0	0	0	intergen
2	109546134	109546401	MACS_peak_10708	854.69	267	1	0	0	promoter
2	109792721	109792997	MACS_peak_10709	430.51	276	1	0	0	promoter
2	109793830	109794310	MACS_peak_10710	1709	480	1	0	0	promoter
2	109798548	109798923	MACS_peak_10711	258.93	375	0	1	0	gen
2	109851113	109851320	MACS_peak_10713	696.15	207	0	1	0	gen
2	109871139	109871425	MACS_peak_10714	755.05	286	0	0	0	intergen
2	109889953	109890304	MACS_peak_10715	975.16	351	0	0	0	intergen
2	109957696	109957931	MACS_peak_10716	129.18	235	0	1	2	gen
2	109987855	109988088	MACS_peak_10717	532.66	233	0	0	2	other
2	110071929	110072359	MACS_peak_10718	459.13	430	0	0	0	intergen
2	110137709	110138024	MACS_peak_10719	84.4	315	0	1	0	gen
2	110195898	110196225	MACS_peak_10720	89.62	327	0	1	0	gen
2	110296488	110296914	MACS_peak_10721	57.53	426	0	0	0	intergen
2	110297526	110297880	MACS_peak_10722	94.38	354	0	0	0	intergen
2	110375395	110375763	MACS_peak_10726	103.45	368	0	0	1	other
2	110416595	110416809	MACS_peak_10727	220.75	214	0	1	2	gen
2	110422470	110422607	MACS_peak_10728	1061.85	137	0	1	2	gen
2	110481334	110481553	MACS_peak_10729	1289.87	219	0	0	0	intergen
2	110500081	110500367	MACS_peak_10730	729.71	286	0	0	0	intergen
2	110520189	110520329	MACS_peak_10731	1302.19	140	0	1	0	gen
2	110572584	110572959	MACS_peak_10733	342.06	375	0	1	0	gen
2	110577179	110577622	MACS_peak_10734	1351.81	443	0	0	0	intergen
2	110578492	110578768	MACS_peak_10735	433.72	276	0	0	0	intergen
2	110686914	110687153	MACS_peak_10736	797.18	239	0	0	0	intergen
2	110853603	110853947	MACS_peak_10737	657.74	344	0	1	0	gen
2	111373041	111373316	MACS_peak_10738	846.51	275	0	0	1	other
2	111447616	111447807	MACS_peak_10739	866.35	191	0	0	2	other
2	111483149	111483438	MACS_peak_10740	699.78	289	0	0	3	other
2	111588967	111589345	MACS_peak_10741	75.39	378	0	0	2	other
2	111589811	111590144	MACS_peak_10742	56.31	333	0	0	2	other
2	111619517	111619737	MACS_peak_10743	564.54	220	0	1	2	gen
2	111813254	111813675	MACS_peak_10744	649.49	421	0	1	0	gen
2	111850726	111851128	MACS_peak_10745	1178.01	402	0	1	0	gen
2	111964035	111964295	MACS_peak_10746	353.78	260	0	1	0	gen
2	112048842	112049184	MACS_peak_10747	701.84	342	0	0	0	intergen
2	112049289	112049538	MACS_peak_10748	753.9	249	0	0	0	intergen
2	112094921	112095308	MACS_peak_10749	301.88	387	0	1	0	gen
2	112213768	112213959	MACS_peak_10750	711.79	191	1	0	0	promoter
2	112259413	112259756	MACS_peak_10751	658.44	343	0	0	0	intergen
2	112427159	112427534	MACS_peak_10753	356.7	375	0	1	0	gen
2	112433606	112433986	MACS_peak_10754	1722.91	380	0	1	0	gen
2	112481064	112481274	MACS_peak_10755	936.57	210	1	0	0	promoter
2	112501184	112501470	MACS_peak_10756	437.35	286	0	1	0	gen
2	112501861	112502086	MACS_peak_10757	184.47	225	0	1	0	gen
2	112600173	112600400	MACS_peak_10758	498.19	227	0	0	1	other
2	112626518	112626887	MACS_peak_10759	468.12	369	0	0	0	intergen
2	112726814	112727019	MACS_peak_10760	629.38	205	0	1	0	gen
2	112876559	112876708	MACS_peak_10761	954.29	149	0	0	0	intergen
2	113084322	113084588	MACS_peak_10762	463.44	266	0	0	0	intergen
2	113138272	113138671	MACS_peak_10763	505.16	399	0	0	0	intergen
2	113199212	113199423	MACS_peak_10764	596.79	211	0	1	0	gen
2	113249216	113249509	MACS_peak_10765	677.8	293	0	1	1	gen
2	113326580	113326713	MACS_peak_10766	1049.81	133	0	0	0	intergen
2	113440607	113440963	MACS_peak_10767	886.67	356	1	0	0	promoter
2	113527411	113527779	MACS_peak_10769	2141.93	368	0	0	0	intergen
2	113601798	113602180	MACS_peak_10770	1236.66	382	0	0	0	intergen
2	113604115	113604401	MACS_peak_10771	1032.42	286	0	0	0	intergen
2	113661214	113661594	MACS_peak_10772	120.65	380	0	0	0	intergen
2	113806073	113806205	MACS_peak_10773	1116.4	132	0	0	0	intergen
2	113907874	113908010	MACS_peak_10774	1358.26	136	0	1	0	gen
2	114015138	114015369	MACS_peak_10775	163.16	231	0	0	0	intergen
2	114015594	114015870	MACS_peak_10776	110.72	276	0	0	0	intergen
2	114058640	114058967	MACS_peak_10777	81.15	327	0	0	0	intergen
2	114099174	114099433	MACS_peak_10778	93.87	259	0	0	0	intergen
2	114358598	114358935	MACS_peak_10779	69	337	0	0	0	intergen
2	114370857	114371273	MACS_peak_10780	496.62	416	0	0	0	intergen
2	114517971	114518105	MACS_peak_10782	712.83	134	0	1	0	gen
2	114749062	114749329	MACS_peak_10783	84.4	267	0	1	0	gen
2	114808433	114808567	MACS_peak_10784	1377.21	134	0	1	0	gen
2	114897313	114897717	MACS_peak_10785	66.43	404	0	1	0	gen
2	114898207	114898527	MACS_peak_10786	184.45	320	0	1	0	gen
2	115165468	115165789	MACS_peak_10787	431.05	321	0	1	0	gen
2	115332504	115332789	MACS_peak_10788	149.97	285	0	1	0	gen
2	115487151	115487607	MACS_peak_10789	88.93	456	0	1	0	gen
2	115813962	115814188	MACS_peak_10790	548.55	226	0	1	0	gen
2	116423958	116424209	MACS_peak_10791	455.03	251	0	0	0	intergen
2	116428709	116429077	MACS_peak_10792	653.06	368	0	0	0	intergen
2	116435767	116435988	MACS_peak_10793	513.05	221	0	0	0	intergen
2	116642335	116642584	MACS_peak_10794	65.38	249	0	0	0	intergen
2	116830259	116830721	MACS_peak_10795	633.2	462	0	0	0	intergen
2	116989323	116989518	MACS_peak_10797	280.74	195	0	0	0	intergen
2	117226073	117226449	MACS_peak_10798	85.15	376	0	0	0	intergen
2	117412005	117412358	MACS_peak_10799	414.75	353	0	0	0	intergen
2	117424502	117424764	MACS_peak_10800	591.97	262	0	0	0	intergen
2	117567345	117567740	MACS_peak_10802	115.07	395	0	0	0	intergen
2	117625446	117625816	MACS_peak_10803	57.77	370	0	0	0	intergen
2	117628122	117628434	MACS_peak_10804	57.63	312	0	0	0	intergen
2	117653338	117653529	MACS_peak_10805	146.78	191	0	0	0	intergen
2	117654265	117654716	MACS_peak_10806	108.41	451	0	0	0	intergen
2	117782909	117783229	MACS_peak_10809	71.98	320	0	0	1	other
2	117806688	117806963	MACS_peak_10810	147.82	275	0	0	0	intergen
2	117814350	117814777	MACS_peak_10811	1372.86	427	1	0	0	promoter
2	117926086	117926403	MACS_peak_10812	57.81	317	0	1	1	gen
2	117967856	117968057	MACS_peak_10813	645.81	201	0	1	0	gen
2	118003400	118003582	MACS_peak_10814	687.62	182	0	1	1	gen
2	118137208	118137646	MACS_peak_10815	115.63	438	0	0	1	other
2	118140731	118141118	MACS_peak_10816	66.28	387	0	0	1	other
2	118487516	118487783	MACS_peak_10817	97.79	267	0	0	0	intergen
2	118517398	118517604	MACS_peak_10818	629.38	206	0	0	0	intergen
2	118707926	118708133	MACS_peak_10819	780.06	207	0	0	0	intergen
2	118867225	118867575	MACS_peak_10820	416.22	350	0	0	0	intergen
2	118867754	118868094	MACS_peak_10821	787.9	340	0	0	0	intergen
2	118891035	118891342	MACS_peak_10822	543.18	307	0	0	0	intergen
2	119299080	119299271	MACS_peak_10825	695.57	191	1	0	0	promoter
2	120026826	120027178	MACS_peak_10826	499.41	352	0	1	0	gen
2	120175126	120175360	MACS_peak_10827	662.31	234	0	1	1	gen
2	120313151	120313584	MACS_peak_10828	700.37	433	0	0	0	intergen
2	120723634	120723938	MACS_peak_10829	440.4	304	0	0	0	intergen
2	121061224	121061462	MACS_peak_10830	334.07	238	0	0	0	intergen
2	121076947	121077180	MACS_peak_10831	532.66	233	0	0	0	intergen
2	121080231	121080477	MACS_peak_10832	485.56	246	0	0	0	intergen
2	121084729	121084863	MACS_peak_10833	1666.76	134	0	0	1	other
2	121576225	121576502	MACS_peak_10834	488.85	277	0	1	0	gen
2	122265663	122265902	MACS_peak_10835	114.01	239	0	0	0	intergen
2	122349637	122349991	MACS_peak_10837	85.97	354	0	0	0	intergen
2	122552599	122552989	MACS_peak_10838	219.32	390	0	0	0	intergen
2	123182349	123182543	MACS_peak_10839	848.95	194	0	0	0	intergen
2	123309230	123309434	MACS_peak_10840	1195.57	204	0	0	0	intergen
2	123335553	123335791	MACS_peak_10841	516.86	238	0	0	0	intergen
2	123379643	123379796	MACS_peak_10843	783.37	153	0	0	0	intergen
2	123406684	123407035	MACS_peak_10844	349.84	351	0	0	0	intergen
2	123634254	123634534	MACS_peak_10845	134.24	280	0	0	0	intergen
2	123784751	123785066	MACS_peak_10846	389.9	315	0	0	0	intergen
2	124126083	124126409	MACS_peak_10847	156.13	326	0	1	0	gen
2	124140854	124141116	MACS_peak_10848	69.07	262	0	1	0	gen
2	124337426	124337768	MACS_peak_10849	59.66	342	0	1	0	gen
2	124597701	124598043	MACS_peak_10851	104.88	342	0	1	0	gen
2	124811918	124812195	MACS_peak_10852	721.05	277	0	1	0	gen
2	124858914	124859260	MACS_peak_10853	112.96	346	0	1	0	gen
2	125417283	125417572	MACS_peak_10855	56.85	289	0	0	0	intergen
2	125831072	125831451	MACS_peak_10856	84.2	379	0	0	0	intergen
2	125891653	125891996	MACS_peak_10857	536.24	343	0	0	0	intergen
2	125892371	125892640	MACS_peak_10858	461.5	269	0	0	0	intergen
2	125892859	125893221	MACS_peak_10859	525.14	362	0	0	0	intergen
2	125894143	125894488	MACS_peak_10860	535.04	345	0	0	0	intergen
2	126109054	126109297	MACS_peak_10861	645.81	243	0	0	0	intergen
2	126118866	126119251	MACS_peak_10862	57.86	385	0	0	0	intergen
2	126305896	126306028	MACS_peak_10863	1116.4	132	0	0	0	intergen
2	127797087	127797426	MACS_peak_10864	380.3	339	0	1	0	gen
2	128036002	128036146	MACS_peak_10865	537.26	144	0	0	0	intergen
2	128179141	128179480	MACS_peak_10866	421.69	339	0	1	0	gen
2	128784407	128784733	MACS_peak_10867	268.93	326	0	0	0	intergen
2	128862835	128863089	MACS_peak_10869	51.21	254	0	0	0	intergen
2	128966431	128966790	MACS_peak_10870	79.07	359	0	0	0	intergen
2	129834345	129834478	MACS_peak_10872	815.65	133	0	0	1	other
2	129849612	129849888	MACS_peak_10873	1273.02	276	0	0	1	other
2	129963130	129963510	MACS_peak_10874	294.76	380	0	0	0	intergen
2	130155893	130156280	MACS_peak_10875	511.42	387	1	0	0	promoter
2	130244941	130245410	MACS_peak_10876	62.89	469	0	0	0	intergen
2	130360505	130360858	MACS_peak_10877	651.52	353	1	0	0	promoter
2	131007355	131007726	MACS_peak_10878	540.91	371	0	1	0	gen
2	131305516	131305648	MACS_peak_10879	1090.31	132	0	1	2	gen
2	131492341	131492566	MACS_peak_10880	548.55	225	0	1	0	gen
2	131672624	131672979	MACS_peak_10881	529.16	355	0	0	0	intergen
2	131689170	131689364	MACS_peak_10882	484.87	194	0	0	0	intergen
2	132010946	132011207	MACS_peak_10883	152.63	261	0	0	0	intergen
2	132020016	132020418	MACS_peak_10884	321.4	402	0	0	0	intergen
2	132020857	132021075	MACS_peak_10885	219.76	218	0	0	0	intergen
2	132210695	132211089	MACS_peak_10886	76.73	394	0	1	0	gen
2	132211690	132211942	MACS_peak_10887	89.26	252	0	1	0	gen
2	132216667	132216963	MACS_peak_10888	50.92	296	0	1	0	gen
2	132223680	132224087	MACS_peak_10890	85.14	407	0	1	0	gen
2	132225844	132226187	MACS_peak_10891	82.19	343	0	1	0	gen
2	132230041	132230400	MACS_peak_10892	69.92	359	0	1	0	gen
2	132242223	132242547	MACS_peak_10894	55.59	324	0	1	0	gen
2	132448847	132449105	MACS_peak_10896	727.26	258	0	1	0	gen
2	132455467	132455776	MACS_peak_10897	120.84	309	0	1	0	gen
2	132533240	132533622	MACS_peak_10898	50.4	382	0	1	0	gen
2	132565667	132565964	MACS_peak_10899	126.08	297	0	1	0	gen
2	132566009	132566381	MACS_peak_10900	75.42	372	0	1	0	gen
2	133171466	133171806	MACS_peak_10901	660.56	340	0	1	0	gen
2	133385640	133385915	MACS_peak_10903	76.3	275	0	1	0	gen
2	133465973	133466355	MACS_peak_10904	64.83	382	0	1	0	gen
2	133561012	133561376	MACS_peak_10906	1102.85	364	0	1	0	gen
2	133638857	133638995	MACS_peak_10908	1043.77	138	0	0	0	intergen
2	133780120	133780489	MACS_peak_10909	363.1	369	0	0	0	intergen
2	133786806	133787137	MACS_peak_10910	172.39	331	0	0	0	intergen
2	133913036	133913231	MACS_peak_10911	88.2	195	0	0	0	intergen
2	134046543	134046940	MACS_peak_10912	53.84	397	0	0	0	intergen
2	134066366	134066688	MACS_peak_10913	100.97	322	0	0	0	intergen
2	134228366	134228773	MACS_peak_10914	738.45	407	0	1	0	gen
2	134450961	134451164	MACS_peak_10915	989.9	203	1	1	0	promoter
2	134695410	134695661	MACS_peak_10916	412.67	251	0	1	0	gen
2	134756641	134756778	MACS_peak_10917	1326.27	137	0	0	1	other
2	135138900	135139074	MACS_peak_10918	1208.41	174	1	1	0	promoter
2	135294236	135294486	MACS_peak_10919	82.05	250	0	1	0	gen
2	135407909	135408220	MACS_peak_10920	51.07	311	0	1	0	gen
2	135424889	135425207	MACS_peak_10921	940.27	318	0	1	0	gen
2	135515691	135515886	MACS_peak_10922	352.92	195	0	1	0	gen
2	135685652	135686003	MACS_peak_10923	415.73	351	0	1	0	gen
2	136193589	136193842	MACS_peak_10924	470.06	253	0	0	0	intergen
2	136297087	136297301	MACS_peak_10925	596.79	214	0	0	0	intergen
2	136724754	136724977	MACS_peak_10928	564.54	223	0	0	0	intergen
2	137071303	137071698	MACS_peak_10929	57.86	395	0	1	0	gen
2	137281571	137281904	MACS_peak_10930	90.41	333	0	1	0	gen
2	137283942	137284181	MACS_peak_10931	87.15	239	0	1	0	gen
2	137303597	137303816	MACS_peak_10932	564.92	219	0	1	0	gen
2	137311214	137311451	MACS_peak_10933	75.39	237	0	1	0	gen
2	137558838	137559193	MACS_peak_10934	77	355	0	1	0	gen
2	137650651	137650864	MACS_peak_10935	593.82	213	0	1	0	gen
2	137653417	137653685	MACS_peak_10936	462.14	268	0	1	0	gen
2	137659762	137660041	MACS_peak_10937	455.19	279	0	1	0	gen
2	137910596	137910957	MACS_peak_10938	1170.94	361	0	0	0	intergen
2	137943920	137944221	MACS_peak_10939	442.11	301	0	0	0	intergen
2	138787154	138787350	MACS_peak_10940	1226.97	196	0	0	0	intergen
2	138814562	138814820	MACS_peak_10941	468.72	258	0	0	0	intergen
2	138827581	138827924	MACS_peak_10942	419.68	343	0	0	0	intergen
2	139103202	139103443	MACS_peak_10943	146.67	241	0	0	0	intergen
2	139132975	139133165	MACS_peak_10944	1216.37	190	0	0	0	intergen
2	139200197	139200461	MACS_peak_10945	76.3	264	0	0	0	intergen
2	139309836	139310218	MACS_peak_10946	52.69	382	0	0	0	intergen
2	139372563	139372976	MACS_peak_10947	125.52	413	0	0	1	other
2	139443576	139443784	MACS_peak_10948	276.43	208	0	0	0	intergen
2	139651875	139652260	MACS_peak_10949	238.69	385	0	0	0	intergen
2	139695806	139696110	MACS_peak_10950	267.28	304	0	0	0	intergen
2	139946685	139947076	MACS_peak_10951	876.2	391	0	0	0	intergen
2	140256040	140256263	MACS_peak_10952	482.68	223	0	1	0	gen
2	140381757	140381903	MACS_peak_10953	1785.17	146	0	1	0	gen
2	140586459	140586657	MACS_peak_10954	831.63	198	0	1	0	gen
2	140964338	140964733	MACS_peak_10955	476.47	395	0	1	0	gen
2	141043920	141044273	MACS_peak_10956	86.41	353	0	1	0	gen
2	141044355	141044823	MACS_peak_10957	143.08	468	0	1	0	gen
2	141070544	141070884	MACS_peak_10958	62.38	340	0	1	0	gen
2	141153225	141153564	MACS_peak_10960	421.69	339	0	1	0	gen
2	141208867	141209137	MACS_peak_10961	229.83	270	0	1	0	gen
2	141463435	141463689	MACS_peak_10962	584.94	254	0	1	0	gen
2	141699796	141700181	MACS_peak_10963	753.71	385	0	1	0	gen
2	141964530	141964911	MACS_peak_10964	76.23	381	0	1	0	gen
2	142381904	142382177	MACS_peak_10965	713.56	273	0	0	0	intergen
2	142482559	142482905	MACS_peak_10966	711.84	346	0	0	0	intergen
2	142609543	142609767	MACS_peak_10967	80.88	224	0	0	0	intergen
2	142640627	142641044	MACS_peak_10968	593.23	417	0	0	0	intergen
2	142730555	142730932	MACS_peak_10969	139.4	377	0	0	0	intergen
2	142861431	142861766	MACS_peak_10970	106.42	335	0	0	0	intergen
2	142870357	142870506	MACS_peak_10971	689.09	149	0	0	0	intergen
2	143034222	143034699	MACS_peak_10973	791.15	477	0	1	0	gen
2	143222545	143222796	MACS_peak_10974	883.81	251	0	1	0	gen
2	143259322	143259683	MACS_peak_10975	771.4	361	0	1	0	gen
2	143536663	143537100	MACS_peak_10976	246.41	437	0	1	2	gen
2	143637869	143638084	MACS_peak_10977	343.42	215	0	1	0	gen
2	143866436	143866804	MACS_peak_10978	79.66	368	0	0	0	intergen
2	144270099	144270374	MACS_peak_10980	250.06	275	0	1	0	gen
2	144416878	144417125	MACS_peak_10981	485.56	247	0	1	0	gen
2	144722514	144722828	MACS_peak_10982	68.9	314	0	0	1	other
2	145459847	145460094	MACS_peak_10983	573.39	247	0	0	0	intergen
2	145946837	145947246	MACS_peak_10985	219.32	409	0	0	0	intergen
2	146661599	146661985	MACS_peak_10986	953.02	386	0	0	0	intergen
2	146734044	146734401	MACS_peak_10987	528	357	0	0	0	intergen
2	147152950	147153357	MACS_peak_10988	158.84	407	0	0	0	intergen
2	147727801	147728162	MACS_peak_10989	102.15	361	0	0	0	intergen
2	147744674	147744997	MACS_peak_10990	85.96	323	0	0	0	intergen
2	147745572	147745882	MACS_peak_10991	70.33	310	0	0	0	intergen
2	147910974	147911228	MACS_peak_10992	596.79	254	0	1	0	gen
2	147937744	147938114	MACS_peak_10993	640.22	370	0	1	0	gen
2	148049600	148049817	MACS_peak_10994	580.62	217	0	1	0	gen
2	148189927	148190139	MACS_peak_10995	55.13	212	0	1	0	gen
2	148194239	148194580	MACS_peak_10996	128.49	341	0	1	0	gen
2	148291797	148292024	MACS_peak_10997	508.11	227	0	1	0	gen
2	148294109	148294407	MACS_peak_10998	125.63	298	0	1	0	gen
2	148326611	148326963	MACS_peak_10999	153.7	352	0	1	0	gen
2	148381906	148382289	MACS_peak_11000	127.98	383	0	1	0	gen
2	148780375	148780613	MACS_peak_11001	502.51	238	0	1	0	gen
2	148792017	148792280	MACS_peak_11002	229.83	263	0	0	0	intergen
2	148809607	148809898	MACS_peak_11003	570.2	291	0	0	0	intergen
2	148926663	148926914	MACS_peak_11004	746.04	251	0	1	0	gen
2	149017401	149017640	MACS_peak_11005	645.81	239	0	1	0	gen
2	149035305	149035602	MACS_peak_11006	373.73	297	1	0	0	promoter
2	149263556	149263793	MACS_peak_11007	516.86	237	0	0	0	intergen
2	149549633	149549946	MACS_peak_11008	63.13	313	0	0	0	intergen
2	149561307	149561651	MACS_peak_11009	1050.85	344	0	0	0	intergen
2	149597568	149597840	MACS_peak_11010	459.58	272	0	0	1	other
2	149673291	149673724	MACS_peak_11011	172.39	433	0	0	1	other
2	149853084	149853508	MACS_peak_11012	67.65	424	0	0	1	other
2	150023919	150024379	MACS_peak_11013	2368.43	460	0	0	0	intergen
2	150117729	150118034	MACS_peak_11015	355.37	305	0	0	0	intergen
2	150599951	150600261	MACS_peak_11016	557.12	310	0	0	1	other
2	151010020	151010336	MACS_peak_11017	730.17	316	0	0	1	other
2	151051676	151051978	MACS_peak_11018	441.54	302	0	0	0	intergen
2	151238897	151239270	MACS_peak_11019	1438.77	373	0	0	0	intergen
2	151580861	151581168	MACS_peak_11020	989.38	307	0	1	0	gen
2	151591412	151591719	MACS_peak_11021	947.74	307	0	1	0	gen
2	151601965	151602272	MACS_peak_11022	978.47	307	0	1	0	gen
2	151633289	151633546	MACS_peak_11023	595.98	257	0	1	0	gen
2	151798797	151798963	MACS_peak_11024	762.11	166	1	1	0	promoter
2	151945876	151946160	MACS_peak_11025	704	284	0	2	0	gen
2	151998968	151999274	MACS_peak_11026	603.02	306	0	1	0	gen
2	152017105	152017361	MACS_peak_11027	488.85	256	0	1	0	gen
2	152189960	152190273	MACS_peak_11028	1225.13	313	0	0	0	intergen
2	152689799	152689951	MACS_peak_11029	799.34	152	0	1	0	gen
2	152715920	152716155	MACS_peak_11030	437.66	235	1	1	0	promoter
2	152740695	152741023	MACS_peak_11031	797.81	328	0	1	0	gen
2	152743041	152743316	MACS_peak_11032	581.92	275	0	1	0	gen
2	152808273	152808508	MACS_peak_11033	235.06	235	0	0	0	intergen
2	152861297	152861634	MACS_peak_11034	539.88	337	0	0	0	intergen
2	152925239	152925494	MACS_peak_11035	521.8	255	0	0	0	intergen
2	152929010	152929460	MACS_peak_11036	832.82	450	0	0	0	intergen
2	152997738	152998051	MACS_peak_11037	85.53	313	0	0	0	intergen
2	153035579	153035820	MACS_peak_11038	501.16	241	0	0	0	intergen
2	153061364	153061541	MACS_peak_11039	1171.45	177	0	0	0	intergen
2	153253978	153254247	MACS_peak_11040	68.03	269	0	0	0	intergen
2	153255899	153256311	MACS_peak_11041	101.59	412	0	0	0	intergen
2	153324497	153324788	MACS_peak_11042	201.59	291	0	0	0	intergen
2	153519370	153519705	MACS_peak_11044	541.11	335	0	0	1	other
2	153629813	153630283	MACS_peak_11045	177.17	470	0	0	0	intergen
2	153837002	153837288	MACS_peak_11046	135.44	286	0	0	0	intergen
2	154023933	154024378	MACS_peak_11047	170.56	445	0	1	0	gen
2	154298452	154298821	MACS_peak_11048	407.18	369	0	1	0	gen
2	154402053	154402427	MACS_peak_11049	404.88	374	0	1	0	gen
2	154977098	154977333	MACS_peak_11052	516.86	235	0	0	0	intergen
2	155191449	155191688	MACS_peak_11053	198.25	239	0	0	0	intergen
2	155223709	155224070	MACS_peak_11054	900.92	361	0	0	0	intergen
2	155571695	155572014	MACS_peak_11056	114.74	319	0	0	0	intergen
2	155790054	155790375	MACS_peak_11057	549.92	321	0	0	0	intergen
2	155878162	155878525	MACS_peak_11058	62.38	363	0	0	0	intergen
2	156112931	156113372	MACS_peak_11059	839.04	441	0	0	1	other
2	156259241	156259535	MACS_peak_11060	62.05	294	0	0	0	intergen
2	156371402	156371745	MACS_peak_11061	52.99	343	0	0	0	intergen
2	156695664	156695854	MACS_peak_11062	695.57	190	0	0	0	intergen
2	156774309	156774570	MACS_peak_11063	60.97	261	0	0	0	intergen
2	156995259	156995736	MACS_peak_11064	84.19	477	0	0	0	intergen
2	157055716	157055975	MACS_peak_11065	429.15	259	0	0	0	intergen
2	157194162	157194436	MACS_peak_11066	582.68	274	0	0	0	intergen
2	157302535	157302962	MACS_peak_11067	491.28	427	0	1	0	gen
2	157327617	157327880	MACS_peak_11068	465.4	263	0	0	0	intergen
2	157336246	157336440	MACS_peak_11069	1245.57	194	0	0	0	intergen
2	157492269	157492598	MACS_peak_11070	426.82	329	0	0	0	intergen
2	157547495	157547734	MACS_peak_11071	133.61	239	0	1	0	gen
2	157571830	157572080	MACS_peak_11073	139.22	250	0	1	0	gen
2	157597559	157597773	MACS_peak_11074	596.79	214	0	1	0	gen
2	157629196	157629466	MACS_peak_11075	447.53	270	0	0	0	intergen
2	157892720	157893072	MACS_peak_11076	845.32	352	0	1	0	gen
2	158084303	158084668	MACS_peak_11077	768.37	365	0	1	0	gen
2	158188745	158188922	MACS_peak_11078	972.07	177	0	1	1	gen
2	158264816	158265040	MACS_peak_11079	712.32	224	0	1	0	gen
2	158283509	158283895	MACS_peak_11080	131.14	386	0	1	0	gen
2	158424239	158424419	MACS_peak_11081	446.02	180	0	1	1	gen
2	158724257	158724456	MACS_peak_11082	645.81	199	0	0	2	other
2	158848284	158848696	MACS_peak_11083	762.53	412	0	1	0	gen
2	158869324	158869694	MACS_peak_11084	504.8	370	0	0	0	intergen
2	159590183	159590335	MACS_peak_11085	429.41	152	0	1	0	gen
2	159646493	159646695	MACS_peak_11086	630.96	202	0	0	0	intergen
2	159724197	159724434	MACS_peak_11087	793.98	237	0	1	0	gen
2	159807581	159807809	MACS_peak_11088	695.57	228	1	1	0	promoter
2	160109993	160110322	MACS_peak_11089	929.71	329	0	1	0	gen
2	160116317	160116631	MACS_peak_11090	71.11	314	0	1	0	gen
2	160133542	160133925	MACS_peak_11091	86.22	383	0	1	0	gen
2	160134752	160135068	MACS_peak_11092	90.85	316	0	1	0	gen
2	160210784	160211038	MACS_peak_11094	378.97	254	0	0	1	other
2	160324214	160324545	MACS_peak_11095	380.3	331	0	1	0	gen
2	160691659	160691882	MACS_peak_11096	705.91	223	0	0	0	intergen
2	160713862	160714097	MACS_peak_11097	125.96	235	0	0	0	intergen
2	160757088	160757558	MACS_peak_11098	71.6	470	0	0	0	intergen
2	160817709	160817953	MACS_peak_11099	629.38	244	0	0	0	intergen
2	160882517	160882666	MACS_peak_11101	640.23	149	0	0	0	intergen
2	160919012	160919266	MACS_peak_11102	470.06	254	0	0	0	intergen
2	161273228	161273550	MACS_peak_11103	430.51	322	0	0	1	other
2	161279513	161279716	MACS_peak_11104	693.41	203	0	0	1	other
2	161346346	161346669	MACS_peak_11106	722.05	323	0	1	0	gen
2	161510088	161510220	MACS_peak_11107	1116.4	132	0	1	0	gen
2	161566827	161567226	MACS_peak_11108	81.72	399	0	1	0	gen
2	162297975	162298273	MACS_peak_11109	692.37	298	0	1	0	gen
2	162471889	162472291	MACS_peak_11110	232.65	402	0	1	0	gen
2	162492850	162492996	MACS_peak_11111	1923.8	146	0	1	0	gen
2	162890707	162891151	MACS_peak_11112	836.95	444	0	0	0	intergen
2	162891937	162892247	MACS_peak_11113	445.11	310	0	0	0	intergen
2	163169465	163169790	MACS_peak_11115	415.68	325	0	0	0	intergen
2	163977441	163977692	MACS_peak_11116	235.91	251	0	0	1	other
2	164264436	164264798	MACS_peak_11117	71.04	362	0	0	1	other
2	164265823	164266134	MACS_peak_11118	72.19	311	0	0	1	other
2	164266304	164266633	MACS_peak_11119	68.16	329	0	0	1	other
2	164495669	164495952	MACS_peak_11120	575.98	283	1	0	0	promoter
2	164560238	164560543	MACS_peak_11121	686.76	305	0	1	0	gen
2	164599994	164600310	MACS_peak_11122	1365.96	316	0	1	0	gen
2	164636898	164637126	MACS_peak_11123	667.16	228	0	0	0	intergen
2	164717045	164717284	MACS_peak_11124	516.86	239	0	1	0	gen
2	164796407	164796734	MACS_peak_11125	592.19	327	0	1	0	gen
2	164819308	164819539	MACS_peak_11126	989.9	231	0	1	0	gen
2	164992729	164993161	MACS_peak_11127	603.09	432	0	0	1	other
2	165015095	165015323	MACS_peak_11128	548.55	228	0	0	1	other
2	165293837	165294138	MACS_peak_11129	201.59	301	0	1	0	gen
2	165306404	165306703	MACS_peak_11130	1242.54	299	0	1	0	gen
2	165733411	165733698	MACS_peak_11131	61.01	287	0	0	0	intergen
2	166099906	166100118	MACS_peak_11132	65.9	212	0	1	1	gen
2	166181688	166181928	MACS_peak_11133	1745.55	240	0	0	1	other
2	166413999	166414331	MACS_peak_11134	425.26	332	0	1	0	gen
2	166414772	166415049	MACS_peak_11135	265.34	277	0	1	0	gen
2	166539430	166539669	MACS_peak_11136	516.86	239	0	0	0	intergen
2	166703300	166703771	MACS_peak_11137	60.98	471	0	0	0	intergen
2	166706198	166706560	MACS_peak_11138	53.79	362	0	0	0	intergen
2	166824506	166824732	MACS_peak_11139	533.53	226	0	0	0	intergen
2	166989614	166989867	MACS_peak_11141	68.88	253	0	1	0	gen
2	167010773	167010990	MACS_peak_11142	62.26	217	0	1	0	gen
2	167020988	167021148	MACS_peak_11143	774.15	160	0	1	0	gen
2	167082928	167083295	MACS_peak_11144	63.13	367	0	1	0	gen
2	167212164	167212399	MACS_peak_11146	653.89	235	0	1	0	gen
2	167442520	167442964	MACS_peak_11147	140.23	444	0	0	1	other
2	167560815	167561108	MACS_peak_11148	124.09	293	0	0	0	intergen
2	167565326	167565671	MACS_peak_11149	153.86	345	0	0	0	intergen
2	167840619	167840987	MACS_peak_11150	154.08	368	0	0	1	other
2	167964769	167965151	MACS_peak_11151	439.97	382	0	1	0	gen
2	168118602	168118973	MACS_peak_11152	639.57	371	0	1	0	gen
2	168346697	168346929	MACS_peak_11153	989.9	232	0	0	0	intergen
2	168631556	168631933	MACS_peak_11154	403.51	377	0	1	0	gen
2	168687389	168687673	MACS_peak_11155	722.05	284	0	1	0	gen
2	168759320	168759547	MACS_peak_11156	695.57	227	0	1	0	gen
2	168773722	168774050	MACS_peak_11157	545.46	328	0	1	1	gen
2	168911551	168911744	MACS_peak_11158	678.9	193	1	1	0	promoter
2	168920537	168920919	MACS_peak_11159	312.33	382	0	1	0	gen
2	169276136	169276335	MACS_peak_11162	627.67	199	0	1	0	gen
2	169312065	169312379	MACS_peak_11163	76.3	314	0	1	0	gen
2	169452079	169452480	MACS_peak_11164	323.89	401	0	0	0	intergen
2	169455215	169455579	MACS_peak_11165	51.29	364	0	0	0	intergen
2	169456034	169456302	MACS_peak_11166	111.72	268	0	0	0	intergen
2	169611586	169611855	MACS_peak_11169	603.02	269	0	1	0	gen
2	169767412	169767626	MACS_peak_11170	746.04	214	0	1	1	gen
2	170324635	170324863	MACS_peak_11171	695.57	228	0	1	0	gen
2	170408053	170408269	MACS_peak_11172	745.97	216	0	1	1	gen
2	170625748	170625998	MACS_peak_11173	105.81	250	0	1	0	gen
2	170648558	170648818	MACS_peak_11174	593.56	260	0	1	1	gen
2	170873309	170873547	MACS_peak_11176	662.31	238	0	0	0	intergen
2	170916057	170916343	MACS_peak_11177	953.02	286	0	0	0	intergen
2	170928907	170929274	MACS_peak_11178	408.1	367	1	0	0	promoter
2	171143452	171143654	MACS_peak_11179	253.28	202	0	1	0	gen
2	171642352	171642630	MACS_peak_11180	95.03	278	0	0	0	intergen
2	171705548	171705876	MACS_peak_11181	669.21	328	0	1	0	gen
2	171706221	171706517	MACS_peak_11182	693.99	296	0	1	0	gen
2	171940922	171941262	MACS_peak_11183	407.96	340	0	2	0	gen
2	171970495	171970649	MACS_peak_11184	740.33	154	0	2	0	gen
2	172127345	172127597	MACS_peak_11185	697.97	252	0	0	0	intergen
2	172129739	172129983	MACS_peak_11186	848.63	244	0	0	0	intergen
2	172272445	172272728	MACS_peak_11187	502.84	283	0	0	0	intergen
2	172320726	172321073	MACS_peak_11188	115.17	347	0	0	1	other
2	172593785	172594072	MACS_peak_11189	557.09	287	0	1	0	gen
2	172650864	172651228	MACS_peak_11190	53.24	364	0	0	0	intergen
2	172710482	172710783	MACS_peak_11191	442.11	301	0	0	1	other
2	172806469	172806837	MACS_peak_11192	766.12	368	0	1	0	gen
2	172813361	172813604	MACS_peak_11193	780.06	243	0	1	0	gen
2	172857777	172858026	MACS_peak_11194	187.77	249	0	1	0	gen
2	172864214	172864482	MACS_peak_11195	718.04	268	0	1	0	gen
2	172934038	172934171	MACS_peak_11196	1176.51	133	0	1	0	gen
2	173063283	173063504	MACS_peak_11197	618.8	221	0	0	0	intergen
2	173476497	173476908	MACS_peak_11198	406.81	411	0	0	0	intergen
2	173531218	173531550	MACS_peak_11199	53.45	332	0	0	0	intergen
2	173699543	173699905	MACS_peak_11200	60.06	362	0	0	0	intergen
2	173884499	173884873	MACS_peak_11203	404.88	374	0	0	1	other
2	174253575	174254013	MACS_peak_11204	1306.86	438	0	0	0	intergen
2	174270480	174270934	MACS_peak_11206	67.98	454	0	0	0	intergen
2	174288858	174289302	MACS_peak_11207	69.62	444	0	0	0	intergen
2	174341574	174341802	MACS_peak_11208	1171.45	228	0	0	0	intergen
2	174354315	174354754	MACS_peak_11209	1229.91	439	0	1	0	gen
2	174380433	174380671	MACS_peak_11210	516.86	238	0	1	0	gen
2	174462662	174463015	MACS_peak_11211	651.52	353	0	1	0	gen
2	174522652	174522881	MACS_peak_11212	810.99	229	0	0	0	intergen
2	174605723	174606002	MACS_peak_11213	441.88	279	0	1	1	gen
2	175233550	175233853	MACS_peak_11214	3195.62	303	0	0	0	intergen
2	175282413	175282646	MACS_peak_11215	678.9	233	0	0	1	other
2	175322359	175322680	MACS_peak_11216	318.58	321	0	0	1	other
2	175350734	175350996	MACS_peak_11217	466.05	262	0	0	1	other
2	175366787	175367026	MACS_peak_11218	645.81	239	0	0	1	other
2	175545976	175546249	MACS_peak_11219	456.3	273	0	0	0	intergen
2	175933616	175933869	MACS_peak_11220	310.38	253	0	1	0	gen
2	175963122	175963489	MACS_peak_11221	56.47	367	0	1	0	gen
2	175964204	175964506	MACS_peak_11222	490.09	302	0	1	0	gen
2	176127102	176127314	MACS_peak_11223	758.25	212	2	0	1	promoter
2	176732518	176732759	MACS_peak_11224	645.81	241	0	0	1	other
2	176800907	176801267	MACS_peak_11225	60.64	360	0	0	1	other
2	176866889	176867164	MACS_peak_11226	349.84	275	0	0	0	intergen
2	176915687	176915891	MACS_peak_11227	540.33	204	0	0	0	intergen
2	177123422	177123668	MACS_peak_11228	386.6	246	0	0	1	other
2	177149026	177149218	MACS_peak_11229	866.35	192	0	0	1	other
2	177164412	177164882	MACS_peak_11230	2328.23	470	0	0	1	other
2	177334989	177335366	MACS_peak_11231	635.71	377	0	1	1	gen
2	177468271	177468500	MACS_peak_11232	468.48	229	0	1	0	gen
2	177489701	177489970	MACS_peak_11233	461.5	269	0	1	0	gen
2	177763709	177763966	MACS_peak_11234	595.98	257	0	2	0	gen
2	177906293	177906656	MACS_peak_11236	409.98	363	0	2	0	gen
2	177973368	177973742	MACS_peak_11237	62.75	374	0	2	1	gen
2	177983309	177983578	MACS_peak_11238	400.56	269	0	2	1	gen
2	178112247	178112473	MACS_peak_11239	695.57	226	1	0	0	promoter
2	178132360	178132623	MACS_peak_11240	476.21	263	0	1	0	gen
2	178700795	178701115	MACS_peak_11241	431.58	320	0	1	1	gen
2	178761805	178762095	MACS_peak_11242	570.92	290	0	1	1	gen
2	178787876	178788134	MACS_peak_11243	595.17	258	0	1	0	gen
2	178804877	178805061	MACS_peak_11244	896.52	184	0	1	0	gen
2	178891546	178891789	MACS_peak_11245	501.16	243	0	1	0	gen
2	178941887	178942095	MACS_peak_11246	190.03	208	0	1	0	gen
2	179088399	179088574	MACS_peak_11248	163.37	175	0	0	0	intergen
2	179089851	179090142	MACS_peak_11249	121.23	291	0	0	0	intergen
2	179317452	179317753	MACS_peak_11250	56.38	301	0	0	0	intergen
2	179320129	179320591	MACS_peak_11251	90.01	462	0	0	0	intergen
2	179390147	179390553	MACS_peak_11252	55.15	406	0	0	0	intergen
2	179422098	179422352	MACS_peak_11253	729.14	254	0	0	0	intergen
2	179682235	179682479	MACS_peak_11254	629.38	244	0	1	0	gen
2	179751240	179751529	MACS_peak_11255	226.26	289	0	1	0	gen
2	180077317	180077626	MACS_peak_11256	1406.8	309	0	0	0	intergen
2	180701236	180701692	MACS_peak_11257	953.93	456	0	0	1	other
2	180768652	180769012	MACS_peak_11258	56.38	360	0	0	1	other
2	180830849	180831223	MACS_peak_11259	52.5	374	0	0	1	other
2	181123176	181123579	MACS_peak_11260	741.16	403	0	0	1	other
2	181329238	181329513	MACS_peak_11262	380.3	275	0	0	1	other
2	181386272	181386545	MACS_peak_11263	1025.27	273	0	0	1	other
2	181573061	181573371	MACS_peak_11264	437.04	310	0	1	0	gen
2	181664613	181664973	MACS_peak_11265	84.06	360	0	1	0	gen
2	181738002	181738308	MACS_peak_11266	257.79	306	0	0	0	intergen
2	182132656	182133027	MACS_peak_11267	1160.58	371	0	0	0	intergen
2	182186146	182186610	MACS_peak_11268	823.38	464	0	1	0	gen
2	182453558	182453937	MACS_peak_11269	56.38	379	0	1	0	gen
2	182519173	182519430	MACS_peak_11270	595.98	257	0	1	0	gen
2	182748319	182748705	MACS_peak_11272	69.76	386	0	1	0	gen
2	182767506	182767829	MACS_peak_11274	275.91	323	0	1	0	gen
2	182874604	182874984	MACS_peak_11275	84.42	380	0	0	0	intergen
2	183002964	183003218	MACS_peak_11276	470.06	254	0	1	0	gen
2	183248794	183249191	MACS_peak_11277	506.19	397	0	0	0	intergen
2	183402935	183403355	MACS_peak_11278	64.01	420	0	0	0	intergen
2	183448945	183449162	MACS_peak_11279	118.49	217	0	0	0	intergen
2	183452519	183452805	MACS_peak_11280	86.75	286	0	0	0	intergen
2	183481244	183481483	MACS_peak_11281	797.18	239	0	0	0	intergen
2	183588406	183588814	MACS_peak_11282	77.86	408	0	0	0	intergen
2	183589172	183589402	MACS_peak_11283	119.99	230	0	0	0	intergen
2	183913577	183913920	MACS_peak_11284	138.06	343	0	0	1	other
2	183917165	183917449	MACS_peak_11286	136.41	284	0	0	1	other
2	183977631	183977958	MACS_peak_11287	161.58	327	0	0	0	intergen
2	183978179	183978560	MACS_peak_11288	118.8	381	0	0	0	intergen
2	184207810	184208074	MACS_peak_11289	590.39	264	0	0	0	intergen
2	184259188	184259407	MACS_peak_11290	564.92	219	0	0	0	intergen
2	184388003	184388204	MACS_peak_11291	814.37	201	0	0	0	intergen
2	184448039	184448406	MACS_peak_11292	488.85	367	0	0	0	intergen
2	184611584	184611771	MACS_peak_11293	658.72	187	0	1	0	gen
2	184703586	184703729	MACS_peak_11294	856.68	143	0	1	0	gen
2	184948059	184948438	MACS_peak_11295	79.03	379	0	0	0	intergen
2	185020137	185020489	MACS_peak_11296	488.85	352	0	0	0	intergen
2	185041365	185041736	MACS_peak_11297	603.02	371	0	0	0	intergen
2	185179576	185179797	MACS_peak_11298	432.48	221	0	0	0	intergen
2	185275958	185276372	MACS_peak_11299	865.89	414	0	0	0	intergen
2	185279915	185280343	MACS_peak_11300	605.31	428	0	0	0	intergen
2	185584861	185585128	MACS_peak_11302	175.11	267	0	0	0	intergen
2	185629170	185629417	MACS_peak_11303	331.5	247	0	0	0	intergen
2	185738987	185739189	MACS_peak_11304	645.81	202	1	0	1	promoter
2	185868562	185868889	MACS_peak_11306	51.1	327	0	0	0	intergen
2	186191483	186191854	MACS_peak_11307	364.63	371	0	0	0	intergen
2	186204568	186204793	MACS_peak_11308	712.32	225	0	0	0	intergen
2	186313762	186314133	MACS_peak_11309	159.91	371	0	0	0	intergen
2	186468175	186468407	MACS_peak_11310	532.66	232	0	0	0	intergen
2	186781050	186781425	MACS_peak_11311	1436.37	375	0	0	0	intergen
2	186862939	186863258	MACS_peak_11312	432.12	319	0	0	0	intergen
2	186895509	186895733	MACS_peak_11313	448.53	224	0	0	0	intergen
2	186903211	186903466	MACS_peak_11314	430.78	255	0	0	0	intergen
2	187287698	187288102	MACS_peak_11315	128.56	404	0	0	1	other
2	187291883	187292113	MACS_peak_11316	496.47	230	0	0	1	other
2	187497935	187498222	MACS_peak_11317	603.02	287	0	1	1	gen
2	187500026	187500340	MACS_peak_11318	679.74	314	0	1	1	gen
2	187594832	187595207	MACS_peak_11319	378.98	375	0	0	0	intergen
2	187659022	187659239	MACS_peak_11320	436.02	217	0	0	0	intergen
2	188421880	188422100	MACS_peak_11321	564.54	220	0	1	0	gen
2	188524555	188524787	MACS_peak_11322	532.66	232	0	1	0	gen
2	188826321	188826676	MACS_peak_11323	85.58	355	0	0	1	other
2	188976610	188976981	MACS_peak_11325	639.57	371	1	0	0	promoter
2	188983368	188983712	MACS_peak_11326	482.41	344	0	1	0	gen
2	189027043	189027327	MACS_peak_11327	52.27	284	1	0	0	promoter
2	189287924	189288213	MACS_peak_11328	1027.23	289	0	0	0	intergen
2	189323568	189323864	MACS_peak_11329	63.19	296	0	0	0	intergen
2	189416067	189416447	MACS_peak_11330	147.83	380	0	0	0	intergen
2	189466700	189467008	MACS_peak_11331	558.46	308	0	1	0	gen
2	189660919	189661395	MACS_peak_11332	815.52	476	1	0	0	promoter
2	189698384	189698601	MACS_peak_11333	1079.97	217	0	1	0	gen
2	190070436	190070732	MACS_peak_11334	1217	296	0	1	0	gen
2	190193637	190193812	MACS_peak_11335	972.07	175	1	1	0	promoter
2	190227291	190227563	MACS_peak_11336	100.42	272	0	1	0	gen
2	190314840	190315129	MACS_peak_11337	380.3	289	0	1	0	gen
2	190372412	190372707	MACS_peak_11338	445.58	295	0	0	0	intergen
2	190727739	190728202	MACS_peak_11339	586.55	463	0	0	0	intergen
2	190775558	190775878	MACS_peak_11340	108.7	320	0	0	0	intergen
2	190781624	190781979	MACS_peak_11341	876.07	355	0	0	0	intergen
2	191165060	191165358	MACS_peak_11342	382.04	298	0	0	0	intergen
2	191501657	191501915	MACS_peak_11343	864.19	258	0	0	0	intergen
2	191511280	191511629	MACS_peak_11344	372.52	349	0	0	0	intergen
2	191521716	191522024	MACS_peak_11345	815.17	308	0	0	0	intergen
2	191650209	191650469	MACS_peak_11346	422.67	260	0	0	0	intergen
2	191690383	191690681	MACS_peak_11347	443.84	298	0	1	0	gen
2	191986445	191986578	MACS_peak_11348	1431.06	133	0	1	1	gen
2	192162527	192162896	MACS_peak_11349	640.87	369	0	1	0	gen
2	192269080	192269348	MACS_peak_11350	50.92	268	0	0	0	intergen
2	192821175	192821406	MACS_peak_11352	532.66	231	0	0	0	intergen
2	192915903	192916275	MACS_peak_11353	75.01	372	0	0	0	intergen
2	192943049	192943340	MACS_peak_11354	830.86	291	0	0	0	intergen
2	192990298	192990649	MACS_peak_11355	54.95	351	0	0	0	intergen
2	193034417	193034714	MACS_peak_11356	57.42	297	0	0	0	intergen
2	193036179	193036558	MACS_peak_11357	90.45	379	0	0	0	intergen
2	193103090	193103494	MACS_peak_11358	619.12	404	0	0	0	intergen
2	193347494	193347630	MACS_peak_11360	646.66	136	0	0	0	intergen
2	193444134	193444392	MACS_peak_11361	595.17	258	0	0	0	intergen
2	193522735	193523141	MACS_peak_11362	739.13	406	0	0	0	intergen
2	193622642	193622988	MACS_peak_11364	109.64	346	0	0	0	intergen
2	193705740	193706017	MACS_peak_11365	85.69	277	0	0	0	intergen
2	193709236	193709701	MACS_peak_11366	94.4	465	0	0	0	intergen
2	193777020	193777351	MACS_peak_11367	667.02	331	0	0	0	intergen
2	193848581	193848789	MACS_peak_11368	604.98	208	0	0	0	intergen
2	193908406	193908744	MACS_peak_11369	230.98	338	0	0	0	intergen
2	194392318	194392610	MACS_peak_11370	89.39	292	0	0	1	other
2	194447747	194448183	MACS_peak_11371	108.08	436	0	0	0	intergen
2	194448372	194448841	MACS_peak_11372	122.09	469	0	0	0	intergen
2	194474636	194474990	MACS_peak_11375	182.28	354	0	0	0	intergen
2	194492130	194492557	MACS_peak_11376	1517.68	427	0	0	0	intergen
2	194527512	194527743	MACS_peak_11377	937.16	231	0	0	0	intergen
2	194692436	194692765	MACS_peak_11378	285.42	329	0	0	0	intergen
2	194819495	194819692	MACS_peak_11379	644.94	197	0	0	0	intergen
2	194864333	194864620	MACS_peak_11380	608.88	287	0	0	0	intergen
2	195070057	195070434	MACS_peak_11381	110.58	377	0	0	0	intergen
2	195260857	195261297	MACS_peak_11383	72.51	440	0	0	0	intergen
2	195318544	195318836	MACS_peak_11384	829.92	292	0	0	0	intergen
2	195374323	195374700	MACS_peak_11385	95.34	377	0	0	0	intergen
2	195660248	195660625	MACS_peak_11387	516.8	377	0	1	0	gen
2	195745138	195745480	MACS_peak_11388	66.16	342	0	1	0	gen
2	195938349	195938605	MACS_peak_11389	683.4	256	0	1	0	gen
2	196181266	196181457	MACS_peak_11390	695.57	191	0	0	0	intergen
2	196298136	196298475	MACS_peak_11391	351.43	339	0	1	0	gen
2	196337465	196337767	MACS_peak_11392	441.54	302	0	1	0	gen
2	196521691	196521983	MACS_peak_11393	147.15	292	0	1	0	gen
2	196526783	196527100	MACS_peak_11394	102.96	317	0	1	0	gen
2	196757483	196757740	MACS_peak_11395	158.81	257	0	1	0	gen
2	196914703	196914838	MACS_peak_11396	838.85	135	0	1	0	gen
2	196948370	196948533	MACS_peak_11397	1549.78	163	0	0	0	intergen
2	197012077	197012334	MACS_peak_11398	469.39	257	0	1	0	gen
2	197058017	197058268	MACS_peak_11399	746.04	251	0	1	0	gen
2	197191511	197191726	MACS_peak_11401	1079.97	215	0	1	0	gen
2	197260849	197261322	MACS_peak_11402	142.22	473	0	1	1	gen
2	197575669	197575938	MACS_peak_11403	586.5	269	0	1	0	gen
2	197606519	197606823	MACS_peak_11404	160.56	304	0	1	0	gen
2	197619431	197619791	MACS_peak_11405	93.4	360	0	1	0	gen
2	197636780	197637065	MACS_peak_11406	58.88	285	0	1	0	gen
2	197638567	197638816	MACS_peak_11408	96.18	249	0	1	0	gen
2	197732167	197732534	MACS_peak_11410	75.67	367	0	1	1	gen
2	197777985	197778293	MACS_peak_11412	406.81	308	0	1	0	gen
2	197922168	197922455	MACS_peak_11413	137.17	287	0	1	0	gen
2	197946306	197946591	MACS_peak_11414	950.42	285	0	1	0	gen
2	198296717	198297124	MACS_peak_11415	992.94	407	0	1	0	gen
2	198374309	198374658	MACS_peak_11416	654.27	349	0	1	1	gen
2	198582118	198582522	MACS_peak_11417	160.2	404	0	0	1	other
2	198848531	198848748	MACS_peak_11419	656.41	217	0	0	0	intergen
2	199149608	199149806	MACS_peak_11420	624.08	198	0	0	0	intergen
2	199486056	199486299	MACS_peak_11421	525.9	243	0	0	0	intergen
2	199488940	199489180	MACS_peak_11422	797.18	240	0	0	0	intergen
2	199816699	199816975	MACS_peak_11423	450.78	276	0	1	0	gen
2	199861283	199861563	MACS_peak_11424	707.43	280	0	0	0	intergen
2	200131579	200131802	MACS_peak_11426	712.32	223	0	0	0	intergen
2	200287346	200287526	MACS_peak_11427	746.04	180	0	0	0	intergen
2	200562101	200562421	MACS_peak_11428	56.84	320	0	1	0	gen
2	200563747	200564147	MACS_peak_11429	75.42	400	0	1	0	gen
2	200575952	200576287	MACS_peak_11430	423.72	335	0	1	0	gen
2	200856812	200857007	MACS_peak_11431	485.3	195	1	0	0	promoter
2	200905679	200906086	MACS_peak_11432	555.48	407	1	0	0	promoter
2	201169161	201169497	MACS_peak_11433	265.34	336	0	1	0	gen
2	201232315	201232663	MACS_peak_11434	972.38	348	1	0	0	promoter
2	201291827	201292164	MACS_peak_11435	84.4	337	1	0	0	promoter
2	201835842	201836260	MACS_peak_11436	1353.18	418	0	1	0	gen
2	202262175	202262548	MACS_peak_11437	103.45	373	1	0	0	promoter
2	202279031	202279363	MACS_peak_11438	425.26	332	0	1	0	gen
2	202460646	202460945	MACS_peak_11439	452.42	299	0	1	0	gen
2	202491620	202491869	MACS_peak_11440	862.64	249	0	1	0	gen
2	202573733	202574153	MACS_peak_11441	774.27	420	0	0	0	intergen
2	203074215	203074442	MACS_peak_11442	548.55	227	0	1	0	gen
2	203225494	203225707	MACS_peak_11443	1282.94	213	0	1	0	gen
2	203294840	203294980	MACS_peak_11444	275.54	140	0	1	0	gen
2	203575377	203575575	MACS_peak_11445	662.31	198	0	0	0	intergen
2	203815410	203815616	MACS_peak_11446	612.68	206	0	0	0	intergen
2	203909750	203910048	MACS_peak_11447	824.29	298	0	0	0	intergen
2	204145333	204145588	MACS_peak_11448	596.79	255	0	0	0	intergen
2	204325448	204325739	MACS_peak_11449	570.2	291	0	0	0	intergen
2	204339904	204340197	MACS_peak_11450	3195.62	293	0	0	0	intergen
2	204475326	204475484	MACS_peak_11451	1608.09	158	0	0	0	intergen
2	204625113	204625507	MACS_peak_11452	625.13	394	0	1	0	gen
2	204829698	204830030	MACS_peak_11454	178.37	332	0	1	0	gen
2	205074277	205074517	MACS_peak_11455	647.47	240	0	1	0	gen
2	205417190	205417517	MACS_peak_11457	201.59	327	0	1	0	gen
2	206037288	206037653	MACS_peak_11458	643.49	365	0	1	0	gen
2	206071176	206071397	MACS_peak_11459	255.86	221	0	1	0	gen
2	206164312	206164617	MACS_peak_11460	475.52	305	0	0	0	intergen
2	206260386	206260620	MACS_peak_11461	532.66	234	0	0	1	other
2	206278067	206278306	MACS_peak_11462	1098.16	239	1	0	0	promoter
2	206508651	206508783	MACS_peak_11464	932.35	132	0	1	0	gen
2	206781620	206781880	MACS_peak_11465	1631.97	260	0	1	0	gen
2	206879969	206880140	MACS_peak_11467	1007.8	171	0	0	0	intergen
2	206912217	206912426	MACS_peak_11469	72.71	209	0	0	0	intergen
2	206989442	206989717	MACS_peak_11470	380.3	275	0	0	0	intergen
2	207003770	207004147	MACS_peak_11471	62.6	377	0	0	0	intergen
2	207716745	207717042	MACS_peak_11473	178.37	297	0	1	0	gen
2	208072212	208072565	MACS_peak_11474	651.52	353	0	0	0	intergen
2	208158992	208159246	MACS_peak_11475	148.7	254	1	0	0	promoter
2	208256540	208256900	MACS_peak_11476	526.28	360	0	1	0	gen
2	208316110	208316446	MACS_peak_11477	80.67	336	0	1	0	gen
2	208373443	208373796	MACS_peak_11478	414.75	353	0	1	0	gen
2	208466456	208466621	MACS_peak_11479	831.63	165	0	1	1	gen
2	208482444	208482718	MACS_peak_11480	2861.42	274	0	1	1	gen
2	208696553	208696844	MACS_peak_11481	114.74	291	0	1	0	gen
2	208749371	208749616	MACS_peak_11483	88.89	245	0	1	0	gen
2	208761816	208762182	MACS_peak_11484	148.93	366	0	1	0	gen
2	208783260	208783550	MACS_peak_11485	330.91	290	0	1	0	gen
2	208786207	208786627	MACS_peak_11486	98.64	420	0	1	0	gen
2	208787938	208788299	MACS_peak_11487	62.38	361	0	1	0	gen
2	208799669	208800014	MACS_peak_11488	271.96	345	0	1	0	gen
2	208805542	208805908	MACS_peak_11489	75.01	366	0	1	0	gen
2	208835454	208835725	MACS_peak_11490	118.88	271	0	1	0	gen
2	208899158	208899540	MACS_peak_11491	56.64	382	0	0	0	intergen
2	209130095	209130486	MACS_peak_11492	75.28	391	0	0	0	intergen
2	209132239	209132710	MACS_peak_11494	60.61	471	0	0	0	intergen
2	209208076	209208350	MACS_peak_11496	458.32	274	0	0	0	intergen
2	209333402	209333677	MACS_peak_11497	132.73	275	0	0	0	intergen
2	209334458	209334848	MACS_peak_11498	360.79	390	0	0	0	intergen
2	209425479	209425689	MACS_peak_11499	936.57	210	1	0	0	promoter
2	209593659	209594027	MACS_peak_11500	894.97	368	0	1	0	gen
2	209622471	209622813	MACS_peak_11501	786.29	342	0	1	0	gen
2	209751122	209751523	MACS_peak_11503	88.68	401	0	0	0	intergen
2	210069712	210069849	MACS_peak_11504	567.81	137	0	1	0	gen
2	210195382	210195840	MACS_peak_11505	1180.63	458	0	1	1	gen
2	210399539	210399846	MACS_peak_11506	547.35	307	0	0	1	other
2	210507531	210507946	MACS_peak_11507	65.47	415	0	1	0	gen
2	210509200	210509679	MACS_peak_11508	87.62	479	0	1	0	gen
2	210577559	210577993	MACS_peak_11509	601.99	434	0	1	0	gen
2	210761694	210762079	MACS_peak_11510	103.28	385	0	0	0	intergen
2	211052163	211052518	MACS_peak_11511	776.01	355	0	0	0	intergen
2	211134620	211135060	MACS_peak_11512	598.7	440	0	0	0	intergen
2	211135340	211135617	MACS_peak_11513	456.44	277	0	0	0	intergen
2	211254696	211254938	MACS_peak_11514	227.44	242	0	0	0	intergen
2	211363750	211364045	MACS_peak_11515	445.58	295	0	0	0	intergen
2	211455157	211455477	MACS_peak_11516	550.56	320	0	1	0	gen
2	211877361	211877582	MACS_peak_11517	729.14	221	0	1	0	gen
2	212057459	212057704	MACS_peak_11518	236.5	245	0	1	0	gen
2	212146865	212147191	MACS_peak_11519	564	326	0	1	0	gen
2	212520473	212520661	MACS_peak_11520	883.81	188	0	1	0	gen
2	212567608	212567923	MACS_peak_11521	1836.46	315	0	0	0	intergen
2	212584080	212584411	MACS_peak_11522	128.46	331	0	0	1	other
2	212686335	212686602	MACS_peak_11523	994.68	267	0	0	1	other
2	212702186	212702396	MACS_peak_11524	342.2	210	0	0	1	other
2	212892297	212892511	MACS_peak_11525	644.42	214	0	0	1	other
2	213019224	213019524	MACS_peak_11526	1098.12	300	0	1	1	gen
2	213246665	213246964	MACS_peak_11527	1242.54	299	0	0	0	intergen
2	213256558	213256827	MACS_peak_11528	201.59	269	0	0	0	intergen
2	213593745	213593896	MACS_peak_11529	742.08	151	0	1	0	gen
2	213678218	213678577	MACS_peak_11530	52.67	359	0	1	0	gen
2	213833483	213833655	MACS_peak_11531	738.06	172	0	1	0	gen
2	213887218	213887467	MACS_peak_11532	613.04	249	0	1	0	gen
2	213934642	213935033	MACS_peak_11533	425.22	391	0	1	0	gen
2	214632912	214633383	MACS_peak_11534	100.83	471	0	0	1	other
2	214635507	214635871	MACS_peak_11535	68.17	364	0	0	1	other
2	214684582	214684859	MACS_peak_11536	84.4	277	0	0	0	intergen
2	214960770	214961073	MACS_peak_11538	561.84	303	0	1	1	gen
2	215043828	215044026	MACS_peak_11539	642.68	198	0	1	1	gen
2	215195911	215196248	MACS_peak_11540	113.53	337	0	0	0	intergen
2	215254090	215254537	MACS_peak_11541	172.39	447	0	0	0	intergen
2	215269832	215270182	MACS_peak_11542	653.58	350	0	0	0	intergen
2	215454502	215454764	MACS_peak_11543	591.97	262	0	0	1	other
2	215535694	215535937	MACS_peak_11544	554.96	243	0	0	2	other
2	216033930	216034288	MACS_peak_11545	648.14	358	0	1	0	gen
2	216404083	216404304	MACS_peak_11546	549.18	221	0	0	1	other
2	216696786	216696996	MACS_peak_11547	772.8	210	0	0	1	other
2	216777784	216778117	MACS_peak_11548	542.34	333	0	0	1	other
2	217215528	217215683	MACS_peak_11550	463.36	155	0	0	0	intergen
2	217311236	217311635	MACS_peak_11551	118	399	0	0	2	other
2	217513674	217513806	MACS_peak_11552	1116.4	132	0	0	1	other
2	217674804	217675139	MACS_peak_11553	83.8	335	0	0	1	other
2	217713506	217713801	MACS_peak_11555	567.38	295	0	0	1	other
2	217789270	217789499	MACS_peak_11556	848.95	229	0	0	0	intergen
2	218186271	218186572	MACS_peak_11557	689.95	301	0	0	0	intergen
2	218301321	218301567	MACS_peak_11558	458.27	246	0	1	0	gen
2	218687493	218687752	MACS_peak_11559	830.88	259	0	1	0	gen
2	218847707	218847953	MACS_peak_11560	439.71	246	0	0	0	intergen
2	218876650	218876975	MACS_peak_11561	603.02	325	1	0	0	promoter
2	218979999	218980328	MACS_peak_11562	668.48	329	1	0	1	promoter
2	219126620	219126845	MACS_peak_11563	3056.71	225	0	2	0	gen
2	219171214	219171490	MACS_peak_11564	984.35	276	1	0	0	promoter
2	219594623	219594979	MACS_peak_11565	284.23	356	1	0	0	promoter
2	219642507	219642775	MACS_peak_11566	462.14	268	0	0	0	intergen
2	219934317	219934663	MACS_peak_11568	51.97	346	0	0	0	intergen
2	220233164	220233537	MACS_peak_11570	473.28	373	0	0	1	other
2	220547801	220548020	MACS_peak_11571	580.62	219	0	0	1	other
2	221181517	221181780	MACS_peak_11572	722.6	263	0	0	0	intergen
2	221988267	221988550	MACS_peak_11573	69.18	283	0	0	0	intergen
2	221989493	221989975	MACS_peak_11574	59.36	482	0	0	0	intergen
2	222002066	222002424	MACS_peak_11575	50.92	358	0	0	0	intergen
2	222152186	222152492	MACS_peak_11577	52.18	306	0	0	0	intergen
2	222154905	222155170	MACS_peak_11578	106.55	265	0	0	0	intergen
2	222690670	222690963	MACS_peak_11579	446.75	293	0	1	0	gen
2	222744505	222744651	MACS_peak_11580	556.14	146	0	0	0	intergen
2	222801033	222801196	MACS_peak_11581	586.33	163	0	0	0	intergen
2	222898994	222899431	MACS_peak_11582	3100	437	0	1	0	gen
2	223399279	223399471	MACS_peak_11583	678.9	192	0	0	0	intergen
2	223417622	223417977	MACS_peak_11584	114.74	355	0	0	0	intergen
2	223691374	223691625	MACS_peak_11585	389.4	251	0	0	0	intergen
2	223692339	223692653	MACS_peak_11586	434.84	314	0	0	0	intergen
2	223929769	223929962	MACS_peak_11587	678.9	193	0	1	0	gen
2	223970379	223970573	MACS_peak_11588	848.95	194	1	0	0	promoter
2	224232020	224232265	MACS_peak_11589	450.38	245	0	0	0	intergen
2	225128806	225129074	MACS_peak_11591	76.3	268	0	0	0	intergen
2	225519785	225520075	MACS_peak_11592	166.98	290	0	1	0	gen
2	225520223	225520660	MACS_peak_11593	97.37	437	0	1	0	gen
2	225521896	225522262	MACS_peak_11594	75.01	366	0	1	0	gen
2	225644356	225644822	MACS_peak_11595	62.5	466	0	1	0	gen
2	225665665	225665924	MACS_peak_11596	468.05	259	0	0	0	intergen
2	226110908	226111335	MACS_peak_11598	139.98	427	0	0	0	intergen
2	226507908	226508050	MACS_peak_11600	1067.21	142	0	0	0	intergen
2	226813175	226813418	MACS_peak_11601	501.16	243	0	0	0	intergen
2	226977572	226977761	MACS_peak_11602	695.57	189	0	1	0	gen
2	227107186	227107377	MACS_peak_11603	866.35	191	0	1	0	gen
2	227379442	227379695	MACS_peak_11604	425.33	253	0	1	0	gen
2	227890475	227890721	MACS_peak_11605	485.56	246	0	1	0	gen
2	228036321	228036699	MACS_peak_11606	53.46	378	0	1	0	gen
2	228200652	228201130	MACS_peak_11607	56.91	478	0	0	0	intergen
2	228203524	228203892	MACS_peak_11608	63.13	368	0	0	0	intergen
2	228481960	228482376	MACS_peak_11611	139.27	416	0	0	0	intergen
2	228572936	228573321	MACS_peak_11612	65.58	385	0	0	1	other
2	229458859	229459055	MACS_peak_11613	662.31	196	0	1	0	gen
2	229743861	229744193	MACS_peak_11614	149.97	332	0	0	0	intergen
2	230118987	230119326	MACS_peak_11615	974.11	339	0	0	0	intergen
2	230230544	230230865	MACS_peak_11616	431.05	321	0	1	0	gen
2	230291685	230291997	MACS_peak_11617	435.94	312	0	1	0	gen
2	230611444	230611655	MACS_peak_11618	1023.29	211	0	0	0	intergen
2	230902230	230902501	MACS_peak_11619	584.96	271	0	0	0	intergen
2	230988944	230989272	MACS_peak_11620	142.05	328	1	0	1	promoter
2	231091157	231091437	MACS_peak_11621	3100	280	0	1	0	gen
2	231244151	231244387	MACS_peak_11622	662.31	236	0	1	0	gen
2	231405795	231406076	MACS_peak_11623	1120.76	281	0	0	0	intergen
2	231490062	231490342	MACS_peak_11624	578.19	280	0	0	0	intergen
2	231601722	231601900	MACS_peak_11625	763.02	178	0	0	0	intergen
2	231641597	231641751	MACS_peak_11626	498.32	154	0	0	0	intergen
2	231679640	231679795	MACS_peak_11627	1904.96	155	0	0	0	intergen
2	231900512	231900813	MACS_peak_11628	563.21	301	0	0	0	intergen
2	232142119	232142394	MACS_peak_11629	457.69	275	0	1	0	gen
2	232178936	232179121	MACS_peak_11630	51.74	185	0	1	0	gen
2	232357309	232357653	MACS_peak_11631	80.67	344	0	0	0	intergen
2	232688373	232688505	MACS_peak_11632	1028.85	132	0	0	0	intergen
2	233186607	233186808	MACS_peak_11633	68.85	201	0	1	0	gen
2	233380541	233380786	MACS_peak_11634	629.38	245	0	1	0	gen
2	233561425	233561797	MACS_peak_11635	52.99	372	0	1	0	gen
2	233577614	233577799	MACS_peak_11636	281.97	185	0	0	0	intergen
2	234288840	234289246	MACS_peak_11638	722.05	406	0	0	0	intergen
2	234888834	234889096	MACS_peak_11639	124.58	262	0	0	1	other
2	234890523	234890944	MACS_peak_11640	63	421	0	0	1	other
2	235307386	235307748	MACS_peak_11641	62.29	362	0	0	0	intergen
2	236084991	236085345	MACS_peak_11642	159.56	354	0	1	0	gen
2	236135170	236135469	MACS_peak_11643	479.57	299	0	0	0	intergen
2	236180963	236181173	MACS_peak_11644	760.34	210	0	0	1	other
2	236384273	236384550	MACS_peak_11645	64.82	277	0	1	0	gen
2	236868265	236868524	MACS_peak_11647	127.5	259	0	0	0	intergen
2	237072338	237072636	MACS_peak_11648	443.84	298	0	0	1	other
2	237343511	237343654	MACS_peak_11649	546.58	143	0	1	0	gen
2	237410165	237410328	MACS_peak_11650	1892.57	163	0	1	0	gen
2	238065117	238065313	MACS_peak_11651	644.94	196	1	1	0	promoter
2	238256643	238256871	MACS_peak_11652	848.95	228	0	1	0	gen
2	238717727	238718001	MACS_peak_11653	71.7	274	0	0	0	intergen
2	238785081	238785328	MACS_peak_11655	763.02	247	0	0	0	intergen
2	239357782	239358107	MACS_peak_11656	603.02	325	0	1	0	gen
2	239837993	239838280	MACS_peak_11657	107.62	287	0	0	0	intergen
2	239909877	239910132	MACS_peak_11658	1853.13	255	0	1	0	gen
2	240233002	240233174	MACS_peak_11659	1007.8	172	0	0	1	other
2	240495014	240495207	MACS_peak_11660	835.09	193	0	1	0	gen
2	240546655	240546989	MACS_peak_11662	58.11	334	0	1	0	gen
2	240675513	240675703	MACS_peak_11664	695.57	190	1	0	0	promoter
2	240699197	240699387	MACS_peak_11665	695.57	190	0	0	0	intergen
2	241338580	241339056	MACS_peak_11666	939.22	476	0	1	0	gen
2	241396147	241396553	MACS_peak_11667	59.93	406	0	1	0	gen
2	241732668	241732899	MACS_peak_11668	1090.36	231	1	0	0	promoter
2	241875931	241876224	MACS_peak_11669	398.43	293	0	0	0	intergen
2	242146484	242146753	MACS_peak_11670	360.28	269	0	0	1	other
2	242159923	242160330	MACS_peak_11671	1382.49	407	0	0	0	intergen
2	242182006	242182309	MACS_peak_11672	540.43	303	0	0	0	intergen
3	135689	135884	MACS_peak_12964	472.76	195	0	0	0	intergen
3	360603	361009	MACS_peak_12965	120.88	406	0	1	0	gen
3	382777	382992	MACS_peak_12966	828.25	215	0	1	1	gen
3	410225	410497	MACS_peak_12967	988.9	272	0	0	0	intergen
3	473977	474209	MACS_peak_12968	799.8	232	0	0	0	intergen
3	612676	613011	MACS_peak_12971	89.68	335	0	0	1	other
3	632610	632894	MACS_peak_12972	704	284	0	0	1	other
3	727170	727401	MACS_peak_12973	762.11	231	0	0	1	other
3	889849	890131	MACS_peak_12974	937.94	282	0	0	0	intergen
3	902244	902576	MACS_peak_12975	642.94	332	0	0	0	intergen
3	1033714	1033997	MACS_peak_12976	603.02	283	0	0	0	intergen
3	1083944	1084187	MACS_peak_12977	645.81	243	0	0	0	intergen
3	1183080	1183288	MACS_peak_12978	613.04	208	0	1	0	gen
3	1207739	1207997	MACS_peak_12979	1604.58	258	0	1	0	gen
3	1389407	1389675	MACS_peak_12980	89.68	268	0	1	0	gen
3	1482451	1482768	MACS_peak_12981	54.21	317	0	0	0	intergen
3	1665736	1665957	MACS_peak_12982	869.22	221	0	0	0	intergen
3	1707665	1707963	MACS_peak_12983	692.37	298	0	0	0	intergen
3	1988102	1988275	MACS_peak_12984	1128.59	173	0	0	0	intergen
3	2006929	2007205	MACS_peak_12985	86.12	276	0	0	0	intergen
3	2008014	2008357	MACS_peak_12986	57.32	343	0	0	0	intergen
3	2326499	2326635	MACS_peak_12987	1061.85	136	0	1	0	gen
3	2550053	2550426	MACS_peak_12988	480.61	373	0	1	0	gen
3	2575698	2575831	MACS_peak_12989	1072.4	133	0	1	0	gen
3	2600447	2600831	MACS_peak_12990	105.65	384	0	1	0	gen
3	3131771	3132144	MACS_peak_12992	74.1	373	0	0	0	intergen
3	3200482	3200940	MACS_peak_12993	1483.9	458	0	0	0	intergen
3	3370618	3371065	MACS_peak_12994	1192.27	447	0	0	1	other
3	3387357	3387548	MACS_peak_12995	691.98	191	0	0	1	other
3	3723661	3724004	MACS_peak_12996	52.95	343	0	1	0	gen
3	3865617	3865920	MACS_peak_12997	142.05	303	0	1	0	gen
3	3868074	3868413	MACS_peak_12998	151.81	339	0	1	0	gen
3	3898431	3898768	MACS_peak_12999	61.21	337	0	1	0	gen
3	3913105	3913496	MACS_peak_13000	77.96	391	0	1	0	gen
3	3913604	3913854	MACS_peak_13001	108.58	250	0	1	0	gen
3	3964260	3964466	MACS_peak_13002	114.49	206	0	1	0	gen
3	3966077	3966335	MACS_peak_13003	50.65	258	0	1	0	gen
3	3998243	3998599	MACS_peak_13004	1859.03	356	0	1	0	gen
3	4025480	4025841	MACS_peak_13005	97.24	361	0	1	0	gen
3	4290369	4290613	MACS_peak_13006	501.16	244	0	1	0	gen
3	4314755	4315003	MACS_peak_13007	1043.77	248	0	2	0	gen
3	4363710	4364000	MACS_peak_13008	111.09	290	0	1	0	gen
3	4447350	4447572	MACS_peak_13009	433.36	222	0	1	0	gen
3	4633316	4633682	MACS_peak_13010	522.88	366	0	1	0	gen
3	4711465	4711739	MACS_peak_13011	488.85	274	0	1	0	gen
3	4840429	4840690	MACS_peak_13012	1445.42	261	0	1	1	gen
3	4967486	4967782	MACS_peak_13013	198.49	296	0	0	1	other
3	4976235	4976530	MACS_peak_13014	551.41	295	1	0	1	promoter
3	4980394	4980683	MACS_peak_13015	699.78	289	1	0	0	promoter
3	5165297	5165484	MACS_peak_13016	712.32	187	0	1	1	gen
3	5226689	5227123	MACS_peak_13017	843.98	434	0	0	0	intergen
3	5233944	5234239	MACS_peak_13018	142.05	295	0	0	0	intergen
3	5426398	5426618	MACS_peak_13019	431.6	220	0	0	0	intergen
3	5526164	5526535	MACS_peak_13020	55.51	371	0	0	0	intergen
3	5806233	5806494	MACS_peak_13021	403.26	261	0	0	0	intergen
3	6140019	6140350	MACS_peak_13022	611.86	331	0	0	0	intergen
3	6270428	6270725	MACS_peak_13023	118.5	297	0	0	1	other
3	6320030	6320318	MACS_peak_13024	57.21	288	0	0	1	other
3	6486303	6486633	MACS_peak_13025	198.42	330	0	0	0	intergen
3	6487846	6488031	MACS_peak_13026	86.68	185	0	0	0	intergen
3	6536989	6537345	MACS_peak_13027	51.61	356	0	0	1	other
3	6758296	6758522	MACS_peak_13028	816.83	226	0	0	1	other
3	6935503	6935716	MACS_peak_13029	763.02	213	0	1	0	gen
3	7075897	7076235	MACS_peak_13030	422.19	338	0	1	0	gen
3	7162632	7162780	MACS_peak_13031	522.42	148	0	1	0	gen
3	7449268	7449558	MACS_peak_13032	1395.23	290	0	1	0	gen
3	7895791	7896146	MACS_peak_13033	198.49	355	0	0	0	intergen
3	8111275	8111534	MACS_peak_13034	726.32	259	0	0	2	other
3	8142419	8142715	MACS_peak_13035	648.05	296	0	0	1	other
3	8417359	8417792	MACS_peak_13036	540.82	433	0	0	1	other
3	8481286	8481650	MACS_peak_13037	386.41	364	0	0	1	other
3	8502190	8502472	MACS_peak_13038	972.38	282	1	0	1	promoter
3	8607592	8607781	MACS_peak_13039	801.73	189	0	0	1	other
3	8682987	8683340	MACS_peak_13040	530.32	353	0	1	1	gen
3	8713937	8714158	MACS_peak_13041	458.84	221	0	1	0	gen
3	8769344	8769637	MACS_peak_13043	568.79	293	0	1	0	gen
3	8971016	8971293	MACS_peak_13044	972.38	277	0	0	0	intergen
3	9067381	9067840	MACS_peak_13045	1482.85	459	0	1	0	gen
3	9302667	9303033	MACS_peak_13046	435.67	366	0	1	1	gen
3	9424869	9425077	MACS_peak_13047	931.22	208	0	1	0	gen
3	9503308	9503568	MACS_peak_13048	593.56	260	0	0	0	intergen
3	9821036	9821248	MACS_peak_13049	919.78	212	0	2	0	gen
3	10225016	10225187	MACS_peak_13050	932.24	171	0	1	0	gen
3	10322274	10322656	MACS_peak_13051	357.27	382	1	0	0	promoter
3	10344201	10344466	MACS_peak_13052	720.77	265	0	1	0	gen
3	10738974	10739266	MACS_peak_13053	437.52	292	0	0	0	intergen
3	10745314	10745508	MACS_peak_13054	678.9	194	0	0	0	intergen
3	10783414	10783698	MACS_peak_13055	559.26	284	0	0	0	intergen
3	11155507	11155700	MACS_peak_13056	619.53	193	0	1	0	gen
3	11236598	11236945	MACS_peak_13057	2690.04	347	0	1	0	gen
3	11257058	11257388	MACS_peak_13058	528.29	330	0	1	0	gen
3	11286234	11286465	MACS_peak_13059	619.53	231	0	1	0	gen
3	11426164	11426482	MACS_peak_13060	845.32	318	0	1	0	gen
3	11595231	11595601	MACS_peak_13061	103.45	370	0	1	0	gen
3	11662426	11662751	MACS_peak_13063	909.54	325	0	1	0	gen
3	11717382	11717515	MACS_peak_13064	1011.74	133	0	1	0	gen
3	11846852	11847115	MACS_peak_13065	722.6	263	0	0	0	intergen
3	12028147	12028419	MACS_peak_13066	96.27	272	0	1	0	gen
3	12038732	12038967	MACS_peak_13067	502.51	235	0	1	0	gen
3	12046504	12046741	MACS_peak_13068	516.86	237	0	1	0	gen
3	12134947	12135301	MACS_peak_13069	401.08	354	0	1	0	gen
3	12138119	12138308	MACS_peak_13070	504.54	189	0	1	0	gen
3	12194666	12194931	MACS_peak_13071	621.04	265	0	0	0	intergen
3	12706526	12706747	MACS_peak_13072	1226.97	221	0	0	0	intergen
3	12770686	12770969	MACS_peak_13073	506.92	283	0	0	0	intergen
3	12841625	12841980	MACS_peak_13074	529.16	355	0	1	0	gen
3	12867921	12868238	MACS_peak_13075	677.44	317	0	1	0	gen
3	12902565	12902788	MACS_peak_13076	1043.77	223	0	1	0	gen
3	13179231	13179452	MACS_peak_13077	629.32	221	0	1	0	gen
3	13461605	13461918	MACS_peak_13078	555.13	313	0	0	0	intergen
3	13496345	13496637	MACS_peak_13079	447.34	292	0	1	0	gen
3	13648318	13648534	MACS_peak_13080	1264.23	216	0	0	0	intergen
3	13657851	13658046	MACS_peak_13081	662.31	195	0	0	1	other
3	13673255	13673533	MACS_peak_13082	312.33	278	0	0	1	other
3	13742271	13742512	MACS_peak_13083	913.84	241	0	0	1	other
3	14034433	14034689	MACS_peak_13084	425.33	256	0	0	1	other
3	14072660	14073001	MACS_peak_13085	84.56	341	0	0	1	other
3	14075019	14075394	MACS_peak_13086	115.17	375	0	0	1	other
3	14203558	14203863	MACS_peak_13087	560.48	305	0	0	0	intergen
3	14261177	14261410	MACS_peak_13088	1301.7	233	0	0	0	intergen
3	14436430	14436585	MACS_peak_13089	501.14	155	0	1	0	gen
3	14508802	14509186	MACS_peak_13090	881.79	384	0	1	0	gen
3	14673798	14674114	MACS_peak_13091	553.16	316	1	0	0	promoter
3	14711754	14711951	MACS_peak_13092	754.53	197	0	1	0	gen
3	14857581	14857777	MACS_peak_13093	1191.52	196	0	1	0	gen
3	14925672	14925981	MACS_peak_13094	814.28	309	0	1	1	gen
3	15055304	15055527	MACS_peak_13095	650.69	223	0	1	0	gen
3	15108168	15108361	MACS_peak_13096	678.9	193	0	0	0	intergen
3	15128455	15128791	MACS_peak_13097	1722.91	336	0	0	0	intergen
3	15202651	15202999	MACS_peak_13098	647.33	348	1	0	1	promoter
3	15220335	15220603	MACS_peak_13099	450.74	268	0	1	0	gen
3	15267999	15268200	MACS_peak_13100	645.81	201	0	1	0	gen
3	15305303	15305551	MACS_peak_13101	471.88	248	0	1	0	gen
3	15401428	15401560	MACS_peak_13102	977.06	132	0	1	0	gen
3	15405465	15405788	MACS_peak_13103	548.63	323	0	1	0	gen
3	15731841	15731980	MACS_peak_13104	701.67	139	0	1	0	gen
3	15812318	15812631	MACS_peak_13105	1667.82	313	0	1	0	gen
3	15815727	15816014	MACS_peak_13106	1258.14	287	0	1	0	gen
3	15867624	15867839	MACS_peak_13107	315.94	215	0	0	0	intergen
3	15995194	15995403	MACS_peak_13108	554.69	209	0	0	0	intergen
3	16117870	16118080	MACS_peak_13109	451.61	210	0	0	0	intergen
3	16159397	16159713	MACS_peak_13110	191.91	316	0	0	0	intergen
3	16178445	16178671	MACS_peak_13111	848.95	226	1	0	0	promoter
3	16268136	16268342	MACS_peak_13112	1477.15	206	1	0	0	promoter
3	16517275	16517447	MACS_peak_13114	1226.97	172	0	0	0	intergen
3	16550742	16551054	MACS_peak_13116	811.61	312	0	0	0	intergen
3	16601317	16601706	MACS_peak_13117	510.37	389	0	1	0	gen
3	16679243	16679660	MACS_peak_13118	191.29	417	0	0	0	intergen
3	16777902	16778267	MACS_peak_13119	127.5	365	0	0	0	intergen
3	16954508	16954877	MACS_peak_13120	113.2	369	0	1	0	gen
3	17032499	17032746	MACS_peak_13121	743.63	247	0	1	0	gen
3	17102177	17102454	MACS_peak_13122	169.15	277	0	0	0	intergen
3	17233483	17233791	MACS_peak_13123	424.89	308	0	1	0	gen
3	17258912	17259293	MACS_peak_13124	401.71	381	0	1	0	gen
3	17307519	17307764	MACS_peak_13125	501.16	245	0	1	0	gen
3	17324626	17325036	MACS_peak_13126	972.38	410	0	1	0	gen
3	17344332	17344687	MACS_peak_13127	107.63	355	0	1	0	gen
3	17345101	17345409	MACS_peak_13128	62.76	308	0	1	0	gen
3	17644999	17645376	MACS_peak_13130	1159.16	377	0	1	0	gen
3	17703845	17704200	MACS_peak_13131	76.3	355	0	1	0	gen
3	17810998	17811174	MACS_peak_13132	763.02	176	0	1	0	gen
3	17841318	17841567	MACS_peak_13133	901.33	249	0	1	0	gen
3	17859997	17860420	MACS_peak_13134	95.99	423	0	1	0	gen
3	17860512	17860860	MACS_peak_13135	82.14	348	0	1	0	gen
3	18199306	18199505	MACS_peak_13136	645.81	199	0	1	0	gen
3	18389208	18389480	MACS_peak_13138	446.26	272	0	2	0	gen
3	18440899	18441093	MACS_peak_13139	654.22	194	0	2	0	gen
3	18758198	18758414	MACS_peak_13141	580.62	216	0	0	1	other
3	18922609	18922941	MACS_peak_13144	1062.71	332	0	0	0	intergen
3	18981174	18981531	MACS_peak_13147	101.89	357	0	0	0	intergen
3	18988760	18988976	MACS_peak_13148	564.92	216	0	0	0	intergen
3	19041046	19041300	MACS_peak_13149	434.14	254	0	0	0	intergen
3	19150887	19151201	MACS_peak_13150	488.85	314	1	0	0	promoter
3	19291449	19291890	MACS_peak_13151	118.32	441	0	1	0	gen
3	19348917	19349326	MACS_peak_13152	691.91	409	0	1	0	gen
3	19370899	19371262	MACS_peak_13153	53.51	363	0	1	0	gen
3	19543219	19543602	MACS_peak_13154	631.92	383	0	0	0	intergen
3	19570878	19571194	MACS_peak_13155	380.3	316	0	0	0	intergen
3	19591012	19591334	MACS_peak_13156	79.51	322	0	0	0	intergen
3	19591717	19591927	MACS_peak_13157	84.54	210	0	0	0	intergen
3	19605335	19605666	MACS_peak_13158	439.59	331	0	0	0	intergen
3	19624556	19624956	MACS_peak_13159	59.94	400	0	0	0	intergen
3	19634827	19634992	MACS_peak_13160	579.03	165	0	0	0	intergen
3	19853115	19853501	MACS_peak_13161	167.19	386	0	0	0	intergen
3	19866781	19867235	MACS_peak_13162	915.58	454	0	0	0	intergen
3	20031270	20031452	MACS_peak_13163	919.78	182	0	0	0	intergen
3	20089256	20089421	MACS_peak_13165	1127.44	165	0	1	0	gen
3	20225833	20226041	MACS_peak_13166	931.22	208	0	0	1	other
3	20762679	20763086	MACS_peak_13168	567.67	407	0	0	1	other
3	20874181	20874535	MACS_peak_13169	88.61	354	0	0	1	other
3	21130393	21130768	MACS_peak_13170	84.4	375	0	0	2	other
3	21181312	21181669	MACS_peak_13172	53.24	357	0	0	1	other
3	21182888	21183263	MACS_peak_13173	68.13	375	0	0	1	other
3	21290587	21290956	MACS_peak_13174	1102.85	369	0	0	0	intergen
3	21368256	21368641	MACS_peak_13175	190.92	385	0	0	0	intergen
3	21455845	21456192	MACS_peak_13176	76.91	347	0	1	0	gen
3	21468275	21468567	MACS_peak_13177	312.33	292	0	1	0	gen
3	21659952	21660260	MACS_peak_13178	438.15	308	0	1	0	gen
3	21731929	21732296	MACS_peak_13179	219.32	367	0	1	0	gen
3	21894500	21894920	MACS_peak_13180	388.99	420	0	1	0	gen
3	21940666	21940929	MACS_peak_13181	351.85	263	0	1	0	gen
3	21984748	21984984	MACS_peak_13183	79.65	236	0	1	0	gen
3	22051026	22051327	MACS_peak_13184	72.06	301	0	1	0	gen
3	22110187	22110490	MACS_peak_13185	115.17	303	0	1	0	gen
3	22138786	22139149	MACS_peak_13186	68.83	363	0	1	0	gen
3	22283132	22283446	MACS_peak_13187	554.47	314	0	1	0	gen
3	22312677	22313007	MACS_peak_13188	97.88	330	0	1	0	gen
3	22483186	22483546	MACS_peak_13189	97.63	360	0	0	0	intergen
3	22697634	22697785	MACS_peak_13190	2231.22	151	0	0	0	intergen
3	22711706	22711967	MACS_peak_13191	194.77	261	0	0	0	intergen
3	22730018	22730317	MACS_peak_13192	691.56	299	0	0	0	intergen
3	22803032	22803460	MACS_peak_13193	92.61	428	0	0	0	intergen
3	22887691	22888120	MACS_peak_13194	724.03	429	0	0	0	intergen
3	22954804	22955075	MACS_peak_13195	154.75	271	0	0	0	intergen
3	22960365	22960784	MACS_peak_13196	1249.15	419	0	0	0	intergen
3	23353084	23353350	MACS_peak_13197	101.28	266	0	1	0	gen
3	23399498	23399792	MACS_peak_13198	695.63	294	0	1	0	gen
3	23722716	23723000	MACS_peak_13199	158.81	284	0	0	0	intergen
3	23761485	23761738	MACS_peak_13200	467.41	253	0	0	0	intergen
3	23888663	23889049	MACS_peak_13201	880.18	386	1	1	0	promoter
3	23998995	23999295	MACS_peak_13202	406.81	300	0	0	0	intergen
3	24088830	24089180	MACS_peak_13203	136.5	350	0	0	0	intergen
3	24264648	24265015	MACS_peak_13204	1671.3	367	0	1	0	gen
3	24281497	24281773	MACS_peak_13205	134.2	276	0	1	0	gen
3	24284345	24284692	MACS_peak_13206	69.91	347	0	1	0	gen
3	24369486	24369750	MACS_peak_13207	1317.25	264	0	1	0	gen
3	24473394	24473746	MACS_peak_13208	127.5	352	0	1	0	gen
3	24532517	24532804	MACS_peak_13209	450.32	287	0	0	1	other
3	24683830	24684103	MACS_peak_13210	583.44	273	0	0	0	intergen
3	25021869	25022293	MACS_peak_13211	492.72	424	0	0	1	other
3	25333882	25334213	MACS_peak_13212	63.13	331	0	1	0	gen
3	25648043	25648451	MACS_peak_13213	518.48	408	0	1	0	gen
3	25760859	25760998	MACS_peak_13214	652.22	139	0	1	0	gen
3	25856885	25857230	MACS_peak_13215	657.04	345	0	0	0	intergen
3	26125425	26125829	MACS_peak_13216	89.02	404	0	0	0	intergen
3	26297028	26297408	MACS_peak_13217	96.81	380	0	0	0	intergen
3	26384959	26385307	MACS_peak_13218	58.04	348	0	0	0	intergen
3	26494706	26495075	MACS_peak_13219	66.48	369	0	0	0	intergen
3	26539563	26539915	MACS_peak_13220	265.34	352	0	0	0	intergen
3	26573075	26573401	MACS_peak_13221	62.21	326	0	0	0	intergen
3	26745605	26745861	MACS_peak_13222	90.48	256	0	0	0	intergen
3	26758832	26759126	MACS_peak_13223	180.31	294	0	0	0	intergen
3	26918126	26918358	MACS_peak_13224	128.7	232	0	0	0	intergen
3	26993018	26993436	MACS_peak_13225	75.01	418	0	0	0	intergen
3	26993768	26994099	MACS_peak_13226	109.76	331	0	0	0	intergen
3	27205040	27205477	MACS_peak_13227	123	437	0	1	0	gen
3	27279324	27279512	MACS_peak_13228	883.81	188	0	1	0	gen
3	27312149	27312378	MACS_peak_13229	548.55	229	0	1	0	gen
3	27373371	27373622	MACS_peak_13230	883.81	251	1	0	0	promoter
3	27439566	27439790	MACS_peak_13231	549.18	224	0	1	0	gen
3	27659257	27659546	MACS_peak_13232	699.78	289	0	0	0	intergen
3	27659673	27660038	MACS_peak_13233	768.37	365	0	0	0	intergen
3	27681315	27681481	MACS_peak_13234	831.63	166	0	0	0	intergen
3	27817461	27817746	MACS_peak_13235	56.02	285	0	0	1	other
3	27820016	27820240	MACS_peak_13236	58.71	224	0	0	1	other
3	28062018	28062375	MACS_peak_13237	55.08	357	0	0	0	intergen
3	28317438	28317706	MACS_peak_13239	853.65	268	1	1	0	promoter
3	28328496	28328887	MACS_peak_13240	406.81	391	0	1	0	gen
3	28415683	28416043	MACS_peak_13241	68.83	360	0	2	0	gen
3	28448781	28448914	MACS_peak_13242	710.42	133	0	2	0	gen
3	28493310	28493720	MACS_peak_13243	52.99	410	0	2	0	gen
3	28667732	28667943	MACS_peak_13244	763.02	211	0	2	0	gen
3	29022232	29022484	MACS_peak_13245	613.04	252	0	2	0	gen
3	29152593	29152950	MACS_peak_13246	528	357	0	2	0	gen
3	29459254	29459480	MACS_peak_13247	548.55	226	0	2	0	gen
3	29622955	29623234	MACS_peak_13248	466.48	279	0	2	1	gen
3	29763696	29763960	MACS_peak_13249	536.7	264	0	2	0	gen
3	29820185	29820328	MACS_peak_13250	856.68	143	0	1	0	gen
3	30012961	30013177	MACS_peak_13251	901.33	216	0	0	0	intergen
3	30040234	30040466	MACS_peak_13252	340.89	232	0	0	0	intergen
3	30051849	30052234	MACS_peak_13253	72.45	385	0	0	0	intergen
3	30054479	30054772	MACS_peak_13254	97.29	293	0	0	0	intergen
3	30063177	30063513	MACS_peak_13255	791.16	336	0	0	0	intergen
3	30244676	30245074	MACS_peak_13256	127.94	398	0	0	0	intergen
3	30432957	30433318	MACS_peak_13257	93.43	361	0	0	0	intergen
3	30768680	30769000	MACS_peak_13258	550.56	320	0	1	0	gen
3	31491294	31491441	MACS_peak_13259	1001.32	147	0	0	0	intergen
3	31644676	31645064	MACS_peak_13260	337.18	388	0	0	0	intergen
3	31724736	31724989	MACS_peak_13261	470.06	253	0	1	0	gen
3	32177343	32177542	MACS_peak_13264	645.81	199	0	0	0	intergen
3	32279515	32279878	MACS_peak_13265	64.31	363	0	1	0	gen
3	32510203	32510407	MACS_peak_13266	629.38	204	0	0	0	intergen
3	32537971	32538171	MACS_peak_13267	983.72	200	0	1	0	gen
3	32573255	32573387	MACS_peak_13268	977.06	132	0	0	0	intergen
3	32733534	32733947	MACS_peak_13269	613.85	413	0	1	1	gen
3	33285310	33285583	MACS_peak_13270	103.45	273	0	1	0	gen
3	33309051	33309336	MACS_peak_13271	451.52	285	0	1	0	gen
3	33456193	33456325	MACS_peak_13272	1046.12	132	0	0	0	intergen
3	33511646	33512026	MACS_peak_13273	61.75	380	0	1	0	gen
3	33776546	33776899	MACS_peak_13274	530.32	353	0	0	0	intergen
3	33787405	33787771	MACS_peak_13275	408.57	366	0	0	0	intergen
3	33867012	33867309	MACS_peak_13276	693.18	297	0	1	0	gen
3	34017475	34017615	MACS_peak_13277	889.07	140	0	0	0	intergen
3	34429669	34429979	MACS_peak_13278	112.84	310	0	0	1	other
3	34560912	34561222	MACS_peak_13279	219.86	310	0	0	1	other
3	34652881	34653257	MACS_peak_13280	56.1	376	0	0	0	intergen
3	34703842	34704142	MACS_peak_13281	563.9	300	0	0	0	intergen
3	34704285	34704588	MACS_peak_13282	819.69	303	0	0	0	intergen
3	34704640	34705089	MACS_peak_13283	833.5	449	0	0	0	intergen
3	34755644	34755955	MACS_peak_13284	201.59	311	0	0	0	intergen
3	34882782	34882952	MACS_peak_13285	1245.57	170	0	0	0	intergen
3	34919661	34919920	MACS_peak_13286	722.6	259	0	0	0	intergen
3	35014528	35014989	MACS_peak_13287	67.62	461	0	0	0	intergen
3	35015482	35015870	MACS_peak_13288	87.75	388	0	0	0	intergen
3	35101778	35102156	MACS_peak_13289	76.3	378	0	0	0	intergen
3	35106666	35107005	MACS_peak_13290	79.62	339	0	0	0	intergen
3	35523646	35523928	MACS_peak_13291	576.71	282	0	0	0	intergen
3	35564394	35564722	MACS_peak_13292	797.81	328	0	0	0	intergen
3	35900598	35900971	MACS_peak_13293	69	373	0	0	0	intergen
3	36049700	36049992	MACS_peak_13294	54.15	292	0	0	0	intergen
3	36226642	36227020	MACS_peak_13295	56.38	378	0	0	0	intergen
3	36227051	36227487	MACS_peak_13296	83.5	436	0	0	0	intergen
3	36322397	36322768	MACS_peak_13297	80.49	371	0	0	0	intergen
3	36540984	36541202	MACS_peak_13298	1747.35	218	0	1	0	gen
3	36624147	36624513	MACS_peak_13299	124.32	366	0	0	1	other
3	36729553	36729729	MACS_peak_13300	972.07	176	0	1	0	gen
3	36798174	36798542	MACS_peak_13301	114.26	368	0	0	0	intergen
3	37530615	37530925	MACS_peak_13302	127.5	310	0	1	0	gen
3	37967329	37967661	MACS_peak_13304	425.26	332	0	1	0	gen
3	38341959	38342282	MACS_peak_13305	75.01	323	1	0	0	promoter
3	38410513	38410845	MACS_peak_13306	79.95	332	0	1	0	gen
3	38651236	38651522	MACS_peak_13307	450.92	286	0	0	0	intergen
3	38934875	38935172	MACS_peak_13308	85.92	297	0	1	0	gen
3	38937474	38937744	MACS_peak_13309	90.4	270	0	1	0	gen
3	39291833	39292231	MACS_peak_13310	1000.63	398	0	0	0	intergen
3	39370156	39370483	MACS_peak_13311	54.62	327	0	0	0	intergen
3	39378091	39378426	MACS_peak_13312	791.99	335	0	0	0	intergen
3	39417288	39417651	MACS_peak_13313	730.17	363	0	0	0	intergen
3	39447806	39448200	MACS_peak_13314	507.75	394	0	0	0	intergen
3	39541786	39542119	MACS_peak_13315	424.75	333	0	0	0	intergen
3	39650945	39651270	MACS_peak_13316	114.74	325	0	0	0	intergen
3	39877804	39878113	MACS_peak_13318	137	309	0	1	0	gen
3	39886978	39887350	MACS_peak_13319	76.86	372	0	1	0	gen
3	39985699	39985960	MACS_peak_13320	116.4	261	0	1	0	gen
3	40084700	40085067	MACS_peak_13321	306.6	367	0	1	0	gen
3	40137253	40137540	MACS_peak_13322	91.5	287	0	1	0	gen
3	40317118	40317458	MACS_peak_13324	919.5	340	0	0	1	other
3	40327619	40327915	MACS_peak_13325	1940.72	296	0	0	1	other
3	40580454	40580798	MACS_peak_13326	419.18	344	0	0	0	intergen
3	40859784	40860030	MACS_peak_13327	386.6	246	0	0	1	other
3	40870090	40870322	MACS_peak_13328	532.66	232	0	0	0	intergen
3	40896303	40896650	MACS_peak_13329	417.69	347	0	0	0	intergen
3	40904727	40905190	MACS_peak_13330	50.94	463	0	0	0	intergen
3	41203033	41203252	MACS_peak_13331	1061.85	219	0	1	0	gen
3	41378270	41378596	MACS_peak_13332	243.49	326	0	1	0	gen
3	41695771	41696090	MACS_peak_13333	389.76	319	0	1	0	gen
3	41716637	41716829	MACS_peak_13334	678.9	192	0	1	0	gen
3	41735970	41736212	MACS_peak_13335	144.13	242	0	1	0	gen
3	41746266	41746439	MACS_peak_13336	1128.59	173	0	1	0	gen
3	41881344	41881560	MACS_peak_13337	644.42	216	0	1	0	gen
3	41935101	41935323	MACS_peak_13338	831.64	222	0	1	0	gen
3	42788114	42788304	MACS_peak_13339	695.57	190	1	1	1	promoter
3	42848109	42848330	MACS_peak_13340	227.89	221	0	3	2	gen
3	42921999	42922378	MACS_peak_13342	66.96	379	0	2	0	gen
3	43069728	43070210	MACS_peak_13343	88.78	482	0	0	0	intergen
3	43488876	43489181	MACS_peak_13344	104.57	305	0	1	0	gen
3	43503042	43503458	MACS_peak_13345	732.46	416	0	1	0	gen
3	43638589	43638822	MACS_peak_13346	532.66	233	0	1	0	gen
3	43681010	43681261	MACS_peak_13347	234.8	251	0	1	0	gen
3	43730387	43730519	MACS_peak_13348	1116.4	132	0	1	0	gen
3	44323374	44323673	MACS_peak_13349	1242.54	299	0	1	0	gen
3	45037781	45038151	MACS_peak_13350	482.49	370	0	0	0	intergen
3	45040822	45041096	MACS_peak_13351	847.52	274	0	0	0	intergen
3	45705391	45705645	MACS_peak_13352	883.81	254	0	1	0	gen
3	45929113	45929333	MACS_peak_13353	564.54	220	0	1	0	gen
3	46372595	46372837	MACS_peak_13355	645.81	242	1	0	1	promoter
3	46783255	46783628	MACS_peak_13356	81.56	373	0	2	0	gen
3	46866828	46867072	MACS_peak_13357	501.16	244	0	1	0	gen
3	46923566	46923740	MACS_peak_13358	780.06	174	1	0	0	promoter
3	47421161	47421360	MACS_peak_13359	645.81	199	0	1	0	gen
3	47468405	47468736	MACS_peak_13360	67.49	331	0	1	0	gen
3	47990087	47990264	MACS_peak_13361	763.02	177	0	1	0	gen
3	48239424	48239560	MACS_peak_13362	783.1	136	1	0	0	promoter
3	48436000	48436297	MACS_peak_13363	1101.6	297	2	0	0	promoter
3	48952636	48952896	MACS_peak_13364	593.56	260	0	1	0	gen
3	49010260	49010440	MACS_peak_13365	583.31	180	1	0	0	promoter
3	49464593	49464938	MACS_peak_13366	312.33	345	1	0	0	promoter
3	49839300	49839493	MACS_peak_13368	866.35	193	0	1	0	gen
3	50211465	50211692	MACS_peak_13369	224.15	227	0	1	0	gen
3	50226146	50226362	MACS_peak_13370	528	216	1	0	0	promoter
3	50246253	50246462	MACS_peak_13371	606	209	0	1	0	gen
3	50616010	50616214	MACS_peak_13372	1358.26	204	1	0	0	promoter
3	50742542	50742892	MACS_peak_13373	84.72	350	0	1	0	gen
3	50869241	50869394	MACS_peak_13374	372.4	153	0	1	0	gen
3	50909103	50909374	MACS_peak_13375	341.55	271	0	1	0	gen
3	50971526	50971748	MACS_peak_13376	511.99	222	0	1	0	gen
3	51199550	51199920	MACS_peak_13377	117.57	370	0	1	0	gen
3	51201587	51201946	MACS_peak_13378	60.94	359	0	1	0	gen
3	51289778	51290188	MACS_peak_13380	181.04	410	0	1	0	gen
3	51365340	51365722	MACS_peak_13381	62.38	382	0	1	0	gen
3	51366526	51366925	MACS_peak_13382	55.51	399	0	1	0	gen
3	52447095	52447346	MACS_peak_13383	485.56	251	1	0	0	promoter
3	52859427	52859636	MACS_peak_13384	725.36	209	0	2	0	gen
3	53691645	53692021	MACS_peak_13385	506.92	376	0	1	0	gen
3	53923802	53924058	MACS_peak_13386	56.38	256	0	0	0	intergen
3	53938716	53938941	MACS_peak_13387	1358.26	225	0	0	0	intergen
3	54287370	54287740	MACS_peak_13388	50.92	370	0	1	0	gen
3	54287925	54288189	MACS_peak_13389	112.1	264	0	1	0	gen
3	54394466	54394861	MACS_peak_13390	98.08	395	0	1	0	gen
3	54397616	54398034	MACS_peak_13391	54.4	418	0	1	0	gen
3	54428360	54428744	MACS_peak_13392	754.42	384	0	1	0	gen
3	54433918	54434132	MACS_peak_13393	746.04	214	0	1	0	gen
3	54461365	54461659	MACS_peak_13394	56.76	294	0	1	0	gen
3	54804705	54804974	MACS_peak_13395	68.03	269	0	1	0	gen
3	54840602	54840807	MACS_peak_13397	747.75	205	0	1	0	gen
3	55249039	55249266	MACS_peak_13398	1511.05	227	0	0	0	intergen
3	55393927	55394263	MACS_peak_13399	56.38	336	0	0	0	intergen
3	55449642	55449862	MACS_peak_13400	729.14	220	0	0	0	intergen
3	56218150	56218436	MACS_peak_13401	131.92	286	0	1	0	gen
3	56579214	56579526	MACS_peak_13402	76.3	312	0	1	0	gen
3	56702503	56702825	MACS_peak_13403	549.27	322	0	0	0	intergen
3	56947184	56947550	MACS_peak_13404	73.5	366	0	1	1	gen
3	57100008	57100313	MACS_peak_13406	439.84	305	0	1	0	gen
3	57127132	57127486	MACS_peak_13407	761.56	354	0	1	0	gen
3	57329373	57329831	MACS_peak_13408	58.18	458	0	1	0	gen
3	57434147	57434374	MACS_peak_13409	548.55	227	0	1	0	gen
3	57480301	57480524	MACS_peak_13410	119.34	223	0	1	0	gen
3	57608308	57608741	MACS_peak_13411	147.59	433	0	0	0	intergen
3	57824406	57824676	MACS_peak_13412	546.29	270	0	1	0	gen
3	57885662	57885999	MACS_peak_13413	293.19	337	0	1	0	gen
3	58510529	58510669	MACS_peak_13414	1025.76	140	0	1	0	gen
3	58565328	58565538	MACS_peak_13415	624.46	210	1	0	0	promoter
3	58807673	58807951	MACS_peak_13416	158.81	278	0	1	0	gen
3	58820681	58821024	MACS_peak_13417	53.46	343	0	1	0	gen
3	58845017	58845442	MACS_peak_13419	51.67	425	0	1	1	gen
3	58852323	58852694	MACS_peak_13420	166.23	371	0	1	1	gen
3	58934703	58935001	MACS_peak_13421	68.74	298	0	1	1	gen
3	58994775	58995040	MACS_peak_13422	464.09	265	0	1	1	gen
3	59215146	59215510	MACS_peak_13423	362.61	364	0	0	0	intergen
3	59221695	59222056	MACS_peak_13424	62.38	361	0	0	0	intergen
3	59357602	59357997	MACS_peak_13425	75.01	395	0	0	0	intergen
3	59492363	59492825	MACS_peak_13426	65.22	462	0	0	1	other
3	59616845	59617169	MACS_peak_13427	72.18	324	0	0	0	intergen
3	59627313	59627557	MACS_peak_13428	160.58	244	0	0	0	intergen
3	60652637	60652854	MACS_peak_13429	442.02	217	0	1	0	gen
3	61628209	61628562	MACS_peak_13430	114.74	353	0	1	0	gen
3	61802019	61802151	MACS_peak_13431	844.97	132	0	1	0	gen
3	61878595	61879017	MACS_peak_13434	386.11	422	0	1	0	gen
3	61966008	61966247	MACS_peak_13437	1284.45	239	0	1	0	gen
3	61972032	61972224	MACS_peak_13438	445.84	192	0	1	0	gen
3	62130673	62130953	MACS_peak_13440	368.38	280	0	1	0	gen
3	62131566	62132008	MACS_peak_13441	889.09	442	0	1	0	gen
3	62151519	62151749	MACS_peak_13442	654.46	230	0	1	0	gen
3	62188850	62189267	MACS_peak_13443	1653.29	417	0	1	0	gen
3	62229873	62230171	MACS_peak_13445	439.97	298	0	1	0	gen
3	62332850	62333184	MACS_peak_13446	1628.4	334	0	1	1	gen
3	62352218	62352539	MACS_peak_13447	775.34	321	0	0	1	other
3	62561076	62561236	MACS_peak_13451	1072.88	160	0	1	0	gen
3	62599487	62599923	MACS_peak_13452	1860.19	436	0	1	0	gen
3	62663180	62663393	MACS_peak_13453	438.69	213	0	1	0	gen
3	62922001	62922380	MACS_peak_13456	349.84	379	0	0	0	intergen
3	62942632	62943044	MACS_peak_13457	758.66	412	0	0	0	intergen
3	63017602	63018050	MACS_peak_13458	163.76	448	0	0	1	other
3	63058066	63058492	MACS_peak_13459	449.66	426	0	0	1	other
3	63142713	63143025	MACS_peak_13460	95.09	312	0	0	0	intergen
3	63193660	63193988	MACS_peak_13461	1823.93	328	0	0	0	intergen
3	63228567	63229049	MACS_peak_13462	1278.7	482	1	0	0	promoter
3	63242999	63243292	MACS_peak_13464	1551.26	293	0	1	0	gen
3	63333748	63334132	MACS_peak_13465	893.58	384	0	1	0	gen
3	63336415	63336552	MACS_peak_13466	1197.14	137	0	1	0	gen
3	63341884	63342283	MACS_peak_13467	483.21	399	0	1	0	gen
3	63349441	63349906	MACS_peak_13468	890.63	465	0	1	0	gen
3	63351168	63351498	MACS_peak_13469	967.33	330	0	1	0	gen
3	63364825	63365230	MACS_peak_13470	924.5	405	0	1	0	gen
3	63380648	63380986	MACS_peak_13471	69	338	0	1	0	gen
3	63396058	63396335	MACS_peak_13472	473.09	277	0	1	0	gen
3	63425631	63425797	MACS_peak_13473	685.59	166	0	1	1	gen
3	63482327	63482660	MACS_peak_13474	193.53	333	0	1	1	gen
3	63627440	63627833	MACS_peak_13475	349.84	393	0	0	0	intergen
3	63661326	63661609	MACS_peak_13476	688.53	283	0	1	0	gen
3	63735622	63735963	MACS_peak_13477	78	341	0	0	0	intergen
3	63772449	63772895	MACS_peak_13479	83.62	446	0	0	1	other
3	63820578	63821019	MACS_peak_13482	505.83	441	1	0	1	promoter
3	63842271	63842536	MACS_peak_13483	465.8	265	0	2	0	gen
3	63851526	63851752	MACS_peak_13484	826.97	226	0	1	0	gen
3	63889360	63889661	MACS_peak_13485	2496.33	301	0	1	1	gen
3	63961798	63962131	MACS_peak_13486	424.75	333	0	2	0	gen
3	63992983	63993307	MACS_peak_13487	174.17	324	0	2	0	gen
3	64014510	64014781	MACS_peak_13489	1307.61	271	1	0	1	promoter
3	64016046	64016307	MACS_peak_13490	161.92	261	0	1	0	gen
3	64021992	64022277	MACS_peak_13491	331.88	285	0	1	0	gen
3	64025899	64026355	MACS_peak_13493	1994.86	456	0	0	0	intergen
3	64030548	64030987	MACS_peak_13494	1145.3	439	0	0	0	intergen
3	64031467	64031849	MACS_peak_13495	109.38	382	0	0	0	intergen
3	64033205	64033569	MACS_peak_13496	134.52	364	0	0	0	intergen
3	64074700	64074947	MACS_peak_13497	267.43	247	0	0	1	other
3	64119365	64119563	MACS_peak_13499	463.62	198	0	1	0	gen
3	64123054	64123445	MACS_peak_13500	315.47	391	0	1	0	gen
3	64166638	64167031	MACS_peak_13501	1689.5	393	0	1	0	gen
3	64175573	64175904	MACS_peak_13502	213.29	331	0	1	0	gen
3	64177013	64177150	MACS_peak_13503	873.57	137	0	1	0	gen
3	64178543	64178910	MACS_peak_13504	147.46	367	0	1	0	gen
3	64179162	64179511	MACS_peak_13505	283.77	349	0	1	0	gen
3	64182795	64183128	MACS_peak_13506	118.95	333	0	1	0	gen
3	64244375	64244762	MACS_peak_13507	2218.24	387	0	1	0	gen
3	64262552	64262902	MACS_peak_13508	327.74	350	0	1	0	gen
3	64298391	64298825	MACS_peak_13509	257.88	434	0	1	0	gen
3	64329178	64329392	MACS_peak_13511	252.75	214	0	1	0	gen
3	64342934	64343223	MACS_peak_13512	211.21	289	0	1	0	gen
3	64371992	64372344	MACS_peak_13513	388.33	352	0	1	0	gen
3	64376500	64376895	MACS_peak_13514	310.82	395	0	1	0	gen
3	64399061	64399524	MACS_peak_13515	3100	463	0	1	0	gen
3	64417315	64417720	MACS_peak_13516	311.51	405	0	1	0	gen
3	64423766	64424092	MACS_peak_13517	915.46	326	0	1	0	gen
3	64484414	64484803	MACS_peak_13520	1855.02	389	0	0	0	intergen
3	64533586	64533944	MACS_peak_13522	1869.63	358	0	1	0	gen
3	64560985	64561337	MACS_peak_13523	120.16	352	0	1	0	gen
3	64562445	64562694	MACS_peak_13524	177.23	249	0	1	1	gen
3	64569916	64570316	MACS_peak_13525	161.27	400	0	1	1	gen
3	64588776	64588944	MACS_peak_13527	412.51	168	0	1	1	gen
3	64589060	64589401	MACS_peak_13528	168.15	341	0	1	1	gen
3	64609714	64610047	MACS_peak_13529	180.31	333	0	1	0	gen
3	64673667	64674046	MACS_peak_13530	164.39	379	0	1	0	gen
3	64674091	64674423	MACS_peak_13531	127.5	332	0	1	0	gen
3	64685751	64686030	MACS_peak_13532	337.15	279	0	1	1	gen
3	64695096	64695477	MACS_peak_13533	169.37	381	0	0	1	other
3	64696411	64696566	MACS_peak_13534	368.67	155	0	0	1	other
3	64706697	64707110	MACS_peak_13535	465.64	413	0	0	1	other
3	64720216	64720498	MACS_peak_13537	245.14	282	0	0	1	other
3	64733333	64733595	MACS_peak_13538	196.37	262	0	0	1	other
3	64829937	64830297	MACS_peak_13541	218.69	360	0	0	1	other
3	64849321	64849684	MACS_peak_13542	240.61	363	0	0	1	other
3	64903515	64903781	MACS_peak_13543	2583.33	266	0	0	1	other
3	64965867	64966092	MACS_peak_13544	506.03	225	0	0	1	other
3	64982308	64982712	MACS_peak_13545	93.93	404	0	0	1	other
3	65124954	65125215	MACS_peak_13546	79.31	261	0	0	0	intergen
3	65352110	65352323	MACS_peak_13547	596.79	213	1	0	0	promoter
3	65509639	65510000	MACS_peak_13548	75.61	361	0	1	0	gen
3	65569899	65570195	MACS_peak_13550	445	296	0	1	0	gen
3	65698923	65699286	MACS_peak_13551	58.53	363	0	1	0	gen
3	65785007	65785459	MACS_peak_13552	592.28	452	0	1	0	gen
3	66138615	66138994	MACS_peak_13553	515.71	379	0	1	0	gen
3	66236233	66236538	MACS_peak_13554	686.76	305	0	1	0	gen
3	66594738	66594905	MACS_peak_13556	746.5	167	0	0	0	intergen
3	66848159	66848478	MACS_peak_13557	159.64	319	0	0	0	intergen
3	66917576	66917950	MACS_peak_13558	65.9	374	0	0	0	intergen
3	67151834	67152187	MACS_peak_13559	69.8	353	0	0	0	intergen
3	67279440	67279760	MACS_peak_13560	109.53	320	0	0	0	intergen
3	67396872	67397264	MACS_peak_13561	75.42	392	0	1	0	gen
3	68123774	68124008	MACS_peak_13562	1429.94	234	0	1	0	gen
3	68259548	68259929	MACS_peak_13563	137.06	381	0	1	0	gen
3	68805446	68805829	MACS_peak_13564	65.81	383	0	1	0	gen
3	68812961	68813305	MACS_peak_13565	65.53	344	0	1	0	gen
3	68876163	68876507	MACS_peak_13566	834.03	344	0	1	0	gen
3	68972460	68972837	MACS_peak_13567	403.51	377	1	0	0	promoter
3	69061914	69062099	MACS_peak_13568	901.33	185	0	1	0	gen
3	69161658	69161902	MACS_peak_13569	780.06	244	0	0	0	intergen
3	69337117	69337512	MACS_peak_13570	63.13	395	0	1	0	gen
3	69343566	69343704	MACS_peak_13571	1212.34	138	0	1	0	gen
3	69425408	69425682	MACS_peak_13572	458.32	274	0	1	0	gen
3	69671143	69671435	MACS_peak_13573	966.8	292	0	0	0	intergen
3	69755332	69755578	MACS_peak_13574	453.76	246	0	1	0	gen
3	69792991	69793129	MACS_peak_13575	682.8	138	0	1	0	gen
3	69842197	69842416	MACS_peak_13576	1061.85	219	0	1	0	gen
3	69919952	69920281	MACS_peak_13577	429.01	329	0	1	0	gen
3	70006957	70007127	MACS_peak_13579	425.96	170	0	0	1	other
3	70009183	70009521	MACS_peak_13580	116.45	338	0	0	1	other
3	70018410	70018763	MACS_peak_13581	96.97	353	0	0	1	other
3	70090383	70090602	MACS_peak_13582	729.14	219	0	0	1	other
3	70285620	70285978	MACS_peak_13583	127.15	358	0	1	1	gen
3	70449235	70449560	MACS_peak_13584	95.12	325	0	0	1	other
3	70815653	70815937	MACS_peak_13585	704	284	0	0	0	intergen
3	70979267	70979414	MACS_peak_13586	649.42	147	0	2	0	gen
3	71859291	71859495	MACS_peak_13587	629.38	204	0	0	0	intergen
3	72045362	72045806	MACS_peak_13588	714.62	444	0	0	1	other
3	72570604	72570807	MACS_peak_13589	629.38	203	0	0	0	intergen
3	72748233	72748367	MACS_peak_13590	1098.16	134	1	0	0	promoter
3	72946282	72946416	MACS_peak_13591	1330.81	134	0	1	0	gen
3	73191289	73191423	MACS_peak_13592	1072.4	134	0	0	0	intergen
3	73373049	73373413	MACS_peak_13593	115.26	364	0	0	0	intergen
3	73416777	73416914	MACS_peak_13594	567.81	137	0	1	0	gen
3	73508423	73508641	MACS_peak_13595	580.62	218	0	1	0	gen
3	73843501	73843745	MACS_peak_13596	123.23	244	0	0	1	other
3	73848251	73848497	MACS_peak_13597	983.12	246	0	0	1	other
3	73913140	73913507	MACS_peak_13598	408.1	367	0	0	0	intergen
3	73921397	73921780	MACS_peak_13599	193.63	383	0	0	0	intergen
3	74735041	74735237	MACS_peak_13600	668.89	196	0	0	0	intergen
3	75001431	75001664	MACS_peak_13601	627.26	233	0	0	0	intergen
3	75094312	75094667	MACS_peak_13602	103.15	355	0	0	0	intergen
3	75097201	75097558	MACS_peak_13603	91.77	357	0	0	0	intergen
3	75258861	75259118	MACS_peak_13604	595.98	257	0	0	0	intergen
3	75422011	75422441	MACS_peak_13606	1104.71	430	0	0	1	other
3	75429727	75429973	MACS_peak_13607	629.38	246	0	0	1	other
3	75723443	75723787	MACS_peak_13609	316.58	344	0	1	0	gen
3	75818006	75818335	MACS_peak_13610	306.6	329	0	0	0	intergen
3	76024694	76025002	MACS_peak_13611	488.85	308	0	1	0	gen
3	76045086	76045270	MACS_peak_13612	729.14	184	0	1	0	gen
3	76108010	76108249	MACS_peak_13613	645.81	239	0	1	0	gen
3	76374701	76374978	MACS_peak_13615	380.3	277	0	1	0	gen
3	76524724	76525072	MACS_peak_13616	417.2	348	0	1	0	gen
3	76570459	76570929	MACS_peak_13617	1471.44	470	0	1	0	gen
3	76672515	76672725	MACS_peak_13618	607.01	210	0	1	0	gen
3	76746197	76746600	MACS_peak_13619	236.98	403	0	1	0	gen
3	76776655	76776846	MACS_peak_13620	666.79	191	0	1	0	gen
3	76890093	76890271	MACS_peak_13621	714.45	178	0	1	0	gen
3	77022377	77022596	MACS_peak_13622	708.51	219	0	1	0	gen
3	77104650	77104842	MACS_peak_13623	866.35	192	0	1	0	gen
3	77158389	77158557	MACS_peak_13624	814.37	168	0	1	0	gen
3	77625094	77625273	MACS_peak_13626	954.29	179	0	1	0	gen
3	77641740	77641966	MACS_peak_13627	848.95	226	0	1	0	gen
3	77767837	77768169	MACS_peak_13628	68.72	332	0	0	0	intergen
3	77965243	77965643	MACS_peak_13629	105.65	400	0	0	0	intergen
3	78038858	78039111	MACS_peak_13630	378.3	253	0	0	1	other
3	78066346	78066524	MACS_peak_13631	763.02	178	0	0	0	intergen
3	78148746	78148929	MACS_peak_13632	918.92	183	0	0	0	intergen
3	78152792	78152925	MACS_peak_13633	1098.16	133	0	0	0	intergen
3	78266122	78266526	MACS_peak_13634	906.56	404	0	0	0	intergen
3	78286949	78287156	MACS_peak_13635	613.04	207	0	0	1	other
3	78313468	78313771	MACS_peak_13636	440.97	303	0	0	0	intergen
3	78493119	78493415	MACS_peak_13637	157.36	296	0	0	0	intergen
3	78582286	78582708	MACS_peak_13638	136.18	422	0	0	0	intergen
3	78645849	78646054	MACS_peak_13639	629.38	205	0	1	0	gen
3	78659456	78659746	MACS_peak_13640	680.29	290	0	1	0	gen
3	78842328	78842631	MACS_peak_13641	819.69	303	0	1	0	gen
3	78914265	78914514	MACS_peak_13642	497.05	249	0	1	0	gen
3	78914976	78915244	MACS_peak_13643	533.6	268	0	1	0	gen
3	78916160	78916376	MACS_peak_13644	682.16	216	0	1	0	gen
3	78988309	78988606	MACS_peak_13645	565.98	297	0	1	0	gen
3	79213306	79213760	MACS_peak_13646	866.8	454	0	1	0	gen
3	79497567	79497893	MACS_peak_13647	1130.66	326	0	1	0	gen
3	79531895	79532188	MACS_peak_13648	965.74	293	0	1	0	gen
3	79575283	79575647	MACS_peak_13649	380.3	364	0	1	0	gen
3	79612589	79612920	MACS_peak_13650	52.99	331	0	1	0	gen
3	79735722	79736008	MACS_peak_13651	277.16	286	0	1	0	gen
3	79864443	79864723	MACS_peak_13652	406.81	280	0	0	0	intergen
3	80021232	80021426	MACS_peak_13654	678.9	194	0	0	0	intergen
3	80461544	80462021	MACS_peak_13655	695.04	477	0	0	0	intergen
3	80588561	80588913	MACS_peak_13656	69	352	0	0	0	intergen
3	80688958	80689214	MACS_peak_13657	729.14	256	0	0	0	intergen
3	80785460	80785771	MACS_peak_13658	380.66	311	0	0	2	other
3	80837425	80837825	MACS_peak_13659	78.9	400	0	0	0	intergen
3	80861472	80861850	MACS_peak_13660	96.97	378	0	0	0	intergen
3	80876398	80876800	MACS_peak_13661	91.15	402	0	0	0	intergen
3	80891832	80892147	MACS_peak_13662	76.3	315	0	0	0	intergen
3	80965302	80965701	MACS_peak_13664	135.16	399	0	0	0	intergen
3	81006092	81006324	MACS_peak_13665	688.92	232	0	0	1	other
3	81010491	81010762	MACS_peak_13666	142.05	271	0	0	1	other
3	81302040	81302376	MACS_peak_13667	759.11	336	0	0	0	intergen
3	81339078	81339334	MACS_peak_13668	580.75	256	0	0	0	intergen
3	81419208	81419498	MACS_peak_13669	570.92	290	0	0	0	intergen
3	81490471	81490887	MACS_peak_13670	867.3	416	1	0	0	promoter
3	81611437	81611684	MACS_peak_13671	1180.64	247	0	1	0	gen
3	81643841	81644016	MACS_peak_13672	780.06	175	0	1	0	gen
3	81666540	81666794	MACS_peak_13673	1171.45	254	0	1	0	gen
3	81737234	81737477	MACS_peak_13674	429.06	243	0	1	0	gen
3	81882883	81883172	MACS_peak_13675	85.49	289	0	0	1	other
3	81910111	81910493	MACS_peak_13676	401.26	382	0	0	1	other
3	82109447	82109746	MACS_peak_13677	125.27	299	0	0	1	other
3	82133050	82133327	MACS_peak_13678	580.42	277	0	0	1	other
3	82153517	82153983	MACS_peak_13679	52.04	466	0	0	1	other
3	82297944	82298231	MACS_peak_13680	211.5	287	0	0	1	other
3	82329376	82329656	MACS_peak_13682	408.96	280	0	0	1	other
3	82400973	82401316	MACS_peak_13684	55.36	343	0	0	1	other
3	82423114	82423395	MACS_peak_13685	453.96	281	0	0	1	other
3	82464534	82464980	MACS_peak_13686	595.47	446	0	0	0	intergen
3	82497212	82497657	MACS_peak_13687	596.01	445	0	0	0	intergen
3	82915231	82915549	MACS_peak_13688	498.48	318	0	0	0	intergen
3	82971087	82971430	MACS_peak_13689	164.26	343	0	0	0	intergen
3	83007962	83008181	MACS_peak_13690	729.14	219	0	0	0	intergen
3	83102970	83103220	MACS_peak_13691	647.94	250	0	0	0	intergen
3	83270666	83270941	MACS_peak_13692	834.03	275	0	0	0	intergen
3	83591804	83592141	MACS_peak_13693	380.3	337	0	0	0	intergen
3	83747717	83748040	MACS_peak_13695	150.64	323	0	0	0	intergen
3	83928440	83928691	MACS_peak_13696	485.56	251	0	0	0	intergen
3	84114582	84114854	MACS_peak_13697	459.58	272	0	0	0	intergen
3	84420844	84421215	MACS_peak_13698	79.7	371	0	0	0	intergen
3	84686376	84686729	MACS_peak_13699	89.02	353	0	0	1	other
3	84825934	84826158	MACS_peak_13700	564.54	224	0	0	1	other
3	84865830	84866048	MACS_peak_13701	827.31	218	0	0	1	other
3	84889731	84890045	MACS_peak_13702	50.92	314	0	0	1	other
3	85215259	85215492	MACS_peak_13703	416.25	233	0	1	0	gen
3	85294983	85295381	MACS_peak_13704	104.01	398	0	1	0	gen
3	85868540	85868790	MACS_peak_13706	746.04	250	0	1	0	gen
3	85916645	85917014	MACS_peak_13707	62.37	369	0	1	0	gen
3	86468139	86468353	MACS_peak_13708	452.38	214	0	0	0	intergen
3	86563454	86563703	MACS_peak_13709	485.56	249	0	0	0	intergen
3	86702384	86702695	MACS_peak_13710	560.1	311	0	0	0	intergen
3	86819498	86819949	MACS_peak_13711	732.22	451	0	0	0	intergen
3	87006906	87007156	MACS_peak_13713	1189.9	250	0	0	0	intergen
3	87095945	87096360	MACS_peak_13714	129.02	415	0	0	1	other
3	87206746	87207061	MACS_peak_13715	1236.43	315	0	0	0	intergen
3	87298217	87298465	MACS_peak_13716	485.56	248	0	0	0	intergen
3	87333349	87333590	MACS_peak_13717	1569.18	241	0	0	0	intergen
3	87343155	87343366	MACS_peak_13718	104.5	211	0	0	0	intergen
3	87350666	87350903	MACS_peak_13719	745.98	237	0	0	0	intergen
3	87403216	87403492	MACS_peak_13720	136.23	276	0	0	0	intergen
3	87407858	87408107	MACS_peak_13721	414.39	249	0	0	0	intergen
3	87450845	87451225	MACS_peak_13722	757.3	380	0	0	0	intergen
3	87503793	87504230	MACS_peak_13723	376.36	437	0	0	0	intergen
3	87751834	87752042	MACS_peak_13724	432	208	0	0	1	other
3	87849195	87849579	MACS_peak_13725	65.9	384	0	0	0	intergen
3	88003170	88003448	MACS_peak_13726	843.51	278	0	0	0	intergen
3	88005158	88005470	MACS_peak_13727	555.79	312	0	0	0	intergen
3	88203261	88203686	MACS_peak_13728	843.52	425	0	0	0	intergen
3	88304225	88304463	MACS_peak_13730	177.91	238	0	0	0	intergen
3	88550964	88551230	MACS_peak_13731	54.39	266	0	0	0	intergen
3	88552693	88553067	MACS_peak_13732	66.97	374	0	0	0	intergen
3	88558896	88559184	MACS_peak_13733	84.4	288	0	0	0	intergen
3	88678572	88678875	MACS_peak_13734	688.35	303	0	0	0	intergen
3	88778835	88779097	MACS_peak_13735	265.34	262	0	0	0	intergen
3	89245890	89246169	MACS_peak_13737	353.52	279	0	1	0	gen
3	89348851	89349296	MACS_peak_13739	72.56	445	0	1	0	gen
3	89749147	89749465	MACS_peak_13741	74.3	318	0	0	0	intergen
3	89872962	89873191	MACS_peak_13742	65.12	229	0	0	0	intergen
3	90093102	90093397	MACS_peak_13743	528.04	295	0	0	0	intergen
3	90156753	90157160	MACS_peak_13744	121.95	407	0	0	0	intergen
3	90182587	90182869	MACS_peak_13745	1413.23	282	0	0	0	intergen
3	90258184	90258318	MACS_peak_13746	583.66	134	0	0	0	intergen
3	90264169	90264612	MACS_peak_13747	186.49	443	0	0	0	intergen
3	90289374	90289597	MACS_peak_13748	141.49	223	0	0	0	intergen
3	90307437	90307800	MACS_peak_13749	80.07	363	0	0	0	intergen
3	90352397	90352613	MACS_peak_13750	130.72	216	0	0	0	intergen
3	90367343	90367767	MACS_peak_13751	64.12	424	0	0	0	intergen
3	90384928	90385260	MACS_peak_13752	50.92	332	0	0	0	intergen
3	90388800	90389045	MACS_peak_13753	98.02	245	0	0	0	intergen
3	90399692	90399915	MACS_peak_13755	152.5	223	0	0	0	intergen
3	90403318	90403574	MACS_peak_13756	69	256	0	0	0	intergen
3	90403978	90404210	MACS_peak_13757	396.99	232	0	0	0	intergen
3	90405220	90405547	MACS_peak_13758	132.22	327	0	0	0	intergen
3	90406216	90406490	MACS_peak_13759	57.47	274	0	0	0	intergen
3	90408777	90409022	MACS_peak_13760	61.51	245	0	0	0	intergen
3	90415190	90415563	MACS_peak_13761	107.03	373	0	0	0	intergen
3	90415777	90416087	MACS_peak_13762	80.2	310	0	0	0	intergen
3	90416208	90416665	MACS_peak_13763	336.98	457	0	0	0	intergen
3	90421614	90421905	MACS_peak_13765	194.77	291	0	0	0	intergen
3	90437131	90437344	MACS_peak_13768	72.28	213	0	0	0	intergen
3	90440252	90440591	MACS_peak_13769	82.39	339	0	0	0	intergen
3	90441728	90441973	MACS_peak_13770	246.87	245	0	0	0	intergen
3	90443922	90444302	MACS_peak_13771	98.68	380	0	0	0	intergen
3	90445446	90445715	MACS_peak_13772	290.03	269	0	0	0	intergen
3	90449666	90449923	MACS_peak_13773	100.89	257	0	0	0	intergen
3	93796117	93796362	MACS_peak_13774	149.09	245	0	0	0	intergen
3	93837263	93837526	MACS_peak_13775	62.38	263	0	0	0	intergen
3	93841790	93841996	MACS_peak_13776	887.94	206	0	0	0	intergen
3	94004376	94004597	MACS_peak_13777	549.18	221	0	1	0	gen
3	94069334	94069779	MACS_peak_13778	737.12	445	0	1	0	gen
3	94101974	94102225	MACS_peak_13779	1189.9	251	0	1	0	gen
3	94188187	94188465	MACS_peak_13780	2551.86	278	0	0	0	intergen
3	94336373	94336666	MACS_peak_13781	965.74	293	0	0	0	intergen
3	94525138	94525393	MACS_peak_13782	470.06	255	0	0	0	intergen
3	94785761	94786003	MACS_peak_13784	487.14	242	0	0	0	intergen
3	94862732	94862986	MACS_peak_13785	425.33	254	0	0	0	intergen
3	94929740	94930066	MACS_peak_13786	932.56	326	0	0	0	intergen
3	95108303	95108503	MACS_peak_13787	1189.9	200	0	0	1	other
3	95521414	95521868	MACS_peak_13789	2473.16	454	0	0	0	intergen
3	95686985	95687210	MACS_peak_13790	277.81	225	0	0	0	intergen
3	95783835	95784263	MACS_peak_13791	314.21	428	0	0	0	intergen
3	95805634	95806028	MACS_peak_13792	75.01	394	0	0	0	intergen
3	96129677	96129867	MACS_peak_13793	695.57	190	0	0	0	intergen
3	96595774	96595985	MACS_peak_13794	743.63	211	0	0	0	intergen
3	96604572	96604849	MACS_peak_13795	186.07	277	0	0	0	intergen
3	96863125	96863437	MACS_peak_13798	323.3	312	0	1	0	gen
3	96937203	96937438	MACS_peak_13799	100.83	235	0	1	0	gen
3	97195957	97196201	MACS_peak_13800	463.37	244	0	1	0	gen
3	97371315	97371534	MACS_peak_13801	184.61	219	0	1	0	gen
3	97418099	97418511	MACS_peak_13802	1120.88	412	0	1	0	gen
3	97507223	97507454	MACS_peak_13803	482.83	231	0	1	0	gen
3	97544052	97544386	MACS_peak_13804	101.68	334	0	1	0	gen
3	97549037	97549286	MACS_peak_13805	436.29	249	0	1	0	gen
3	97669132	97669366	MACS_peak_13806	470	234	0	1	0	gen
3	97719268	97719543	MACS_peak_13807	1128.24	275	0	1	0	gen
3	98039375	98039599	MACS_peak_13809	866.35	224	0	0	0	intergen
3	98360120	98360550	MACS_peak_13810	489.85	430	0	0	1	other
3	98766394	98766533	MACS_peak_13812	1523.54	139	0	1	0	gen
3	98800849	98801002	MACS_peak_13813	800.14	153	0	1	0	gen
3	98817503	98817730	MACS_peak_13814	695.57	227	0	2	0	gen
3	98994265	98994466	MACS_peak_13815	645.81	201	0	0	1	other
3	99039702	99040071	MACS_peak_13816	97.82	369	0	0	0	intergen
3	99060597	99061012	MACS_peak_13817	67.86	415	0	0	0	intergen
3	99155142	99155430	MACS_peak_13818	380.3	288	0	0	0	intergen
3	99244507	99244857	MACS_peak_13819	68.83	350	0	0	0	intergen
3	99284850	99284990	MACS_peak_13820	551.66	140	0	0	0	intergen
3	99499158	99499459	MACS_peak_13821	1386.14	301	0	0	0	intergen
3	99551649	99551889	MACS_peak_13822	645.81	240	0	0	0	intergen
3	99680477	99680806	MACS_peak_13823	89.02	329	0	1	0	gen
3	99687104	99687304	MACS_peak_13824	1189.9	200	0	1	0	gen
3	99753496	99753856	MACS_peak_13825	488.85	360	0	1	0	gen
3	99843294	99843587	MACS_peak_13826	965.74	293	0	2	0	gen
3	100068818	100069138	MACS_peak_13827	550.56	320	0	2	0	gen
3	100069773	100070050	MACS_peak_13828	312.33	277	0	2	0	gen
3	100186028	100186162	MACS_peak_13829	1666.76	134	0	0	1	other
3	100283226	100283387	MACS_peak_13830	866.35	161	0	1	0	gen
3	100462934	100463215	MACS_peak_13831	561.46	281	0	0	0	intergen
3	100513900	100514372	MACS_peak_13832	60.31	472	0	1	0	gen
3	100546448	100546694	MACS_peak_13833	436.8	246	0	1	0	gen
3	100618116	100618408	MACS_peak_13834	84.4	292	0	1	0	gen
3	101113863	101114295	MACS_peak_13835	137.06	432	0	0	0	intergen
3	101234101	101234422	MACS_peak_13836	380.3	321	0	1	0	gen
3	101537486	101537702	MACS_peak_13837	133.76	216	0	0	0	intergen
3	101573598	101573960	MACS_peak_13838	770.64	362	1	0	0	promoter
3	101578776	101579120	MACS_peak_13839	722.05	344	0	0	0	intergen
3	101699554	101699805	MACS_peak_13840	540.72	251	0	0	0	intergen
3	101707380	101707654	MACS_peak_13841	1871.42	274	0	0	0	intergen
3	101907261	101907650	MACS_peak_13843	219.35	389	0	0	0	intergen
3	102033744	102034049	MACS_peak_13844	439.84	305	0	0	0	intergen
3	102375712	102376042	MACS_peak_13846	528.29	330	0	1	0	gen
3	102467083	102467332	MACS_peak_13847	485.56	249	0	1	0	gen
3	102562574	102562713	MACS_peak_13848	1298.51	139	0	0	0	intergen
3	102673542	102673851	MACS_peak_13849	814.28	309	0	0	1	other
3	102718590	102718746	MACS_peak_13850	808.51	156	0	0	0	intergen
3	102770307	102770555	MACS_peak_13851	596.67	248	0	0	0	intergen
3	102776698	102777062	MACS_peak_13852	56.38	364	0	0	0	intergen
3	102820927	102821159	MACS_peak_13853	323.97	232	0	0	0	intergen
3	103556784	103557039	MACS_peak_13854	92.87	255	0	0	0	intergen
3	103557118	103557344	MACS_peak_13855	62.14	226	0	0	0	intergen
3	103710924	103711297	MACS_peak_13856	54.81	373	0	0	0	intergen
3	103875896	103876137	MACS_peak_13857	517.94	241	0	0	0	intergen
3	103991536	103991753	MACS_peak_13858	1245.57	217	0	0	0	intergen
3	104091294	104091614	MACS_peak_13859	737.12	320	0	0	0	intergen
3	104240168	104240395	MACS_peak_13860	442.89	227	0	0	0	intergen
3	104318578	104318757	MACS_peak_13861	699.69	179	0	0	0	intergen
3	104539955	104540203	MACS_peak_13862	485.56	248	0	0	0	intergen
3	104564102	104564371	MACS_peak_13863	461.5	269	0	0	0	intergen
3	104679133	104679375	MACS_peak_13864	501.16	242	0	0	0	intergen
3	104892794	104893040	MACS_peak_13865	386.6	246	0	0	0	intergen
3	105113847	105113979	MACS_peak_13866	857.98	132	0	0	0	intergen
3	105369778	105370013	MACS_peak_13867	662.31	235	1	0	0	promoter
3	105462741	105463031	MACS_peak_13868	760.25	290	0	1	0	gen
3	105625438	105625634	MACS_peak_13869	224.32	196	0	0	0	intergen
3	105686398	105686692	MACS_peak_13870	722.05	294	0	1	0	gen
3	106072822	106073182	MACS_peak_13871	50.92	360	0	0	0	intergen
3	106301978	106302203	MACS_peak_13872	548.55	225	0	0	0	intergen
3	106357118	106357385	MACS_peak_13873	1285.66	267	0	0	0	intergen
3	106463304	106463473	MACS_peak_13874	1025.76	169	0	0	0	intergen
3	106489677	106489910	MACS_peak_13875	647.86	233	0	0	0	intergen
3	106609801	106610141	MACS_peak_13876	660.56	340	0	0	0	intergen
3	106665818	106666232	MACS_peak_13877	78.58	414	0	0	0	intergen
3	106824868	106825044	MACS_peak_13878	711.62	176	0	0	0	intergen
3	106876790	106876994	MACS_peak_13879	616.96	204	0	0	1	other
3	107091094	107091381	MACS_peak_13880	834.69	287	0	0	1	other
3	107145810	107146114	MACS_peak_13881	160.84	304	0	0	1	other
3	107206120	107206497	MACS_peak_13883	738.27	377	0	0	1	other
3	107272953	107273180	MACS_peak_13884	548.55	227	0	0	2	other
3	107583843	107584219	MACS_peak_13885	553.12	376	0	1	0	gen
3	107660448	107660777	MACS_peak_13886	1737.05	329	0	1	0	gen
3	107663507	107663723	MACS_peak_13887	901.33	216	0	1	0	gen
3	107690566	107690919	MACS_peak_13888	117.14	353	0	1	0	gen
3	107695548	107695913	MACS_peak_13889	56.07	365	0	1	0	gen
3	107741335	107741583	MACS_peak_13890	388.01	248	0	1	0	gen
3	107753549	107753769	MACS_peak_13891	564.54	220	0	1	0	gen
3	107794616	107794924	MACS_peak_13892	438.15	308	0	1	0	gen
3	107927519	107927822	MACS_peak_13894	561.84	303	0	0	1	other
3	107932683	107932923	MACS_peak_13895	936.57	240	0	0	0	intergen
3	108205618	108206067	MACS_peak_13896	959.23	449	0	1	0	gen
3	108321640	108321912	MACS_peak_13898	459.58	272	0	1	0	gen
3	108477685	108477907	MACS_peak_13900	549.18	222	0	1	0	gen
3	108674538	108674770	MACS_peak_13902	537.4	232	0	1	0	gen
3	108686062	108686276	MACS_peak_13903	596.79	214	0	1	0	gen
3	108753151	108753354	MACS_peak_13904	53.16	203	0	1	0	gen
3	109082138	109082357	MACS_peak_13906	879.27	219	0	1	0	gen
3	109164443	109164675	MACS_peak_13907	113.93	232	0	0	0	intergen
3	109200439	109200889	MACS_peak_13908	75.96	450	0	0	1	other
3	109275706	109275919	MACS_peak_13909	580.75	213	0	0	0	intergen
3	109330201	109330438	MACS_peak_13910	177.15	237	1	0	0	promoter
3	109410275	109410631	MACS_peak_13911	265.34	356	0	0	1	other
3	109543205	109543546	MACS_peak_13912	181.92	341	0	0	0	intergen
3	109731902	109732158	MACS_peak_13913	670.44	256	0	0	1	other
3	109999287	109999637	MACS_peak_13914	389.76	350	0	0	0	intergen
3	110117950	110118287	MACS_peak_13915	82.62	337	0	0	0	intergen
3	110632244	110632618	MACS_peak_13916	88.84	374	0	0	0	intergen
3	110634876	110635180	MACS_peak_13917	55.83	304	0	0	0	intergen
3	110823498	110823852	MACS_peak_13918	401.08	354	0	0	0	intergen
3	110889147	110889511	MACS_peak_13919	76.89	364	0	0	1	other
3	110911908	110912326	MACS_peak_13920	84.28	418	0	0	1	other
3	110990680	110990935	MACS_peak_13921	719.86	255	0	0	1	other
3	111020642	111021059	MACS_peak_13923	133.13	417	0	0	1	other
3	111021227	111021540	MACS_peak_13924	52.08	313	0	0	1	other
3	111080432	111080651	MACS_peak_13925	580.62	219	0	1	0	gen
3	111193901	111194069	MACS_peak_13926	814.37	168	0	1	0	gen
3	111338008	111338372	MACS_peak_13927	1031.37	364	0	1	0	gen
3	111668929	111669191	MACS_peak_13928	859.93	262	0	0	0	intergen
3	111832838	111833224	MACS_peak_13929	349.84	386	0	2	0	gen
3	112189397	112189772	MACS_peak_13931	56.38	375	0	1	0	gen
3	112205275	112205495	MACS_peak_13932	175.39	220	0	1	0	gen
3	112225255	112225630	MACS_peak_13933	404.42	375	0	1	0	gen
3	112510503	112510839	MACS_peak_13934	423.21	336	0	0	0	intergen
3	112519499	112519720	MACS_peak_13935	564.54	221	0	0	0	intergen
3	112531379	112531649	MACS_peak_13936	830.22	270	1	0	0	promoter
3	112663671	112663982	MACS_peak_13937	71.7	311	0	0	0	intergen
3	112814277	112814687	MACS_peak_13938	615.59	410	1	0	0	promoter
3	112913333	112913712	MACS_peak_13939	75.08	379	0	0	0	intergen
3	112915369	112915614	MACS_peak_13940	179.63	245	0	0	0	intergen
3	113025477	113025828	MACS_peak_13941	415.79	351	0	0	1	other
3	113288100	113288359	MACS_peak_13942	726.32	259	1	0	0	promoter
3	113577865	113578294	MACS_peak_13943	365.14	429	0	1	0	gen
3	113626690	113627141	MACS_peak_13944	1086.69	451	0	1	0	gen
3	113736501	113736833	MACS_peak_13945	425.26	332	0	1	0	gen
3	113764370	113764655	MACS_peak_13946	574.52	285	0	1	0	gen
3	113844731	113844949	MACS_peak_13947	836.95	218	0	1	0	gen
3	113887702	113887879	MACS_peak_13948	1144.35	177	0	1	0	gen
3	113912953	113913429	MACS_peak_13949	469.13	476	0	1	0	gen
3	113973742	113974035	MACS_peak_13950	722.05	293	0	1	0	gen
3	114041003	114041380	MACS_peak_13951	834.03	377	0	2	0	gen
3	114152404	114152673	MACS_peak_13952	461.5	269	0	1	0	gen
3	114383814	114384177	MACS_peak_13953	644.81	363	0	1	1	gen
3	114526905	114527297	MACS_peak_13954	508.79	392	0	1	1	gen
3	114535206	114535439	MACS_peak_13955	101.54	233	0	1	0	gen
3	114645016	114645338	MACS_peak_13956	936.39	322	0	1	0	gen
3	114712989	114713180	MACS_peak_13957	695.57	191	0	1	0	gen
3	115040657	115041108	MACS_peak_13958	957.71	451	0	1	0	gen
3	115276272	115276536	MACS_peak_13959	998.2	264	0	0	1	other
3	115427336	115427625	MACS_peak_13960	96.97	289	0	0	0	intergen
3	115482536	115482791	MACS_peak_13961	1007.8	255	0	0	0	intergen
3	115485188	115485375	MACS_peak_13962	1334.07	187	0	0	0	intergen
3	115677811	115678071	MACS_peak_13963	467.38	260	0	1	0	gen
3	115697934	115698315	MACS_peak_13964	611.86	381	0	1	0	gen
3	115784519	115784833	MACS_peak_13965	679.74	314	0	0	0	intergen
3	115814716	115815085	MACS_peak_13966	1162.63	369	0	1	0	gen
3	115837045	115837350	MACS_peak_13967	1680.37	305	0	1	0	gen
3	116140156	116140398	MACS_peak_13968	780.06	242	0	1	0	gen
3	116432011	116432164	MACS_peak_13969	918.92	153	0	1	0	gen
3	116488609	116488976	MACS_peak_13970	158.81	367	0	1	0	gen
3	116489984	116490150	MACS_peak_13971	741.54	166	0	1	0	gen
3	116699143	116699550	MACS_peak_13972	52.93	407	0	1	0	gen
3	116770913	116771209	MACS_peak_13973	603.02	296	0	1	0	gen
3	117636597	117636833	MACS_peak_13974	332.58	236	0	0	0	intergen
3	117719415	117719679	MACS_peak_13975	721.68	264	0	0	1	other
3	117738311	117738607	MACS_peak_13976	603.02	296	0	0	1	other
3	117910181	117910500	MACS_peak_13977	551.21	319	0	0	1	other
3	118062418	118062711	MACS_peak_13978	91.66	293	0	0	1	other
3	118141776	118142142	MACS_peak_13979	56.38	366	0	0	1	other
3	118311332	118311540	MACS_peak_13980	1145.34	208	0	0	1	other
3	118513866	118514111	MACS_peak_13982	780.06	245	0	0	1	other
3	118634991	118635248	MACS_peak_13983	544.73	257	0	0	0	intergen
3	119098711	119098942	MACS_peak_13984	517.97	231	0	1	0	gen
3	119145450	119145702	MACS_peak_13985	470.06	252	2	1	0	promoter
3	119387127	119387489	MACS_peak_13986	665.71	362	0	1	0	gen
3	119690216	119690383	MACS_peak_13987	1264.23	167	0	0	0	intergen
3	119821012	119821467	MACS_peak_13988	1288.68	455	1	0	0	promoter
3	119891862	119892243	MACS_peak_13989	514.63	381	0	1	0	gen
3	119954066	119954363	MACS_peak_13990	534.92	297	0	1	0	gen
3	120150935	120151198	MACS_peak_13991	229.83	263	0	0	0	intergen
3	120182932	120183187	MACS_peak_13992	379.63	255	0	1	0	gen
3	120244305	120244519	MACS_peak_13993	918.92	214	0	1	0	gen
3	120377132	120377486	MACS_peak_13994	78.38	354	0	0	1	other
3	120507282	120507605	MACS_peak_13995	429.98	323	0	0	0	intergen
3	120561336	120561578	MACS_peak_13996	501.16	242	0	0	0	intergen
3	120581265	120581598	MACS_peak_13997	61.45	333	0	0	0	intergen
3	120583387	120583682	MACS_peak_13998	115.76	295	0	0	0	intergen
3	120723544	120723940	MACS_peak_13999	54.13	396	0	1	0	gen
3	120736203	120736511	MACS_peak_14000	143.12	308	0	1	0	gen
3	120794997	120795361	MACS_peak_14001	524.01	364	0	0	0	intergen
3	120951393	120951703	MACS_peak_14003	126.18	310	0	1	0	gen
3	121032441	121032809	MACS_peak_14004	101.68	368	0	1	0	gen
3	121089868	121090143	MACS_peak_14005	373.09	275	0	1	0	gen
3	121327115	121327369	MACS_peak_14006	1026.72	254	0	1	0	gen
3	121455030	121455462	MACS_peak_14007	77.58	432	0	1	0	gen
3	121966752	121966885	MACS_peak_14009	1098.16	133	0	0	0	intergen
3	121989938	121990221	MACS_peak_14010	452.74	283	1	0	0	promoter
3	121995664	121995853	MACS_peak_14011	695.57	189	0	1	0	gen
3	122072303	122072538	MACS_peak_14012	97.66	235	0	1	0	gen
3	122101623	122101830	MACS_peak_14013	585.19	207	0	1	0	gen
3	122133664	122134041	MACS_peak_14014	91.56	377	0	0	0	intergen
3	122140561	122140926	MACS_peak_14015	66.1	365	0	0	0	intergen
3	122258886	122259231	MACS_peak_14016	657.04	345	0	1	0	gen
3	122392926	122393342	MACS_peak_14018	496.62	416	0	1	0	gen
3	122752467	122752843	MACS_peak_14019	403.97	376	0	1	0	gen
3	122942951	122943183	MACS_peak_14021	532.66	232	0	1	0	gen
3	123258711	123259179	MACS_peak_14022	469.45	468	0	1	0	gen
3	123262527	123262819	MACS_peak_14023	829.92	292	0	1	0	gen
3	123328929	123329129	MACS_peak_14024	814.37	200	0	1	0	gen
3	123555696	123555979	MACS_peak_14025	439.43	283	0	1	0	gen
3	123559077	123559357	MACS_peak_14026	707.43	280	0	1	0	gen
3	123652374	123652762	MACS_peak_14028	510.89	388	0	1	0	gen
3	123852444	123852706	MACS_peak_14029	114.74	262	0	1	0	gen
3	123979683	123980060	MACS_peak_14030	635.71	377	0	1	0	gen
3	124079368	124079721	MACS_peak_14031	777.57	353	1	0	0	promoter
3	124351783	124351969	MACS_peak_14032	712.32	186	0	1	0	gen
3	124468279	124468597	MACS_peak_14033	551.85	318	0	1	0	gen
3	124559929	124560203	MACS_peak_14035	582.68	274	0	1	0	gen
3	124838023	124838222	MACS_peak_14036	645.81	199	0	1	0	gen
3	124928671	124928989	MACS_peak_14037	1331.31	318	0	1	0	gen
3	124995439	124995705	MACS_peak_14038	463.44	266	0	1	0	gen
3	125268868	125269083	MACS_peak_14039	896.52	215	0	1	0	gen
3	125453970	125454218	MACS_peak_14040	485.56	248	0	1	0	gen
3	125697976	125698305	MACS_peak_14041	544.83	329	0	0	0	intergen
3	125766261	125766556	MACS_peak_14042	432.29	295	0	0	0	intergen
3	125783241	125783394	MACS_peak_14043	908.36	153	0	0	2	other
3	125898206	125898534	MACS_peak_14044	419.16	328	0	0	2	other
3	125921800	125922004	MACS_peak_14045	1335.62	204	0	0	1	other
3	125929075	125929459	MACS_peak_14046	1312.66	384	1	0	1	promoter
3	125937161	125937536	MACS_peak_14047	85.15	375	0	0	0	intergen
3	125972453	125972794	MACS_peak_14049	1192.57	341	1	0	0	promoter
3	126081614	126081806	MACS_peak_14050	1061.85	192	0	1	0	gen
3	126132953	126133158	MACS_peak_14051	797.18	205	0	1	0	gen
3	126198324	126198541	MACS_peak_14052	717.33	217	0	0	1	other
3	126335252	126335690	MACS_peak_14054	61.26	438	0	0	0	intergen
3	126368406	126368724	MACS_peak_14055	380.3	318	0	0	0	intergen
3	126389331	126389657	MACS_peak_14056	670.69	326	0	0	0	intergen
3	126522393	126522603	MACS_peak_14057	936.57	210	2	0	0	promoter
3	126586244	126586500	MACS_peak_14058	211.31	256	0	1	0	gen
3	126660048	126660215	MACS_peak_14059	814.37	167	0	0	0	intergen
3	126982515	126982870	MACS_peak_14060	413.79	355	0	0	0	intergen
3	127455634	127455916	MACS_peak_14061	453.35	282	0	0	0	intergen
3	127575003	127575326	MACS_peak_14062	672.92	323	1	0	0	promoter
3	127696273	127696417	MACS_peak_14063	979.06	144	0	1	0	gen
3	127882633	127882765	MACS_peak_14064	665.1	132	0	1	0	gen
3	128138921	128139125	MACS_peak_14065	893.54	204	0	1	0	gen
3	128150598	128150983	MACS_peak_14066	630.67	385	1	1	0	promoter
3	128369942	128370174	MACS_peak_14067	678.9	232	0	1	0	gen
3	128426292	128426590	MACS_peak_14068	960.47	298	0	0	0	intergen
3	128584488	128584926	MACS_peak_14069	599.79	438	0	0	0	intergen
3	128753278	128753479	MACS_peak_14071	478.76	201	0	1	0	gen
3	128845958	128846147	MACS_peak_14072	695.57	189	0	0	0	intergen
3	129328750	129329108	MACS_peak_14073	368.21	358	0	0	0	intergen
3	129627842	129628218	MACS_peak_14074	464.3	376	0	0	0	intergen
3	129657872	129658161	MACS_peak_14075	449.12	289	0	1	0	gen
3	129829617	129829897	MACS_peak_14076	454.58	280	0	1	0	gen
3	129852461	129852703	MACS_peak_14077	501.16	242	0	1	0	gen
3	129992994	129993204	MACS_peak_14078	613.04	210	0	0	0	intergen
3	130003074	130003349	MACS_peak_14079	693.11	275	0	0	0	intergen
3	130098232	130098668	MACS_peak_14080	1666.64	436	0	1	0	gen
3	130276262	130276635	MACS_peak_14082	518.99	373	0	0	0	intergen
3	130295004	130295411	MACS_peak_14083	137.06	407	0	0	0	intergen
3	130699740	130700085	MACS_peak_14084	418.68	345	0	1	0	gen
3	130723059	130723196	MACS_peak_14085	896.34	137	0	1	0	gen
3	130747171	130747467	MACS_peak_14086	93.4	296	0	0	0	intergen
3	131057393	131057861	MACS_peak_14087	51.51	468	0	1	1	gen
3	131333541	131333855	MACS_peak_14089	70.49	314	0	1	1	gen
3	131437998	131438271	MACS_peak_14090	458.95	273	0	0	0	intergen
3	131443954	131444089	MACS_peak_14091	1546.53	135	0	0	0	intergen
3	131473534	131473944	MACS_peak_14092	615.59	410	0	1	0	gen
3	131486002	131486248	MACS_peak_14093	93.49	246	0	1	0	gen
3	131515064	131515420	MACS_peak_14094	59.64	356	0	0	0	intergen
3	131965514	131965704	MACS_peak_14095	362.76	190	0	1	0	gen
3	132034948	132035255	MACS_peak_14097	559.13	307	0	1	0	gen
3	132038325	132038557	MACS_peak_14098	678.9	232	0	1	0	gen
3	132253334	132253621	MACS_peak_14099	557.09	287	0	1	0	gen
3	132260938	132261248	MACS_peak_14100	381.29	310	0	1	0	gen
3	132352598	132352891	MACS_peak_14101	696.46	293	0	1	0	gen
3	132375368	132375776	MACS_peak_14102	65.9	408	0	0	0	intergen
3	132376424	132376890	MACS_peak_14103	140.38	466	0	0	0	intergen
3	132469892	132470355	MACS_peak_14104	148.8	463	0	1	0	gen
3	132485994	132486210	MACS_peak_14105	746.04	216	0	1	0	gen
3	132657758	132657892	MACS_peak_14106	916.48	134	1	2	0	promoter
3	132861872	132862050	MACS_peak_14107	698.01	178	0	0	1	other
3	133003652	133003950	MACS_peak_14108	79.17	298	0	0	0	intergen
3	133041301	133041634	MACS_peak_14109	542.34	333	1	0	0	promoter
3	133168091	133168413	MACS_peak_14110	380.3	322	0	1	0	gen
3	133175402	133175674	MACS_peak_14111	207.12	272	0	1	0	gen
3	133176203	133176460	MACS_peak_14112	79.05	257	0	1	0	gen
3	133178313	133178618	MACS_peak_14113	65.81	305	0	1	0	gen
3	133310217	133310555	MACS_peak_14114	164.26	338	0	1	0	gen
3	133384536	133384742	MACS_peak_14115	629.38	206	0	1	0	gen
3	133464575	133464939	MACS_peak_14116	644.14	364	0	1	0	gen
3	133473434	133473686	MACS_peak_14117	218.51	252	0	1	0	gen
3	133562794	133563106	MACS_peak_14118	158.81	312	0	0	0	intergen
3	133723472	133723604	MACS_peak_14119	496.86	132	0	0	1	other
3	133724118	133724451	MACS_peak_14120	71.46	333	0	0	1	other
3	133727245	133727551	MACS_peak_14121	81.2	306	0	0	1	other
3	134096235	134096541	MACS_peak_14122	146.78	306	0	1	0	gen
3	134240304	134240515	MACS_peak_14123	936.57	211	0	1	0	gen
3	134474046	134474285	MACS_peak_14124	588.69	239	1	0	0	promoter
3	134492533	134492793	MACS_peak_14125	1120.91	260	0	1	0	gen
3	134552507	134552672	MACS_peak_14126	469.07	165	0	1	0	gen
3	134640962	134641248	MACS_peak_14127	450.92	286	0	2	0	gen
3	134782284	134782512	MACS_peak_14128	548.55	228	0	1	0	gen
3	135002347	135002690	MACS_peak_14129	93.07	343	0	1	0	gen
3	135503901	135504278	MACS_peak_14132	403.51	377	0	0	0	intergen
3	135589134	135589379	MACS_peak_14133	56.94	245	0	0	0	intergen
3	135589712	135589900	MACS_peak_14134	100.68	188	0	0	0	intergen
3	135608357	135608691	MACS_peak_14135	66.5	334	0	0	0	intergen
3	135658967	135659244	MACS_peak_14136	119.89	277	0	0	0	intergen
3	135958414	135958668	MACS_peak_14138	883.81	254	0	0	0	intergen
3	136063621	136064036	MACS_peak_14139	110.72	415	0	1	0	gen
3	136075165	136075618	MACS_peak_14140	830.77	453	0	1	0	gen
3	136078808	136079178	MACS_peak_14141	743.41	370	0	1	0	gen
3	136140435	136140730	MACS_peak_14142	312.33	295	0	1	0	gen
3	136227284	136227671	MACS_peak_14143	53.02	387	0	0	0	intergen
3	136279877	136280237	MACS_peak_14144	240.26	360	0	1	0	gen
3	136292295	136292582	MACS_peak_14145	701.46	287	0	1	0	gen
3	136305865	136306166	MACS_peak_14146	442.11	301	0	1	0	gen
3	136351822	136352214	MACS_peak_14147	492.97	392	0	1	0	gen
3	136372903	136373142	MACS_peak_14148	111.22	239	0	1	0	gen
3	136391539	136391948	MACS_peak_14149	412.99	409	0	1	0	gen
3	136418357	136418505	MACS_peak_14150	442.36	148	0	1	0	gen
3	136434593	136434935	MACS_peak_14151	529.34	342	0	1	0	gen
3	136545665	136545945	MACS_peak_14152	670.18	280	0	1	0	gen
3	136702000	136702215	MACS_peak_14153	315.94	215	0	1	0	gen
3	136752322	136752549	MACS_peak_14154	548.55	227	0	0	0	intergen
3	136949849	136950146	MACS_peak_14155	444.41	297	1	0	0	promoter
3	137110342	137110718	MACS_peak_14156	722.05	376	0	0	0	intergen
3	137140617	137140898	MACS_peak_14157	62.38	281	0	0	0	intergen
3	137141535	137141850	MACS_peak_14158	96.89	315	0	0	0	intergen
3	137305101	137305362	MACS_peak_14159	338.85	261	0	0	0	intergen
3	137353580	137353967	MACS_peak_14160	57.86	387	0	0	0	intergen
3	137358682	137358951	MACS_peak_14161	760.48	269	0	0	0	intergen
3	137374819	137375189	MACS_peak_14162	277.95	370	0	0	0	intergen
3	137375862	137376118	MACS_peak_14163	801.76	256	0	0	0	intergen
3	137409652	137410085	MACS_peak_14164	761.1	433	0	0	0	intergen
3	137637776	137638168	MACS_peak_14165	100.3	392	0	0	0	intergen
3	137663545	137663809	MACS_peak_14166	101.93	264	0	0	0	intergen
3	137755918	137756131	MACS_peak_14167	164.14	213	0	0	0	intergen
3	137792674	137793003	MACS_peak_14168	905.75	329	0	0	1	other
3	137956671	137957084	MACS_peak_14169	734.44	413	0	0	0	intergen
3	137971258	137971501	MACS_peak_14170	623.4	243	0	0	0	intergen
3	138068657	138068981	MACS_peak_14171	429.45	324	0	1	0	gen
3	138524131	138524416	MACS_peak_14172	58.29	285	0	1	0	gen
3	138545067	138545413	MACS_peak_14173	434.11	346	0	1	0	gen
3	138594745	138595009	MACS_peak_14174	590.39	264	0	0	0	intergen
3	138744288	138744432	MACS_peak_14175	2140.36	144	0	1	0	gen
3	138848064	138848200	MACS_peak_14176	954.83	136	0	0	0	intergen
3	139145086	139145447	MACS_peak_14178	52.12	361	0	1	0	gen
3	139333714	139334101	MACS_peak_14179	79.31	387	0	1	0	gen
3	139381667	139381928	MACS_peak_14180	592.77	261	0	1	0	gen
3	139562218	139562388	MACS_peak_14181	577.39	170	1	0	1	promoter
3	139569282	139569665	MACS_peak_14182	79.81	383	0	1	1	gen
3	139582531	139582765	MACS_peak_14183	387.94	234	0	1	1	gen
3	139718466	139718773	MACS_peak_14184	559.13	307	0	0	0	intergen
3	140051339	140051653	MACS_peak_14185	679.74	314	0	1	0	gen
3	140128649	140128838	MACS_peak_14186	809.97	189	0	1	0	gen
3	140171546	140171886	MACS_peak_14187	506.92	340	0	1	0	gen
3	140216341	140216628	MACS_peak_14188	573.07	287	0	1	0	gen
3	140579364	140579597	MACS_peak_14189	532.66	233	0	0	0	intergen
3	140989358	140989720	MACS_peak_14190	57.89	362	0	0	0	intergen
3	140990431	140990829	MACS_peak_14191	101.06	398	0	0	0	intergen
3	141105816	141106064	MACS_peak_14192	613.04	248	0	1	0	gen
3	141231655	141231890	MACS_peak_14193	662.31	235	1	0	0	promoter
3	141303375	141303695	MACS_peak_14194	293.68	320	0	1	1	gen
3	141308671	141309049	MACS_peak_14195	806.6	378	0	1	1	gen
3	141360936	141361236	MACS_peak_14196	690.75	300	0	2	1	gen
3	141518464	141518615	MACS_peak_14197	330.71	151	0	1	0	gen
3	141538917	141539154	MACS_peak_14198	814.37	237	0	1	0	gen
3	141561487	141561777	MACS_peak_14199	2523.84	290	0	1	0	gen
3	141742113	141742351	MACS_peak_14200	532.74	238	2	0	0	promoter
3	141913317	141913618	MACS_peak_14201	1511.93	301	0	1	0	gen
3	142136381	142136674	MACS_peak_14202	93.4	293	0	1	0	gen
3	142152435	142152608	MACS_peak_14203	723.41	173	0	0	0	intergen
3	142340360	142340678	MACS_peak_14204	388.29	318	0	1	0	gen
3	142678419	142678729	MACS_peak_14205	51.39	310	0	1	0	gen
3	142929096	142929406	MACS_peak_14206	437.04	310	0	0	1	other
3	142994037	142994294	MACS_peak_14207	1006.59	257	0	1	1	gen
3	143203541	143203783	MACS_peak_14208	518.84	242	0	0	0	intergen
3	143392383	143392783	MACS_peak_14209	155.5	400	0	1	0	gen
3	143400714	143401012	MACS_peak_14210	545.23	298	0	1	0	gen
3	143654089	143654308	MACS_peak_14211	580.62	219	0	1	0	gen
3	143665229	143665586	MACS_peak_14212	93.4	357	0	1	0	gen
3	143763520	143763925	MACS_peak_14213	446.52	405	0	1	0	gen
3	143817144	143817417	MACS_peak_14214	114.74	273	0	1	0	gen
3	143880667	143880864	MACS_peak_14215	644.94	197	0	0	0	intergen
3	143885849	143886104	MACS_peak_14216	470.06	255	0	0	0	intergen
3	143895857	143896207	MACS_peak_14217	304.28	350	0	0	0	intergen
3	143986443	143986682	MACS_peak_14218	246.28	239	0	1	0	gen
3	144072376	144072595	MACS_peak_14219	879.27	219	0	0	0	intergen
3	144308043	144308390	MACS_peak_14220	417.69	347	0	0	0	intergen
3	144415449	144415581	MACS_peak_14221	1116.4	132	0	0	0	intergen
3	144511923	144512216	MACS_peak_14222	722.05	293	0	0	0	intergen
3	144926422	144926764	MACS_peak_14223	312.33	342	0	0	0	intergen
3	144943798	144944051	MACS_peak_14224	733.96	253	0	0	0	intergen
3	145065838	145066064	MACS_peak_14225	271.34	226	0	0	0	intergen
3	145413033	145413237	MACS_peak_14226	797.18	204	0	0	0	intergen
3	145571301	145571573	MACS_peak_14227	722.05	272	0	0	0	intergen
3	145657441	145657763	MACS_peak_14228	721.05	322	0	0	0	intergen
3	145767947	145768321	MACS_peak_14230	404.88	374	0	0	0	intergen
3	145823345	145823816	MACS_peak_14231	70.59	471	0	0	0	intergen
3	146277568	146277769	MACS_peak_14232	525.9	201	0	0	0	intergen
3	146327275	146327513	MACS_peak_14233	777.13	238	0	0	0	intergen
3	146557263	146557559	MACS_peak_14234	826.15	296	0	0	0	intergen
3	146594928	146595162	MACS_peak_14235	793.98	234	0	1	0	gen
3	146638786	146639196	MACS_peak_14236	963.9	410	0	0	0	intergen
3	146641391	146641598	MACS_peak_14237	993.56	207	0	0	0	intergen
3	146725233	146725493	MACS_peak_14238	480.84	260	0	0	0	intergen
3	146817756	146818134	MACS_peak_14239	758.75	378	0	0	0	intergen
3	146877843	146877986	MACS_peak_14240	1110.9	143	0	0	0	intergen
3	146956937	146957232	MACS_peak_14241	538.06	295	0	0	1	other
3	147096804	147097230	MACS_peak_14242	136.54	426	0	0	1	other
3	147120019	147120411	MACS_peak_14243	790.36	392	0	0	1	other
3	147125326	147125594	MACS_peak_14244	137.17	268	0	0	1	other
3	147142694	147143050	MACS_peak_14245	312.33	356	0	0	1	other
3	147361872	147362169	MACS_peak_14246	565.98	297	0	0	1	other
3	147644679	147644879	MACS_peak_14247	983.72	200	0	0	0	intergen
3	147727917	147728246	MACS_peak_14248	56.38	329	0	0	0	intergen
3	147899826	147900179	MACS_peak_14249	518.59	353	0	0	0	intergen
3	147973658	147973842	MACS_peak_14250	918.92	184	0	0	1	other
3	148306606	148306966	MACS_peak_14251	56.38	360	0	0	1	other
3	148338259	148338471	MACS_peak_14252	908.01	212	0	0	1	other
3	148415537	148415827	MACS_peak_14253	201.59	290	0	0	1	other
3	148459951	148460206	MACS_peak_14254	866.35	255	0	0	1	other
3	148520948	148521230	MACS_peak_14255	534.92	282	0	0	1	other
3	148566589	148566820	MACS_peak_14256	246.87	231	0	0	1	other
3	148579957	148580367	MACS_peak_14257	98.56	410	0	0	1	other
3	148631664	148631877	MACS_peak_14258	596.79	213	0	0	0	intergen
3	148691174	148691527	MACS_peak_14259	97.43	353	0	0	0	intergen
3	148727243	148727520	MACS_peak_14260	456.44	277	0	1	0	gen
3	148861296	148861626	MACS_peak_14261	928.77	330	1	0	1	promoter
3	148947308	148947670	MACS_peak_14262	900.06	362	0	0	1	other
3	148955557	148955748	MACS_peak_14263	866.35	191	0	0	1	other
3	149035649	149035787	MACS_peak_14264	630.2	138	0	1	0	gen
3	149273190	149273498	MACS_peak_14265	950.21	308	0	0	1	other
3	149334438	149334680	MACS_peak_14266	588.69	242	0	0	0	intergen
3	149489169	149489462	MACS_peak_14267	696.46	293	0	1	0	gen
3	149494263	149494563	MACS_peak_14268	442.68	300	0	1	0	gen
3	149530661	149530975	MACS_peak_14269	469.6	314	0	1	0	gen
3	149568921	149569270	MACS_peak_14270	742.94	349	0	1	0	gen
3	149652518	149652748	MACS_peak_14271	152.88	230	0	1	0	gen
3	149711053	149711186	MACS_peak_14272	1176.51	133	0	1	0	gen
3	149770355	149770594	MACS_peak_14273	628.77	239	0	1	0	gen
3	149771758	149772030	MACS_peak_14274	459.58	272	0	1	0	gen
3	149804656	149805075	MACS_peak_14275	57.86	419	0	1	0	gen
3	149808346	149808532	MACS_peak_14276	1238.13	186	1	1	0	promoter
3	149936760	149937035	MACS_peak_14277	846.51	275	0	2	0	gen
3	149938375	149938507	MACS_peak_14278	1116.4	132	0	2	0	gen
3	149981965	149982267	MACS_peak_14279	749.11	302	0	1	0	gen
3	150239063	150239328	MACS_peak_14280	464.09	265	0	0	1	other
3	150303720	150304122	MACS_peak_14281	389.76	402	0	0	0	intergen
3	150459654	150459965	MACS_peak_14282	312.33	311	0	1	0	gen
3	150495687	150495905	MACS_peak_14283	499.85	218	0	0	0	intergen
3	150528602	150528839	MACS_peak_14284	654.12	237	0	0	0	intergen
3	150616285	150616645	MACS_peak_14285	96.97	360	0	1	0	gen
3	150787812	150788015	MACS_peak_14286	814.37	203	0	0	0	intergen
3	150817927	150818177	MACS_peak_14287	182.55	250	0	0	0	intergen
3	150925725	150925934	MACS_peak_14288	613.04	209	1	1	2	promoter
3	151116988	151117346	MACS_peak_14289	402.61	358	0	1	0	gen
3	151168367	151168649	MACS_peak_14290	450.7	282	0	1	0	gen
3	151218856	151219002	MACS_peak_14291	914.4	146	0	2	0	gen
3	151247113	151247549	MACS_peak_14292	69.92	436	0	2	0	gen
3	151290685	151291008	MACS_peak_14293	548.63	323	1	1	0	promoter
3	151426018	151426484	MACS_peak_14295	1317.25	466	1	1	0	promoter
3	151439652	151440078	MACS_peak_14296	606.43	426	0	1	0	gen
3	151490326	151490535	MACS_peak_14297	1322.68	209	0	0	0	intergen
3	151839111	151839391	MACS_peak_14298	679.29	280	0	0	1	other
3	152072010	152072243	MACS_peak_14299	831.63	233	0	0	0	intergen
3	152444108	152444355	MACS_peak_14300	629.38	247	0	1	0	gen
3	152466655	152466994	MACS_peak_14301	522.76	339	0	0	1	other
3	152467149	152467330	MACS_peak_14302	742.08	181	0	0	1	other
3	152474518	152474929	MACS_peak_14303	1395.29	411	0	0	1	other
3	152508668	152509020	MACS_peak_14304	530.91	352	0	0	0	intergen
3	152524581	152524997	MACS_peak_14305	985.43	416	0	0	0	intergen
3	152824640	152824904	MACS_peak_14306	574.38	264	0	0	0	intergen
3	152887470	152887824	MACS_peak_14307	776.79	354	0	0	0	intergen
3	153021867	153022074	MACS_peak_14308	745.49	207	0	0	0	intergen
3	153026053	153026376	MACS_peak_14309	618.67	323	0	0	0	intergen
3	153032548	153032809	MACS_peak_14310	646.2	261	0	0	0	intergen
3	153043102	153043326	MACS_peak_14311	754.53	224	0	0	0	intergen
3	153238818	153239146	MACS_peak_14312	80.8	328	0	0	0	intergen
3	153474724	153474967	MACS_peak_14313	628.77	243	0	0	2	other
3	153508716	153509152	MACS_peak_14314	75.01	436	0	0	1	other
3	153549503	153549839	MACS_peak_14315	50.92	336	0	0	1	other
3	153595299	153595522	MACS_peak_14316	564.54	223	0	0	1	other
3	153646531	153646760	MACS_peak_14317	545.56	229	0	0	1	other
3	153798030	153798412	MACS_peak_14318	56.38	382	0	0	1	other
3	153933645	153933943	MACS_peak_14319	121.82	298	0	0	2	other
3	153950528	153950860	MACS_peak_14320	90.78	332	0	0	1	other
3	153970891	153971117	MACS_peak_14321	548.55	226	0	0	1	other
3	154253058	154253370	MACS_peak_14323	391.53	312	0	1	0	gen
3	154301959	154302208	MACS_peak_14324	485.56	249	0	1	0	gen
3	154418090	154418502	MACS_peak_14325	57.86	412	0	1	0	gen
3	154480486	154480877	MACS_peak_14326	57.86	391	0	0	0	intergen
3	154751773	154752013	MACS_peak_14328	468.75	240	0	0	0	intergen
3	154821488	154821866	MACS_peak_14329	200.38	378	0	0	0	intergen
3	154855589	154855900	MACS_peak_14330	105.41	311	0	0	1	other
3	154860798	154861125	MACS_peak_14331	524.87	327	0	0	0	intergen
3	155063460	155063803	MACS_peak_14332	312.33	343	0	1	0	gen
3	155124690	155125037	MACS_peak_14335	66.65	347	0	1	0	gen
3	155144951	155145164	MACS_peak_14336	596.79	213	0	1	0	gen
3	155241934	155242292	MACS_peak_14337	399.16	358	0	0	1	other
3	155360772	155360981	MACS_peak_14338	596.67	209	0	0	0	intergen
3	155438520	155438892	MACS_peak_14339	72.11	372	0	1	0	gen
3	155537099	155537237	MACS_peak_14340	1025.3	138	0	1	0	gen
3	155544855	155545290	MACS_peak_14341	68.1	435	0	1	0	gen
3	155701918	155702177	MACS_peak_14342	603.02	259	0	1	0	gen
3	155753104	155753359	MACS_peak_14343	729.14	255	0	0	0	intergen
3	155859921	155860301	MACS_peak_14344	545.6	380	0	0	0	intergen
3	155955583	155955887	MACS_peak_14345	476.19	304	0	0	0	intergen
3	155978383	155978693	MACS_peak_14346	557.12	310	0	0	0	intergen
3	156043918	156044134	MACS_peak_14347	1264.23	216	0	1	0	gen
3	156151791	156152123	MACS_peak_14348	425.26	332	0	1	0	gen
3	156382547	156382807	MACS_peak_14350	539.85	260	0	1	0	gen
3	156541210	156541394	MACS_peak_14351	918.92	184	1	0	0	promoter
3	156586513	156586733	MACS_peak_14352	398.29	220	0	0	0	intergen
3	156591110	156591528	MACS_peak_14353	90.46	418	0	0	0	intergen
3	156776713	156776989	MACS_peak_14354	710.92	276	0	0	1	other
3	156817565	156817789	MACS_peak_14355	564.54	224	0	0	0	intergen
3	156879265	156879545	MACS_peak_14356	204.68	280	0	1	0	gen
3	156970679	156971085	MACS_peak_14357	51.33	406	0	1	0	gen
3	156998358	156998557	MACS_peak_14358	645.81	199	0	1	0	gen
3	157021044	157021356	MACS_peak_14359	55.83	312	0	1	0	gen
3	157130727	157130936	MACS_peak_14360	954.29	209	0	0	0	intergen
3	157201730	157202044	MACS_peak_14361	554.47	314	0	0	1	other
3	157239185	157239397	MACS_peak_14362	596.79	212	0	0	1	other
3	157493725	157493918	MACS_peak_14363	653.04	193	0	1	0	gen
3	157532631	157532880	MACS_peak_14364	613.04	249	0	1	0	gen
3	157606669	157606885	MACS_peak_14365	901.33	216	0	1	0	gen
3	157686642	157687022	MACS_peak_14366	134.53	380	0	0	0	intergen
3	157689610	157689856	MACS_peak_14367	157.99	246	0	0	0	intergen
3	157864397	157864821	MACS_peak_14368	589.11	424	0	0	0	intergen
3	157885051	157885264	MACS_peak_14369	156.63	213	0	0	0	intergen
3	157900955	157901280	MACS_peak_14370	96.97	325	0	0	0	intergen
3	157950705	157951004	MACS_peak_14371	127.5	299	0	0	0	intergen
3	158078704	158078859	MACS_peak_14372	712.61	155	0	0	1	other
3	158197007	158197400	MACS_peak_14373	109.53	393	0	1	0	gen
3	158221200	158221519	MACS_peak_14374	432.12	319	0	1	0	gen
3	158284464	158284904	MACS_peak_14375	81.85	440	0	1	0	gen
3	158284974	158285216	MACS_peak_14376	76.64	242	0	1	0	gen
3	158313378	158313697	MACS_peak_14377	613.54	319	0	1	0	gen
3	158327844	158328176	MACS_peak_14378	69.44	332	0	1	0	gen
3	158422730	158422976	MACS_peak_14379	70.53	246	0	1	0	gen
3	158434508	158434728	MACS_peak_14380	621.09	220	0	1	0	gen
3	158532225	158532467	MACS_peak_14381	501.16	242	0	1	0	gen
3	158636240	158636616	MACS_peak_14382	93.11	376	0	0	0	intergen
3	158644102	158644521	MACS_peak_14383	934.14	419	2	0	0	promoter
3	158672563	158672873	MACS_peak_14384	557.12	310	0	1	0	gen
3	158727821	158728074	MACS_peak_14385	470.06	253	1	1	0	promoter
3	158791408	158791759	MACS_peak_14386	488.85	351	0	1	0	gen
3	159263826	159264052	MACS_peak_14387	827.89	226	0	2	0	gen
3	159508461	159508653	MACS_peak_14389	162.87	192	0	1	0	gen
3	159589299	159589667	MACS_peak_14390	69	368	0	1	0	gen
3	159680577	159680732	MACS_peak_14391	901.33	155	0	1	0	gen
3	159828355	159828719	MACS_peak_14392	488.85	364	0	1	0	gen
3	159940183	159940563	MACS_peak_14393	69	380	0	0	1	other
3	160003487	160003815	MACS_peak_14394	380.3	328	0	0	1	other
3	160006586	160006904	MACS_peak_14395	940.27	318	0	0	1	other
3	160071920	160072300	MACS_peak_14396	306.6	380	0	0	1	other
3	160486476	160486687	MACS_peak_14399	763.02	211	0	0	0	intergen
3	160577689	160578003	MACS_peak_14400	434.84	314	0	0	0	intergen
3	160685178	160685536	MACS_peak_14401	412.35	358	0	0	0	intergen
3	160843624	160843950	MACS_peak_14402	89.02	326	0	1	0	gen
3	160915652	160916021	MACS_peak_14403	58.05	369	0	1	0	gen
3	160920964	160921330	MACS_peak_14404	1165.72	366	0	1	0	gen
3	160941992	160942235	MACS_peak_14405	645.81	243	0	1	0	gen
3	160976806	160977142	MACS_peak_14406	68.11	336	0	1	0	gen
3	161099590	161099937	MACS_peak_14407	913.18	347	0	1	0	gen
3	161120940	161121127	MACS_peak_14408	437.67	187	0	1	0	gen
3	161220482	161220724	MACS_peak_14409	611.55	242	0	1	0	gen
3	161273692	161273908	MACS_peak_14410	746.04	216	0	0	0	intergen
3	161417512	161417871	MACS_peak_14411	180.31	359	0	0	0	intergen
3	161427977	161428202	MACS_peak_14412	820.7	225	0	0	1	other
3	161508935	161509273	MACS_peak_14413	519.3	338	0	0	0	intergen
3	161559456	161559793	MACS_peak_14414	1782.09	337	0	0	0	intergen
3	161560304	161560605	MACS_peak_14415	563.21	301	0	0	0	intergen
3	161653267	161653402	MACS_peak_14416	1546.53	135	0	0	0	intergen
3	161695252	161695660	MACS_peak_14417	737.78	408	0	0	0	intergen
3	161762294	161762563	MACS_peak_14418	717.14	269	0	0	0	intergen
3	161920101	161920413	MACS_peak_14419	488.85	312	0	0	0	intergen
3	161928833	161929079	MACS_peak_14420	985.92	246	0	0	0	intergen
3	161930629	161930871	MACS_peak_14421	256.56	242	0	0	0	intergen
3	161966274	161966599	MACS_peak_14422	201.59	325	0	0	0	intergen
3	162189091	162189335	MACS_peak_14423	199.37	244	0	0	0	intergen
3	162413515	162413696	MACS_peak_14424	448.06	181	0	0	0	intergen
3	162535007	162535357	MACS_peak_14425	416.22	350	0	0	0	intergen
3	162781433	162781630	MACS_peak_14426	662.31	197	0	0	0	intergen
3	162948299	162948439	MACS_peak_14427	977.05	140	0	0	0	intergen
3	162994867	162995055	MACS_peak_14428	635.07	188	0	0	0	intergen
3	163043187	163043537	MACS_peak_14429	416.22	350	0	0	1	other
3	163148723	163148992	MACS_peak_14430	91.69	269	0	0	2	other
3	163240377	163240859	MACS_peak_14432	54.55	482	0	0	1	other
3	163242345	163242741	MACS_peak_14433	54.21	396	0	0	1	other
3	163457219	163457439	MACS_peak_14434	521.8	220	0	0	0	intergen
3	163642682	163643059	MACS_peak_14435	105.65	377	0	0	0	intergen
3	163951474	163951769	MACS_peak_14436	721.05	295	0	0	0	intergen
3	164084583	164084805	MACS_peak_14437	69.77	222	0	0	0	intergen
3	164227910	164228197	MACS_peak_14438	1086.74	287	0	0	0	intergen
3	164292765	164293045	MACS_peak_14439	165.06	280	0	0	0	intergen
3	164295001	164295482	MACS_peak_14440	55.93	481	0	0	0	intergen
3	164342663	164342987	MACS_peak_14441	142.05	324	0	0	0	intergen
3	164390159	164390428	MACS_peak_14442	448.17	269	0	0	0	intergen
3	164394417	164394630	MACS_peak_14443	863.75	213	0	0	0	intergen
3	164588700	164588978	MACS_peak_14444	506.92	278	0	0	0	intergen
3	164758483	164758744	MACS_peak_14445	1001.77	261	0	0	1	other
3	165058443	165058672	MACS_peak_14446	441.41	229	0	1	0	gen
3	165166812	165167062	MACS_peak_14448	162.52	250	0	0	0	intergen
3	165206738	165207089	MACS_peak_14449	2240.03	351	0	0	0	intergen
3	165317322	165317661	MACS_peak_14450	105.19	339	0	0	1	other
3	165318569	165318947	MACS_peak_14451	52.1	378	0	0	1	other
3	165339638	165340005	MACS_peak_14452	522.32	367	0	0	1	other
3	165438386	165438634	MACS_peak_14453	613.04	248	0	0	1	other
3	165562145	165562399	MACS_peak_14454	810.91	254	0	0	1	other
3	165716523	165716794	MACS_peak_14455	446.89	271	0	0	0	intergen
3	165737363	165737509	MACS_peak_14456	647.42	146	0	0	0	intergen
3	165902320	165902661	MACS_peak_14457	73.7	341	0	0	0	intergen
3	165962419	165962676	MACS_peak_14458	76.3	257	0	0	0	intergen
3	166013184	166013424	MACS_peak_14459	516.86	240	0	0	0	intergen
3	166175727	166175972	MACS_peak_14460	426.48	245	0	0	0	intergen
3	166413120	166413339	MACS_peak_14461	580.62	219	0	0	0	intergen
3	166699369	166699634	MACS_peak_14462	535.92	265	0	0	0	intergen
3	166858809	166859033	MACS_peak_14463	1007.73	224	0	0	0	intergen
3	166880104	166880579	MACS_peak_14464	2081.56	475	0	0	0	intergen
3	166933984	166934176	MACS_peak_14465	808.73	192	0	0	0	intergen
3	167117985	167118232	MACS_peak_14466	387.3	247	0	0	0	intergen
3	167218254	167218536	MACS_peak_14467	453.35	282	0	0	0	intergen
3	167279130	167279586	MACS_peak_14468	94.38	456	0	1	0	gen
3	167406891	167407091	MACS_peak_14469	645.81	200	0	0	1	other
3	167535285	167535494	MACS_peak_14470	558.17	209	0	1	0	gen
3	167665518	167665737	MACS_peak_14471	569.03	219	0	0	0	intergen
3	167684450	167684762	MACS_peak_14472	681.28	312	1	0	0	promoter
3	167740962	167741304	MACS_peak_14473	786.29	342	0	1	0	gen
3	167837155	167837610	MACS_peak_14474	595.76	455	0	0	0	intergen
3	168040620	168040945	MACS_peak_14475	779.06	325	0	1	0	gen
3	168047086	168047469	MACS_peak_14476	882.6	383	0	1	0	gen
3	168165728	168165949	MACS_peak_14477	883.81	221	0	0	0	intergen
3	168211239	168211671	MACS_peak_14478	1017.9	432	0	0	0	intergen
3	168354978	168355295	MACS_peak_14480	121.01	317	0	0	1	other
3	168467451	168467876	MACS_peak_14481	606.99	425	0	0	1	other
3	168511510	168511702	MACS_peak_14482	678.9	192	0	0	1	other
3	168639430	168639802	MACS_peak_14483	69.83	372	0	0	1	other
3	168699071	168699323	MACS_peak_14485	882.78	252	0	0	1	other
3	168847359	168847630	MACS_peak_14486	460.22	271	0	0	0	intergen
3	168864987	168865272	MACS_peak_14487	1408.84	285	0	0	0	intergen
3	168889758	168889943	MACS_peak_14488	712.32	185	0	0	0	intergen
3	168952523	168952809	MACS_peak_14489	573.79	286	0	0	0	intergen
3	169041678	169042126	MACS_peak_14490	1089.21	448	0	0	0	intergen
3	169083716	169084077	MACS_peak_14491	722.05	361	1	0	0	promoter
3	169119532	169119759	MACS_peak_14492	598.2	227	0	1	0	gen
3	169133101	169133554	MACS_peak_14493	956.19	453	0	1	0	gen
3	169362872	169363310	MACS_peak_14494	1505.41	438	0	1	0	gen
3	169367340	169367505	MACS_peak_14495	927.9	165	0	1	0	gen
3	169441714	169441851	MACS_peak_14496	1238.29	137	0	1	0	gen
3	169563057	169563226	MACS_peak_14497	1001.34	169	0	1	0	gen
3	169619586	169620046	MACS_peak_14498	476.09	460	0	1	1	gen
3	169713317	169713520	MACS_peak_14499	124.39	203	0	0	0	intergen
3	169744716	169744897	MACS_peak_14501	662.55	181	0	0	0	intergen
3	170189238	170189457	MACS_peak_14503	729.14	219	0	0	0	intergen
3	170198016	170198404	MACS_peak_14504	351.8	388	0	0	0	intergen
3	170209619	170209785	MACS_peak_14505	579.03	166	0	0	0	intergen
3	170310178	170310478	MACS_peak_14506	790.3	300	0	0	0	intergen
3	170368974	170369286	MACS_peak_14507	1057.89	312	0	1	0	gen
3	170406182	170406313	MACS_peak_14508	889.35	131	0	0	0	intergen
3	170410536	170410755	MACS_peak_14509	625.92	219	0	0	1	other
3	170414165	170414454	MACS_peak_14510	785.14	289	2	0	1	promoter
3	170433129	170433416	MACS_peak_14511	450.32	287	0	2	0	gen
3	170499679	170499903	MACS_peak_14512	614.29	224	0	2	1	gen
3	170617663	170617952	MACS_peak_14513	178.37	289	0	1	1	gen
3	170690422	170690775	MACS_peak_14515	610.12	353	0	1	1	gen
3	170809591	170809796	MACS_peak_14516	629.38	205	0	1	1	gen
3	170812008	170812316	MACS_peak_14517	1089.02	308	0	1	1	gen
3	170848291	170848744	MACS_peak_14518	737.12	453	0	1	1	gen
3	170860031	170860408	MACS_peak_14519	889.09	377	1	0	1	promoter
3	170961370	170961757	MACS_peak_14520	603.02	387	0	0	0	intergen
3	171168239	171168522	MACS_peak_14521	575.98	283	0	1	0	gen
3	171566865	171567118	MACS_peak_14523	470.06	253	0	0	0	intergen
3	171627365	171627765	MACS_peak_14524	58.88	400	0	1	0	gen
3	171639492	171639751	MACS_peak_14525	468.05	259	0	1	0	gen
3	171646423	171646696	MACS_peak_14526	987.75	273	0	1	0	gen
3	171718940	171719170	MACS_peak_14527	678.9	230	0	1	0	gen
3	171770880	171771018	MACS_peak_14528	682.8	138	0	1	0	gen
3	171772584	171772874	MACS_peak_14529	531.56	290	0	1	0	gen
3	171834237	171834502	MACS_peak_14530	589.61	265	0	0	0	intergen
3	171989498	171989840	MACS_peak_14531	483.6	342	0	0	0	intergen
3	172334021	172334327	MACS_peak_14532	520.52	306	0	1	0	gen
3	172548092	172548286	MACS_peak_14533	819.6	194	0	0	0	intergen
3	172623192	172623521	MACS_peak_14534	544.83	329	0	0	0	intergen
3	172623913	172624280	MACS_peak_14535	519.17	367	0	0	0	intergen
3	172673117	172673444	MACS_peak_14536	1194.67	327	0	1	0	gen
3	172997335	172997600	MACS_peak_14537	845.32	265	0	1	0	gen
3	173004429	173004564	MACS_peak_14538	1358.26	135	0	1	0	gen
3	173371894	173372196	MACS_peak_14539	1384.77	302	0	0	0	intergen
3	173446852	173447235	MACS_peak_14540	56.37	383	0	1	0	gen
3	173498900	173499376	MACS_peak_14541	76.79	476	0	1	0	gen
3	173529115	173529404	MACS_peak_14542	970.02	289	0	1	0	gen
3	173567353	173567674	MACS_peak_14543	803.76	321	0	1	0	gen
3	173733051	173733483	MACS_peak_14544	603.09	432	0	1	0	gen
3	173781687	173782042	MACS_peak_14545	721.05	355	0	1	0	gen
3	174125242	174125511	MACS_peak_14546	717.14	269	0	1	0	gen
3	174170342	174170496	MACS_peak_14547	918.92	154	0	1	0	gen
3	174194650	174195090	MACS_peak_14548	349.84	440	0	1	0	gen
3	174397954	174398172	MACS_peak_14549	729.14	218	0	0	0	intergen
3	174520668	174520867	MACS_peak_14550	831.63	199	0	1	0	gen
3	174843608	174843852	MACS_peak_14553	918.92	244	0	1	0	gen
3	174885791	174886056	MACS_peak_14554	198.49	265	0	1	0	gen
3	175251050	175251369	MACS_peak_14555	380.3	319	0	1	1	gen
3	175266733	175267051	MACS_peak_14556	551.85	318	0	1	1	gen
3	175362998	175363394	MACS_peak_14557	203.39	396	0	1	0	gen
3	175491196	175491444	MACS_peak_14558	1844.9	248	0	1	0	gen
3	175670211	175670608	MACS_peak_14559	506.92	397	0	1	0	gen
3	175841107	175841486	MACS_peak_14561	93.4	379	0	0	0	intergen
3	175897142	175897375	MACS_peak_14562	538.37	233	0	0	0	intergen
3	175948188	175948400	MACS_peak_14563	1098.16	212	0	0	0	intergen
3	176187895	176188162	MACS_peak_14565	845.32	267	0	0	0	intergen
3	176430337	176430553	MACS_peak_14567	496.96	216	0	0	0	intergen
3	176832159	176832438	MACS_peak_14568	56.38	279	0	0	1	other
3	176856145	176856360	MACS_peak_14569	596.79	215	0	0	1	other
3	176863719	176864046	MACS_peak_14570	73.52	327	0	0	1	other
3	176864140	176864466	MACS_peak_14571	62.68	326	0	0	1	other
3	177381635	177381980	MACS_peak_14572	380.3	345	0	0	0	intergen
3	177390181	177390636	MACS_peak_14573	76.59	455	0	0	0	intergen
3	178013824	178014127	MACS_peak_14574	79.89	303	0	0	0	intergen
3	178015517	178015881	MACS_peak_14575	89.06	364	0	0	0	intergen
3	178111756	178112129	MACS_peak_14576	1022.96	373	0	0	0	intergen
3	178190608	178190867	MACS_peak_14577	265.34	259	0	0	0	intergen
3	178720577	178720967	MACS_peak_14578	61.22	390	0	2	1	gen
3	178730942	178731238	MACS_peak_14579	1246.38	296	0	2	1	gen
3	179011514	179011647	MACS_peak_14580	1201.31	133	0	0	0	intergen
3	179015425	179015786	MACS_peak_14581	397.74	361	1	0	0	promoter
3	179280766	179281062	MACS_peak_14582	349.84	296	0	0	0	intergen
3	179382175	179382598	MACS_peak_14583	105.65	423	0	1	0	gen
3	179558799	179559221	MACS_peak_14584	2214.43	422	1	0	0	promoter
3	179619807	179620013	MACS_peak_14585	185.79	206	0	1	0	gen
3	179750797	179751063	MACS_peak_14586	463.44	266	0	1	0	gen
3	179797488	179797850	MACS_peak_14588	410.45	362	1	0	0	promoter
3	179811591	179811878	MACS_peak_14589	417.57	287	0	1	0	gen
3	179929150	179929556	MACS_peak_14590	864.57	406	0	1	0	gen
3	180042855	180043195	MACS_peak_14591	58.24	340	0	0	0	intergen
3	180082812	180082991	MACS_peak_14592	746.04	179	0	0	0	intergen
3	180084853	180085117	MACS_peak_14593	464.74	264	0	0	0	intergen
3	180120785	180121109	MACS_peak_14594	127.5	324	0	0	0	intergen
3	180208645	180208954	MACS_peak_14595	437.6	309	0	0	0	intergen
3	180253005	180253190	MACS_peak_14596	1161.41	185	0	0	0	intergen
3	180374067	180374523	MACS_peak_14597	167.1	456	0	0	0	intergen
3	180430442	180430787	MACS_peak_14598	173.28	345	0	0	0	intergen
3	180452379	180452766	MACS_peak_14599	54.86	387	0	0	0	intergen
3	180484518	180484756	MACS_peak_14600	122.84	238	0	0	0	intergen
3	180567433	180567672	MACS_peak_14601	284.38	239	0	0	1	other
3	180707403	180707625	MACS_peak_14602	831.64	222	0	1	0	gen
3	180802825	180803170	MACS_peak_14603	418.68	345	0	1	1	gen
3	180964294	180964667	MACS_peak_14604	405.33	373	0	1	0	gen
3	181176710	181176887	MACS_peak_14605	763.02	177	0	0	1	other
3	181210269	181210566	MACS_peak_14606	565.98	297	0	0	1	other
3	181948249	181948553	MACS_peak_14608	440.4	304	0	0	0	intergen
3	182678425	182678557	MACS_peak_14611	1116.4	132	0	0	0	intergen
3	183031487	183031713	MACS_peak_14612	347.46	226	0	1	0	gen
3	183171712	183172163	MACS_peak_14613	3100	451	0	0	0	intergen
3	183184576	183184928	MACS_peak_14614	652.21	352	0	1	0	gen
3	183234850	183235177	MACS_peak_14615	65.46	327	0	1	0	gen
3	183382480	183382715	MACS_peak_14616	604.07	235	0	1	0	gen
3	183469353	183469719	MACS_peak_14617	618.41	366	0	0	0	intergen
3	183738656	183738973	MACS_peak_14618	109.53	317	0	1	0	gen
3	183884813	183885116	MACS_peak_14619	561.84	303	0	0	0	intergen
3	183895302	183895499	MACS_peak_14620	1392.02	197	0	0	0	intergen
3	184025020	184025267	MACS_peak_14621	445.67	247	0	0	0	intergen
3	184129098	184129407	MACS_peak_14622	437.6	309	0	0	0	intergen
3	184162333	184162577	MACS_peak_14623	501.16	244	0	1	0	gen
3	184174585	184174872	MACS_peak_14624	682.8	287	1	0	0	promoter
3	184250410	184250754	MACS_peak_14625	389.72	344	2	0	0	promoter
3	184468370	184468685	MACS_peak_14626	678.97	315	0	0	0	intergen
3	184469393	184469677	MACS_peak_14627	575.25	284	0	0	0	intergen
3	184541186	184541360	MACS_peak_14628	780.06	174	0	0	0	intergen
3	184561343	184561606	MACS_peak_14629	603.02	263	1	0	0	promoter
3	184697458	184697602	MACS_peak_14630	656.44	144	0	0	0	intergen
3	184748528	184748954	MACS_peak_14631	491.76	426	0	0	0	intergen
3	184803306	184803586	MACS_peak_14632	899.22	280	0	0	0	intergen
3	185230500	185230898	MACS_peak_14633	286.49	398	0	1	0	gen
3	185559074	185559306	MACS_peak_14634	407.44	232	0	0	0	intergen
3	185563720	185564057	MACS_peak_14635	169.88	337	0	0	0	intergen
3	185569743	185569974	MACS_peak_14636	332.27	231	0	0	0	intergen
3	185629095	185629336	MACS_peak_14637	588.69	241	0	1	0	gen
3	185660492	185660709	MACS_peak_14638	746.04	217	0	1	0	gen
3	185943576	185943930	MACS_peak_14639	1119.94	354	0	0	0	intergen
3	185983639	185983824	MACS_peak_14640	582.91	185	0	0	0	intergen
3	186379782	186380113	MACS_peak_14641	57.86	331	0	0	0	intergen
3	186540572	186540840	MACS_peak_14642	718.04	268	1	0	0	promoter
3	186614901	186615138	MACS_peak_14643	1282.94	237	1	0	1	promoter
3	186833546	186833682	MACS_peak_14644	1061.85	136	0	0	0	intergen
3	186904415	186904752	MACS_peak_14645	93.4	337	0	0	0	intergen
3	186905613	186905832	MACS_peak_14646	443.63	219	0	0	0	intergen
3	187000631	187000877	MACS_peak_14647	485.56	246	0	1	0	gen
3	187001678	187002049	MACS_peak_14648	178.37	371	0	1	0	gen
3	187220149	187220509	MACS_peak_14649	646.8	360	1	0	0	promoter
3	187318816	187319127	MACS_peak_14650	556.45	311	0	0	0	intergen
3	187428258	187428573	MACS_peak_14651	54.85	315	0	0	0	intergen
3	187658810	187659217	MACS_peak_14652	1102.85	407	0	0	0	intergen
3	187678985	187679222	MACS_peak_14653	604.07	237	0	0	0	intergen
3	187679698	187680050	MACS_peak_14654	778.35	352	0	0	0	intergen
3	187748084	187748294	MACS_peak_14655	613.04	210	0	0	0	intergen
3	187865343	187865697	MACS_peak_14656	51.03	354	0	0	0	intergen
3	187917316	187917568	MACS_peak_14658	425.33	252	0	0	0	intergen
3	188186974	188187235	MACS_peak_14659	1001.77	261	0	1	0	gen
3	188363801	188363935	MACS_peak_14661	877.68	134	0	1	0	gen
3	188374711	188375116	MACS_peak_14662	75.42	405	0	1	0	gen
3	188415960	188416246	MACS_peak_14663	450.92	286	0	1	0	gen
3	188537820	188538054	MACS_peak_14664	532.66	234	0	1	0	gen
3	188544736	188545101	MACS_peak_14665	94.4	365	0	1	0	gen
3	188749074	188749384	MACS_peak_14666	682.83	310	0	1	0	gen
3	188755722	188755965	MACS_peak_14667	804.69	243	0	1	0	gen
3	188784200	188784454	MACS_peak_14668	470.06	254	0	1	0	gen
3	188817348	188817589	MACS_peak_14670	396.1	241	0	1	0	gen
3	188956820	188957196	MACS_peak_14671	739	376	0	1	0	gen
3	189178919	189179201	MACS_peak_14672	705.71	282	0	1	0	gen
3	189444667	189445019	MACS_peak_14673	54.66	352	0	0	0	intergen
3	189559460	189559845	MACS_peak_14675	97.54	385	0	0	0	intergen
3	189741607	189741815	MACS_peak_14676	459.7	208	0	1	0	gen
3	189961507	189961807	MACS_peak_14677	442.68	300	0	0	0	intergen
3	189967339	189967509	MACS_peak_14678	719.86	170	0	1	0	gen
3	190158086	190158330	MACS_peak_14679	454.18	244	0	0	0	intergen
3	190200717	190201038	MACS_peak_14680	1074.74	321	0	0	0	intergen
3	190269980	190270202	MACS_peak_14681	175.39	222	0	0	0	intergen
3	190322402	190322596	MACS_peak_14682	1245.57	194	1	0	0	promoter
3	190424395	190424772	MACS_peak_14683	516.8	377	1	0	0	promoter
3	190735681	190735950	MACS_peak_14684	968.3	269	0	0	0	intergen
3	190856112	190856580	MACS_peak_14685	700.24	468	1	0	0	promoter
3	190884257	190884570	MACS_peak_14686	1630.42	313	0	1	0	gen
3	191244321	191244592	MACS_peak_14687	850.57	271	0	1	0	gen
3	191427797	191427946	MACS_peak_14688	931.22	149	0	0	1	other
3	191465419	191465686	MACS_peak_14689	55.49	267	1	0	1	promoter
3	191529472	191529661	MACS_peak_14690	883.81	189	0	0	1	other
3	191670730	191671028	MACS_peak_14691	229.83	298	0	0	0	intergen
3	191751681	191751935	MACS_peak_14692	596.79	254	0	0	0	intergen
3	192028445	192028763	MACS_peak_14693	1192.27	318	0	0	0	intergen
3	192130565	192130810	MACS_peak_14694	760.34	245	0	0	0	intergen
3	192152372	192152743	MACS_peak_14695	122.07	371	0	1	0	gen
3	192212364	192212635	MACS_peak_14696	990.05	271	0	1	0	gen
3	192423122	192423322	MACS_peak_14697	645.81	200	0	1	0	gen
3	192444560	192444771	MACS_peak_14698	596.79	211	0	1	0	gen
3	192467248	192467575	MACS_peak_14699	669.95	327	0	1	0	gen
3	192607645	192608005	MACS_peak_14700	411.4	360	0	1	0	gen
3	192772598	192772822	MACS_peak_14701	1025.76	224	0	0	0	intergen
3	192974321	192974537	MACS_peak_14702	1150.33	216	0	0	0	intergen
3	193006029	193006232	MACS_peak_14703	604.21	203	0	0	0	intergen
3	193582493	193582863	MACS_peak_14704	520.65	370	0	1	1	gen
3	193606729	193607000	MACS_peak_14705	77.03	271	0	1	0	gen
3	193780860	193781046	MACS_peak_14706	901.33	186	0	0	0	intergen
3	193788205	193788380	MACS_peak_14707	780.06	175	0	0	0	intergen
3	194343894	194344254	MACS_peak_14709	901.78	360	1	0	0	promoter
3	194472231	194472599	MACS_peak_14710	894.97	368	0	1	0	gen
3	194594723	194595094	MACS_peak_14711	1019.52	371	0	1	0	gen
3	194914476	194914634	MACS_peak_14712	553.97	158	0	0	0	intergen
3	194985085	194985336	MACS_peak_14713	485.56	251	0	0	0	intergen
3	195215011	195215439	MACS_peak_14714	71.64	428	0	1	0	gen
3	195424277	195424416	MACS_peak_14715	685.04	139	0	1	0	gen
3	195522350	195522705	MACS_peak_14717	413.79	355	0	1	0	gen
3	195624749	195624970	MACS_peak_14719	1390.02	221	0	0	0	intergen
3	195653559	195653853	MACS_peak_14720	524.57	294	0	0	0	intergen
3	195855967	195856381	MACS_peak_14721	413.74	414	0	0	1	other
3	195859331	195859662	MACS_peak_14722	972.38	331	1	0	1	promoter
3	195994486	195994800	MACS_peak_14723	510.43	314	0	0	0	intergen
3	196068125	196068313	MACS_peak_14724	883.81	188	0	1	0	gen
3	196537318	196537582	MACS_peak_14725	447.99	264	0	0	0	intergen
3	196609317	196609617	MACS_peak_14726	690.75	300	0	0	0	intergen
3	196684932	196685149	MACS_peak_14727	1276.33	217	0	1	0	gen
3	196759397	196759540	MACS_peak_14728	689.56	143	0	1	0	gen
3	196837910	196838173	MACS_peak_14729	680.87	263	0	0	0	intergen
3	196898558	196898990	MACS_peak_14730	934.75	432	0	1	0	gen
3	197156862	197157107	MACS_peak_14731	629.38	245	0	1	0	gen
3	197256930	197257126	MACS_peak_14732	486.42	196	0	1	0	gen
3	197411722	197412046	MACS_peak_14733	53.76	324	0	0	0	intergen
3	197510206	197510547	MACS_peak_14734	894.65	341	1	0	0	promoter
3	197632035	197632407	MACS_peak_14735	876.66	372	0	0	0	intergen
3	197665138	197665359	MACS_peak_14736	1396.21	221	0	0	1	other
3	197807107	197807239	MACS_peak_14737	950.58	132	0	1	0	gen
3	197942981	197943313	MACS_peak_14738	1238.08	332	0	1	0	gen
3	197992086	197992218	MACS_peak_14739	1116.4	132	0	1	0	gen
3	198089547	198089742	MACS_peak_14740	514.01	195	0	0	0	intergen
3	198102281	198102759	MACS_peak_14743	510.43	478	0	0	0	intergen
3	198157110	198157495	MACS_peak_14744	825.12	385	0	0	1	other
3	198163291	198163612	MACS_peak_14745	419.87	321	0	0	1	other
3	198214329	198214566	MACS_peak_14747	825.98	237	0	0	1	other
3	198217743	198217980	MACS_peak_14748	929.7	237	0	0	1	other
4	21079	21471	MACS_peak_14749	844.39	392	0	0	0	intergen
4	29089	29412	MACS_peak_14750	1548.55	323	0	0	0	intergen
4	44768	45067	MACS_peak_14751	634.13	299	0	0	0	intergen
4	259217	259454	MACS_peak_14752	775.87	237	0	0	0	intergen
4	602690	603014	MACS_peak_14753	801.19	324	0	0	0	intergen
4	926644	926844	MACS_peak_14754	645.81	200	0	1	0	gen
4	1130608	1130925	MACS_peak_14755	413.23	317	0	0	2	other
4	1707048	1707379	MACS_peak_14758	181.92	331	0	1	0	gen
4	2230389	2230709	MACS_peak_14759	438.69	320	1	1	0	promoter
4	2354240	2354498	MACS_peak_14760	488.85	258	0	1	0	gen
4	3136360	3136723	MACS_peak_14761	524.58	363	0	1	0	gen
4	3800034	3800218	MACS_peak_14762	710.43	184	0	0	0	intergen
4	3893725	3894073	MACS_peak_14763	410.97	348	0	0	0	intergen
4	3942403	3942765	MACS_peak_14764	845.32	362	0	0	2	other
4	3984742	3985208	MACS_peak_14765	1339.11	466	0	0	0	intergen
4	4090799	4091014	MACS_peak_14766	1079.97	215	0	0	1	other
4	4161244	4161716	MACS_peak_14767	568.39	472	0	0	0	intergen
4	4430703	4430900	MACS_peak_14768	662.31	197	0	1	0	gen
4	4480604	4480856	MACS_peak_14769	470.06	252	0	1	1	gen
4	4489264	4489531	MACS_peak_14770	265.34	267	0	1	0	gen
4	5273503	5273793	MACS_peak_14773	58.18	290	0	1	0	gen
4	5332965	5333393	MACS_peak_14775	76.42	428	0	1	0	gen
4	5335365	5335748	MACS_peak_14776	96.9	383	0	1	0	gen
4	5460226	5460472	MACS_peak_14777	485.56	246	0	1	0	gen
4	5521790	5522088	MACS_peak_14778	119.21	298	0	0	0	intergen
4	5523319	5523717	MACS_peak_14779	104.01	398	0	0	0	intergen
4	5727256	5727486	MACS_peak_14780	96.34	230	0	1	0	gen
4	6250734	6250993	MACS_peak_14781	594.37	259	0	0	0	intergen
4	6625932	6626167	MACS_peak_14782	1201.14	235	0	0	0	intergen
4	6654949	6655268	MACS_peak_14783	93.4	319	0	0	1	other
4	7844342	7844571	MACS_peak_14784	548.55	229	0	1	0	gen
4	8242186	8242470	MACS_peak_14786	452.13	284	0	0	0	intergen
4	8407004	8407311	MACS_peak_14787	1065.38	307	0	1	0	gen
4	8624930	8625380	MACS_peak_14788	732.96	450	0	0	0	intergen
4	8630566	8630907	MACS_peak_14789	778.03	341	0	0	0	intergen
4	8636216	8636557	MACS_peak_14790	838.31	341	0	0	0	intergen
4	9017426	9017648	MACS_peak_14792	2501.15	222	0	0	0	intergen
4	9103034	9103468	MACS_peak_14793	1472.63	434	0	0	1	other
4	9123625	9123898	MACS_peak_14794	583.44	273	0	0	1	other
4	9217319	9217633	MACS_peak_14795	103.45	314	2	0	0	promoter
4	9217981	9218348	MACS_peak_14796	196.73	367	2	0	0	promoter
4	9222729	9223096	MACS_peak_14797	126.22	367	2	0	0	promoter
4	9226810	9227124	MACS_peak_14798	164.26	314	1	0	0	promoter
4	9227538	9227840	MACS_peak_14799	164.26	302	1	0	0	promoter
4	9231555	9231869	MACS_peak_14800	146.7	314	1	0	0	promoter
4	9232217	9232584	MACS_peak_14801	188.8	367	1	0	0	promoter
4	9236297	9236611	MACS_peak_14802	119.09	314	1	0	0	promoter
4	9236960	9237327	MACS_peak_14803	143.68	367	1	0	0	promoter
4	9241707	9242074	MACS_peak_14804	130.34	367	1	0	0	promoter
4	9245793	9246107	MACS_peak_14805	146.7	314	2	0	0	promoter
4	9246456	9246823	MACS_peak_14806	136.82	367	2	0	0	promoter
4	9250544	9250858	MACS_peak_14807	113.74	314	2	0	0	promoter
4	9251206	9251573	MACS_peak_14808	173.12	367	2	0	0	promoter
4	9255317	9255743	MACS_peak_14809	96.64	426	2	0	0	promoter
4	9255955	9256322	MACS_peak_14810	114.7	367	2	0	0	promoter
4	9260701	9261068	MACS_peak_14811	168.25	367	2	0	0	promoter
4	9264786	9265100	MACS_peak_14812	94.6	314	2	0	0	promoter
4	9265601	9265816	MACS_peak_14813	196.3	215	2	0	0	promoter
4	9269533	9269845	MACS_peak_14814	115.7	312	2	0	0	promoter
4	9270196	9270563	MACS_peak_14815	134.62	367	2	0	0	promoter
4	9322997	9323364	MACS_peak_14816	206.31	367	1	0	0	promoter
4	9327742	9328109	MACS_peak_14817	123.03	367	2	0	0	promoter
4	9332488	9332855	MACS_peak_14818	122.24	367	2	0	0	promoter
4	9337235	9337602	MACS_peak_14819	122.24	367	2	0	0	promoter
4	9341980	9342347	MACS_peak_14820	173.62	367	2	0	0	promoter
4	9346725	9347092	MACS_peak_14821	87.09	367	2	0	0	promoter
4	9351470	9351837	MACS_peak_14822	88.07	367	2	0	0	promoter
4	9356215	9356582	MACS_peak_14823	173.62	367	1	0	0	promoter
4	9360960	9361327	MACS_peak_14824	172.13	367	1	0	0	promoter
4	9365706	9366073	MACS_peak_14825	118.4	367	1	0	0	promoter
4	9381200	9381575	MACS_peak_14826	760.94	375	0	0	0	intergen
4	9495511	9495846	MACS_peak_14827	541.11	335	0	0	1	other
4	9620774	9621084	MACS_peak_14828	79.68	310	0	0	0	intergen
4	9629844	9630202	MACS_peak_14829	50.92	358	0	0	0	intergen
4	9659675	9660141	MACS_peak_14830	1074.34	466	0	0	0	intergen
4	9696043	9696220	MACS_peak_14831	626.48	177	0	0	1	other
4	9734290	9734427	MACS_peak_14832	744.12	137	0	0	1	other
4	9762975	9763340	MACS_peak_14833	523.45	365	0	0	0	intergen
4	10018709	10019141	MACS_peak_14834	603.09	432	0	1	0	gen
4	10554721	10554981	MACS_peak_14835	467.38	260	0	1	0	gen
4	10582091	10582454	MACS_peak_14836	769.88	363	0	1	0	gen
4	10656331	10656553	MACS_peak_14837	564.54	222	0	1	0	gen
4	10716242	10716453	MACS_peak_14838	596.79	211	0	0	0	intergen
4	10778263	10778580	MACS_peak_14839	69.95	317	0	0	0	intergen
4	11064907	11065266	MACS_peak_14840	57.98	359	0	0	0	intergen
4	11145190	11145457	MACS_peak_14841	98.47	267	0	0	0	intergen
4	11216849	11217135	MACS_peak_14842	573.79	286	0	0	0	intergen
4	11370448	11370743	MACS_peak_14843	84.4	295	0	0	0	intergen
4	11377150	11377350	MACS_peak_14844	271.16	200	0	0	0	intergen
4	11562904	11563362	MACS_peak_14845	51.32	458	0	0	0	intergen
4	12092080	12092451	MACS_peak_14846	105.65	371	0	0	0	intergen
4	12093190	12093445	MACS_peak_14847	87.69	255	0	0	0	intergen
4	12337955	12338420	MACS_peak_14848	62.66	465	0	0	0	intergen
4	12343114	12343552	MACS_peak_14849	149.96	438	0	0	0	intergen
4	12510429	12510751	MACS_peak_14850	52.63	322	0	0	0	intergen
4	12714750	12715175	MACS_peak_14852	1109.13	425	0	0	0	intergen
4	12750526	12750820	MACS_peak_14853	88.56	294	0	0	0	intergen
4	12751210	12751667	MACS_peak_14854	58.28	457	0	0	0	intergen
4	12907141	12907515	MACS_peak_14855	53.29	374	0	0	0	intergen
4	13661382	13661727	MACS_peak_14856	76.3	345	0	0	1	other
4	13664085	13664430	MACS_peak_14857	53.91	345	0	0	1	other
4	13669266	13669640	MACS_peak_14858	380.3	374	0	0	1	other
4	13802671	13802902	MACS_peak_14859	125.57	231	0	0	1	other
4	13803138	13803476	MACS_peak_14860	71.13	338	0	0	1	other
4	13812812	13813143	MACS_peak_14861	1203.88	331	0	0	1	other
4	13937427	13937633	MACS_peak_14862	386.31	206	0	0	1	other
4	14011916	14012289	MACS_peak_14864	65.03	373	0	0	0	intergen
4	14012786	14013062	MACS_peak_14865	101.87	276	0	0	0	intergen
4	14207454	14207852	MACS_peak_14866	59.47	398	0	0	1	other
4	14211525	14211885	MACS_peak_14868	78.17	360	0	0	1	other
4	14722866	14723242	MACS_peak_14871	198.49	376	0	0	1	other
4	14833880	14834223	MACS_peak_14873	312.33	343	0	0	1	other
4	15042069	15042239	MACS_peak_14876	797.18	170	0	1	1	gen
4	15272428	15272651	MACS_peak_14878	564.54	223	0	0	1	other
4	15282233	15282483	MACS_peak_14879	60.61	250	0	0	1	other
4	15649903	15650287	MACS_peak_14880	513.02	384	0	1	0	gen
4	15867710	15868075	MACS_peak_14882	1102.85	365	0	0	0	intergen
4	15956348	15956630	MACS_peak_14883	576.71	282	1	0	0	promoter
4	16228559	16228927	MACS_peak_14884	306.6	368	0	0	1	other
4	16406781	16407165	MACS_peak_14885	134.2	384	0	0	1	other
4	16916788	16917060	MACS_peak_14886	459.58	272	0	0	0	intergen
4	17036843	17037059	MACS_peak_14887	580.62	216	0	0	1	other
4	17168941	17169107	MACS_peak_14888	810.9	166	0	0	0	intergen
4	17631946	17632189	MACS_peak_14889	210.25	243	1	1	0	promoter
4	17792649	17792953	MACS_peak_14890	56.38	304	0	0	0	intergen
4	17848850	17849210	MACS_peak_14891	207.85	360	0	1	0	gen
4	18095670	18095973	MACS_peak_14892	110.75	303	0	0	0	intergen
4	18266868	18267163	MACS_peak_14893	80.61	295	0	0	0	intergen
4	18367128	18367348	MACS_peak_14894	883.81	220	0	0	0	intergen
4	18494619	18494906	MACS_peak_14895	57.57	287	0	0	0	intergen
4	18549844	18550088	MACS_peak_14896	79.58	244	0	0	0	intergen
4	19077772	19077920	MACS_peak_14897	1213.79	148	0	0	0	intergen
4	19083357	19083683	MACS_peak_14898	66.5	326	0	0	0	intergen
4	19226346	19226715	MACS_peak_14899	380.3	369	0	0	1	other
4	19732356	19732636	MACS_peak_14901	77.54	280	0	0	1	other
4	19732914	19733176	MACS_peak_14902	78.86	262	0	0	1	other
4	19918538	19918847	MACS_peak_14903	219.35	309	0	0	0	intergen
4	19987005	19987392	MACS_peak_14904	488.85	387	0	0	0	intergen
4	20084953	20085280	MACS_peak_14905	312.33	327	0	0	0	intergen
4	20139182	20139407	MACS_peak_14906	548.55	225	0	0	0	intergen
4	20422482	20422681	MACS_peak_14907	645.81	199	0	1	0	gen
4	21015442	21015761	MACS_peak_14908	1076.9	319	0	1	0	gen
4	21071942	21072264	MACS_peak_14909	97.7	322	0	1	0	gen
4	21159710	21160068	MACS_peak_14910	61.45	358	0	1	0	gen
4	21346080	21346324	MACS_peak_14911	501.16	244	0	1	0	gen
4	21444104	21444459	MACS_peak_14912	82.71	355	0	1	0	gen
4	21444482	21444775	MACS_peak_14913	106.48	293	0	1	0	gen
4	21581946	21582161	MACS_peak_14914	111.27	215	0	1	0	gen
4	21714731	21715086	MACS_peak_14915	155.24	355	0	1	1	gen
4	21765869	21766129	MACS_peak_14916	725.38	260	0	1	0	gen
4	21834560	21834837	MACS_peak_14917	74.52	277	0	1	0	gen
4	22079293	22079574	MACS_peak_14918	61.5	281	0	0	1	other
4	22149380	22149586	MACS_peak_14919	150.33	206	0	0	1	other
4	22151196	22151496	MACS_peak_14920	63.65	300	0	0	1	other
4	22886791	22887014	MACS_peak_14921	88.59	223	0	0	0	intergen
4	22904791	22905021	MACS_peak_14922	420.28	230	0	0	0	intergen
4	23135737	23136086	MACS_peak_14923	416.71	349	0	0	0	intergen
4	23199173	23199489	MACS_peak_14924	603.02	316	0	0	0	intergen
4	23249850	23249995	MACS_peak_14925	614.51	145	0	0	1	other
4	23283048	23283456	MACS_peak_14926	306.6	408	0	0	1	other
4	23539596	23539729	MACS_peak_14927	1312.37	133	0	0	0	intergen
4	23642359	23642829	MACS_peak_14928	302.34	470	0	0	1	other
4	23844389	23844738	MACS_peak_14929	416.71	349	0	1	0	gen
4	23910060	23910484	MACS_peak_14930	978.89	424	0	0	0	intergen
4	24419526	24419751	MACS_peak_14931	712.32	225	0	0	0	intergen
4	24687448	24687690	MACS_peak_14932	1079.97	242	0	0	0	intergen
4	24942315	24942676	MACS_peak_14933	126.04	361	0	1	0	gen
4	24942792	24943153	MACS_peak_14934	100.58	361	0	1	0	gen
4	24961714	24961960	MACS_peak_14935	177.42	246	0	1	0	gen
4	24980054	24980429	MACS_peak_14936	760.94	375	0	0	0	intergen
4	25367137	25367344	MACS_peak_14937	603.96	207	0	1	0	gen
4	26047752	26047887	MACS_peak_14938	1079.97	135	0	0	0	intergen
4	26168608	26168991	MACS_peak_14939	101.19	383	0	1	0	gen
4	26627150	26627414	MACS_peak_14940	53.69	264	0	1	0	gen
4	26627568	26627804	MACS_peak_14941	67.56	236	0	1	0	gen
4	26792568	26792807	MACS_peak_14942	516.86	239	0	0	0	intergen
4	27010487	27010694	MACS_peak_14944	613.04	207	0	1	0	gen
4	27633990	27634278	MACS_peak_14946	700.62	288	0	0	0	intergen
4	27835309	27835566	MACS_peak_14947	728.2	257	0	0	0	intergen
4	27861371	27861555	MACS_peak_14948	918.92	184	0	0	0	intergen
4	28410041	28410386	MACS_peak_14949	110.23	345	0	0	0	intergen
4	28599642	28599776	MACS_peak_14950	1098.16	134	0	0	1	other
4	28957521	28957784	MACS_peak_14951	591.18	263	0	0	0	intergen
4	29532282	29532471	MACS_peak_14952	204.96	189	0	0	0	intergen
4	29970569	29970872	MACS_peak_14953	440.97	303	0	0	0	intergen
4	30096912	30097124	MACS_peak_14954	1472.64	212	0	0	0	intergen
4	30269804	30270193	MACS_peak_14955	486.53	389	0	0	0	intergen
4	31233042	31233205	MACS_peak_14956	1549.78	163	0	0	0	intergen
4	31625507	31625794	MACS_peak_14957	701.46	287	0	0	0	intergen
4	31684595	31685043	MACS_peak_14958	97.38	448	0	0	0	intergen
4	31733940	31734229	MACS_peak_14959	488.85	289	0	0	0	intergen
4	31793922	31794244	MACS_peak_14960	549.27	322	0	0	0	intergen
4	31815558	31815834	MACS_peak_14961	457.06	276	0	0	0	intergen
4	31816337	31816719	MACS_peak_14962	1180.37	382	0	0	0	intergen
4	31817252	31817717	MACS_peak_14963	585.52	465	0	0	0	intergen
4	31817736	31818088	MACS_peak_14964	415.24	352	0	0	0	intergen
4	32016922	32017116	MACS_peak_14967	819.6	194	0	0	1	other
4	32126564	32126847	MACS_peak_14968	95.95	283	0	0	1	other
4	32130400	32130631	MACS_peak_14969	441.45	231	0	0	1	other
4	32832259	32832525	MACS_peak_14970	588.83	266	0	0	0	intergen
4	32840005	32840365	MACS_peak_14973	411.4	360	0	0	0	intergen
4	33060983	33061318	MACS_peak_14974	1199.31	335	0	0	0	intergen
4	33558135	33558533	MACS_peak_14975	96.97	398	0	0	0	intergen
4	33693354	33693692	MACS_peak_14976	534.92	338	0	0	0	intergen
4	33839560	33839891	MACS_peak_14977	77.11	331	0	0	1	other
4	34652712	34653115	MACS_peak_14978	57.86	403	0	0	0	intergen
4	35202075	35202385	MACS_peak_14979	557.12	310	0	0	0	intergen
4	35677971	35678315	MACS_peak_14981	61.13	344	0	0	0	intergen
4	35934449	35934723	MACS_peak_14982	847.52	274	0	0	0	intergen
4	36099326	36099564	MACS_peak_14983	1340.27	238	0	1	0	gen
4	36202216	36202448	MACS_peak_14984	510.52	232	0	1	0	gen
4	36381705	36382151	MACS_peak_14985	69.92	446	0	0	1	other
4	36906669	36906892	MACS_peak_14986	193.82	223	0	0	0	intergen
4	36976520	36976933	MACS_peak_14987	159.03	413	0	0	0	intergen
4	37940103	37940395	MACS_peak_14988	89.02	292	0	1	0	gen
4	37975577	37975826	MACS_peak_14989	744.66	249	0	1	0	gen
4	38077623	38077756	MACS_peak_14991	1098.16	133	0	1	0	gen
4	38339463	38339687	MACS_peak_14992	262.62	224	0	0	0	intergen
4	38380496	38380829	MACS_peak_14993	312.33	333	0	0	1	other
4	38675582	38675892	MACS_peak_14994	437.04	310	0	1	0	gen
4	38860949	38861164	MACS_peak_14995	596.79	215	0	0	0	intergen
4	39619322	39619546	MACS_peak_14996	1025.76	224	0	1	0	gen
4	39930211	39930351	MACS_peak_14997	603.93	140	0	1	0	gen
4	39976507	39976698	MACS_peak_14998	695.57	191	0	1	0	gen
4	40485967	40486105	MACS_peak_14999	1148.16	138	0	1	0	gen
4	40841054	40841326	MACS_peak_15000	459.58	272	0	1	0	gen
4	40976199	40976603	MACS_peak_15001	619.12	404	0	1	0	gen
4	41270579	41270925	MACS_peak_15002	64.79	346	0	0	0	intergen
4	41402069	41402378	MACS_peak_15003	70.69	309	0	1	0	gen
4	41530694	41530924	MACS_peak_15004	353.01	230	0	1	0	gen
4	41693543	41693916	MACS_peak_15005	518.99	373	0	1	0	gen
4	41888126	41888520	MACS_peak_15006	873.84	394	0	0	1	other
4	41958589	41958972	MACS_peak_15007	613.41	383	0	1	0	gen
4	42275053	42275398	MACS_peak_15008	76.3	345	0	0	0	intergen
4	42281927	42282343	MACS_peak_15009	612.12	416	0	0	1	other
4	43451438	43451810	MACS_peak_15010	519.54	372	0	0	0	intergen
4	43452092	43452539	MACS_peak_15011	834.88	447	0	0	0	intergen
4	43471989	43472253	MACS_peak_15012	464.74	264	0	0	1	other
4	43562116	43562351	MACS_peak_15013	516.86	235	0	0	0	intergen
4	43657736	43658128	MACS_peak_15014	124.4	392	0	0	0	intergen
4	43757676	43758027	MACS_peak_15015	415.73	351	0	0	0	intergen
4	44303122	44303445	MACS_peak_15016	103.97	323	0	1	0	gen
4	44493972	44494349	MACS_peak_15017	313.53	377	0	0	0	intergen
4	45015267	45015498	MACS_peak_15018	678.9	231	0	0	1	other
4	45184771	45185024	MACS_peak_15019	883.81	253	0	0	0	intergen
4	45547616	45547818	MACS_peak_15020	757.9	202	0	0	0	intergen
4	45653624	45653971	MACS_peak_15021	113.5	347	0	0	0	intergen
4	45654212	45654505	MACS_peak_15022	72.34	293	0	0	0	intergen
4	45721852	45722079	MACS_peak_15023	548.55	227	0	0	0	intergen
4	45807608	45807958	MACS_peak_15024	53.31	350	0	0	0	intergen
4	45915704	45915980	MACS_peak_15026	69	276	0	0	0	intergen
4	45933209	45933533	MACS_peak_15027	547.99	324	0	0	0	intergen
4	46467067	46467282	MACS_peak_15028	575.37	215	0	1	0	gen
4	46807539	46807819	MACS_peak_15029	578.19	280	0	1	0	gen
4	47122807	47123030	MACS_peak_15030	712.32	223	0	1	0	gen
4	47283258	47283407	MACS_peak_15032	689.09	149	0	1	0	gen
4	47564449	47564714	MACS_peak_15034	1141.07	265	0	1	0	gen
4	47668828	47669101	MACS_peak_15035	713.56	273	0	1	0	gen
4	48003518	48003869	MACS_peak_15036	779.13	351	0	2	0	gen
4	48104182	48104600	MACS_peak_15037	610.97	418	0	1	0	gen
4	48415638	48415923	MACS_peak_15038	76.59	285	0	1	0	gen
4	48649009	48649260	MACS_peak_15039	485.56	251	0	1	0	gen
4	48943830	48944110	MACS_peak_15040	722.05	280	0	0	0	intergen
4	48944724	48945042	MACS_peak_15041	551.85	318	0	0	0	intergen
4	49122169	49122484	MACS_peak_15047	169.66	315	0	0	0	intergen
4	49129479	49129780	MACS_peak_15049	66.61	301	0	0	0	intergen
4	49156836	49156993	MACS_peak_15058	101.13	157	0	0	0	intergen
4	49273596	49273830	MACS_peak_15059	382.21	234	0	0	0	intergen
4	49290008	49290323	MACS_peak_15060	65.37	315	0	0	0	intergen
4	49314795	49315127	MACS_peak_15061	1438.46	332	0	0	0	intergen
4	49510100	49510284	MACS_peak_15062	67.99	184	0	0	0	intergen
4	49512519	49512994	MACS_peak_15063	392.37	475	0	0	0	intergen
4	51796526	51796979	MACS_peak_15071	150.36	453	0	0	0	intergen
4	51798737	51799190	MACS_peak_15072	205.01	453	0	0	0	intergen
4	51800883	51801339	MACS_peak_15073	123.91	456	0	0	0	intergen
4	51807686	51808127	MACS_peak_15076	137.84	441	0	0	0	intergen
4	51809896	51810337	MACS_peak_15077	131.22	441	0	0	0	intergen
4	51814310	51814762	MACS_peak_15079	258.21	452	0	0	0	intergen
4	51976665	51976879	MACS_peak_15080	746.04	214	0	0	0	intergen
4	51985843	51986191	MACS_peak_15081	91.29	348	0	0	0	intergen
4	52167814	52168021	MACS_peak_15082	178.91	207	0	0	0	intergen
4	52394191	52394501	MACS_peak_15083	127.5	310	0	0	0	intergen
4	52449332	52449700	MACS_peak_15084	60.54	368	0	0	0	intergen
4	52540219	52540581	MACS_peak_15085	51.82	362	0	0	0	intergen
4	52818169	52818444	MACS_peak_15086	71.29	275	0	0	0	intergen
4	52896213	52896580	MACS_peak_15087	50.3	367	0	1	0	gen
4	53216954	53217195	MACS_peak_15088	270.08	241	0	1	0	gen
4	53313550	53313821	MACS_peak_15089	460.22	271	0	1	0	gen
4	53331476	53331875	MACS_peak_15090	97.64	399	0	1	0	gen
4	53407833	53408209	MACS_peak_15091	131.65	376	0	2	0	gen
4	53432806	53433181	MACS_peak_15092	391.26	375	0	2	0	gen
4	53491043	53491323	MACS_peak_15093	454.58	280	0	2	0	gen
4	53825630	53825928	MACS_peak_15095	50.54	298	0	1	0	gen
4	53882014	53882282	MACS_peak_15096	77.87	268	0	1	0	gen
4	53896855	53897226	MACS_peak_15097	178.37	371	0	1	0	gen
4	54063079	54063282	MACS_peak_15098	629.38	203	0	2	0	gen
4	54234336	54234595	MACS_peak_15099	726.32	259	0	2	0	gen
4	54647851	54647996	MACS_peak_15100	1044.89	145	0	0	0	intergen
4	55046399	55046621	MACS_peak_15102	119.34	222	0	0	0	intergen
4	55343010	55343155	MACS_peak_15103	1142.17	145	1	0	0	promoter
4	55400116	55400555	MACS_peak_15104	406.81	439	1	0	0	promoter
4	55510635	55510768	MACS_peak_15105	1396.21	133	0	1	0	gen
4	55710534	55710917	MACS_peak_15107	186.49	383	0	0	0	intergen
4	55845287	55845572	MACS_peak_15108	79.96	285	0	0	0	intergen
4	56303186	56303368	MACS_peak_15109	687.62	182	0	1	0	gen
4	56424917	56425149	MACS_peak_15110	532.66	232	0	1	1	gen
4	56685989	56686245	MACS_peak_15111	470.06	256	0	0	0	intergen
4	56800278	56800517	MACS_peak_15112	615.94	239	0	0	0	intergen
4	56888844	56889120	MACS_peak_15113	174.69	276	0	0	0	intergen
4	56960345	56960511	MACS_peak_15114	810.9	166	1	1	0	promoter
4	57164059	57164304	MACS_peak_15115	501.16	245	0	0	1	other
4	57298602	57298767	MACS_peak_15116	347.99	165	0	0	0	intergen
4	57326124	57326346	MACS_peak_15117	261.01	222	0	0	0	intergen
4	57478947	57479215	MACS_peak_15118	853.65	268	0	0	0	intergen
4	57519819	57520292	MACS_peak_15119	147.82	473	0	0	0	intergen
4	57534487	57534763	MACS_peak_15120	158.81	276	0	0	0	intergen
4	57664072	57664376	MACS_peak_15121	72.53	304	0	0	0	intergen
4	57770107	57770470	MACS_peak_15122	59.76	363	0	0	0	intergen
4	57886217	57886566	MACS_peak_15123	99.05	349	0	0	0	intergen
4	57918074	57918334	MACS_peak_15125	114.74	260	0	0	0	intergen
4	58025760	58026109	MACS_peak_15126	53.6	349	0	0	0	intergen
4	58026484	58026835	MACS_peak_15127	69	351	0	0	0	intergen
4	58027660	58028036	MACS_peak_15128	80.5	376	0	0	0	intergen
4	58302359	58302504	MACS_peak_15129	658.5	145	0	0	0	intergen
4	58374860	58375110	MACS_peak_15130	100.52	250	0	0	0	intergen
4	58397679	58398140	MACS_peak_15131	87.62	461	0	0	0	intergen
4	59083487	59083810	MACS_peak_15133	65.12	323	0	0	0	intergen
4	59084857	59085133	MACS_peak_15134	192.33	276	0	0	0	intergen
4	59184854	59185139	MACS_peak_15135	75.01	285	0	0	0	intergen
4	59531660	59531886	MACS_peak_15136	270.24	226	0	0	0	intergen
4	60201151	60201401	MACS_peak_15137	613.04	250	0	0	0	intergen
4	60284208	60284420	MACS_peak_15138	450.48	212	0	0	0	intergen
4	60441371	60441640	MACS_peak_15139	586.5	269	0	0	0	intergen
4	60731362	60731714	MACS_peak_15140	118	352	0	0	0	intergen
4	61023351	61023728	MACS_peak_15141	65.03	377	0	0	0	intergen
4	61134747	61135124	MACS_peak_15142	88.13	377	0	0	0	intergen
4	61755195	61755585	MACS_peak_15143	95.65	390	0	1	0	gen
4	61759259	61759587	MACS_peak_15144	177.47	328	0	1	0	gen
4	61972882	61973184	MACS_peak_15147	383.01	302	0	1	0	gen
4	62376970	62377218	MACS_peak_15148	485.56	248	0	0	0	intergen
4	62595185	62595510	MACS_peak_15149	950.42	325	0	0	0	intergen
4	62605753	62606201	MACS_peak_15150	78.87	448	0	0	0	intergen
4	62607316	62607729	MACS_peak_15151	118.48	413	0	0	0	intergen
4	63102165	63102418	MACS_peak_15152	91.94	253	0	0	0	intergen
4	63534016	63534398	MACS_peak_15153	58.27	382	0	0	0	intergen
4	63917976	63918349	MACS_peak_15155	76.3	373	0	0	0	intergen
4	63948689	63948921	MACS_peak_15156	113.93	232	0	0	0	intergen
4	64375928	64376198	MACS_peak_15157	851.59	270	0	1	0	gen
4	64547026	64547278	MACS_peak_15158	613.04	252	0	0	0	intergen
4	64713288	64713616	MACS_peak_15159	545.46	328	0	0	0	intergen
4	64741787	64742133	MACS_peak_15160	82.83	346	0	0	0	intergen
4	64900672	64900946	MACS_peak_15161	158.81	274	0	0	0	intergen
4	65177791	65178097	MACS_peak_15162	69.61	306	0	0	0	intergen
4	65293167	65293455	MACS_peak_15164	87.93	288	0	0	0	intergen
4	65483028	65483305	MACS_peak_15165	113.79	277	0	1	0	gen
4	65769824	65770217	MACS_peak_15166	115.83	393	0	0	0	intergen
4	65940875	65941112	MACS_peak_15167	406.23	237	0	0	0	intergen
4	66111159	66111509	MACS_peak_15168	93.4	350	0	0	1	other
4	66111899	66112177	MACS_peak_15169	69	278	0	0	1	other
4	66113823	66114143	MACS_peak_15170	100.01	320	0	0	1	other
4	66257184	66257637	MACS_peak_15171	142.8	453	0	0	0	intergen
4	66440604	66440740	MACS_peak_15172	1061.85	136	0	0	0	intergen
4	66495524	66495791	MACS_peak_15173	76.67	267	0	0	0	intergen
4	66657158	66657315	MACS_peak_15174	730.64	157	0	0	0	intergen
4	66969124	66969489	MACS_peak_15175	81.3	365	0	0	0	intergen
4	66996387	66996614	MACS_peak_15176	168.41	227	0	0	0	intergen
4	67176175	67176631	MACS_peak_15177	87.55	456	0	0	0	intergen
4	67327311	67327546	MACS_peak_15178	456.86	235	0	0	0	intergen
4	67657438	67657814	MACS_peak_15180	130.59	376	0	1	0	gen
4	67893031	67893233	MACS_peak_15181	400.13	202	0	0	1	other
4	67910356	67910623	MACS_peak_15182	462.79	267	1	0	1	promoter
4	67918458	67918738	MACS_peak_15183	707.43	280	0	1	1	gen
4	67961394	67961605	MACS_peak_15184	107.74	211	0	1	1	gen
4	68202467	68202926	MACS_peak_15186	118.84	459	0	0	2	other
4	68303652	68303807	MACS_peak_15187	1262.63	155	0	0	0	intergen
4	68606458	68606592	MACS_peak_15188	712.83	134	0	0	0	intergen
4	68717849	68718201	MACS_peak_15189	524.76	352	0	0	0	intergen
4	68770240	68770517	MACS_peak_15190	105.65	277	0	0	0	intergen
4	69304073	69304393	MACS_peak_15191	105.17	320	0	0	0	intergen
4	69319689	69320054	MACS_peak_15192	79.44	365	0	0	0	intergen
4	69689572	69689818	MACS_peak_15193	485.56	246	0	0	0	intergen
4	70018272	70018587	MACS_peak_15194	53.12	315	0	0	0	intergen
4	70183674	70184104	MACS_peak_15195	723.39	430	0	0	0	intergen
4	70620328	70620683	MACS_peak_15196	413.79	355	0	0	0	intergen
4	70620923	70621214	MACS_peak_15197	570.2	291	0	0	0	intergen
4	70688051	70688429	MACS_peak_15199	403.06	378	1	0	0	promoter
4	70918826	70919203	MACS_peak_15200	75.69	377	0	1	0	gen
4	71016656	71016919	MACS_peak_15201	138.55	263	0	2	0	gen
4	71086739	71087042	MACS_peak_15202	131.72	303	0	1	0	gen
4	71087545	71087749	MACS_peak_15203	151.6	204	0	1	0	gen
4	71113355	71113616	MACS_peak_15204	316.62	261	0	1	0	gen
4	71143163	71143635	MACS_peak_15205	86.78	472	0	1	0	gen
4	71177842	71178102	MACS_peak_15206	84.06	260	0	1	0	gen
4	71423742	71424067	MACS_peak_15207	53.45	325	0	1	0	gen
4	71553761	71554033	MACS_peak_15208	584.2	272	0	1	0	gen
4	71735036	71735373	MACS_peak_15209	121.6	337	0	0	0	intergen
4	71941125	71941295	MACS_peak_15210	797.18	170	0	0	0	intergen
4	72129176	72129469	MACS_peak_15211	155.19	293	0	1	0	gen
4	72166624	72166926	MACS_peak_15212	66.89	302	0	0	0	intergen
4	72167068	72167267	MACS_peak_15213	132.87	199	0	0	0	intergen
4	72286312	72286652	MACS_peak_15214	660.56	340	0	1	0	gen
4	72469012	72469201	MACS_peak_15216	695.57	189	0	1	0	gen
4	72479318	72479638	MACS_peak_15217	86.47	320	0	1	0	gen
4	72886744	72886970	MACS_peak_15219	580.35	226	0	0	0	intergen
4	73181964	73182196	MACS_peak_15220	346.62	232	0	1	0	gen
4	73553702	73554119	MACS_peak_15221	64.79	417	0	0	0	intergen
4	73555887	73556182	MACS_peak_15222	56.41	295	0	0	0	intergen
4	73729685	73730011	MACS_peak_15223	546.72	326	0	0	0	intergen
4	74019135	74019538	MACS_peak_15225	514.14	403	0	0	0	intergen
4	74134374	74134565	MACS_peak_15226	850.54	191	0	1	0	gen
4	74311756	74312063	MACS_peak_15227	438.71	307	1	0	0	promoter
4	74376994	74377320	MACS_peak_15228	1049.72	326	0	1	0	gen
4	74593478	74593730	MACS_peak_15230	169.68	252	0	0	0	intergen
4	75165682	75166037	MACS_peak_15232	93.4	355	0	0	0	intergen
4	75187134	75187417	MACS_peak_15233	452.74	283	0	0	0	intergen
4	75239604	75239984	MACS_peak_15234	115.17	380	0	0	0	intergen
4	75274455	75274739	MACS_peak_15235	75.9	284	0	0	1	other
4	75294381	75294699	MACS_peak_15237	96.1	318	0	0	1	other
4	75318455	75318836	MACS_peak_15238	211.68	381	0	0	1	other
4	75335702	75336049	MACS_peak_15239	142.05	347	0	0	1	other
4	75468833	75469227	MACS_peak_15240	469.92	394	0	0	0	intergen
4	75533916	75534203	MACS_peak_15242	202.06	287	0	1	0	gen
4	75848370	75848649	MACS_peak_15244	1123.24	279	0	0	0	intergen
4	75916582	75916914	MACS_peak_15245	611.86	332	1	0	0	promoter
4	76511128	76511394	MACS_peak_15246	719.85	266	0	1	0	gen
4	76758397	76758641	MACS_peak_15247	501.16	244	0	1	0	gen
4	77298423	77298794	MACS_peak_15248	232.87	371	0	1	0	gen
4	77353851	77354071	MACS_peak_15249	1061.85	220	0	1	0	gen
4	77366947	77367167	MACS_peak_15250	1061.85	220	0	1	0	gen
4	77599447	77599771	MACS_peak_15251	547.99	324	0	1	0	gen
4	77618698	77618949	MACS_peak_15252	485.56	251	0	0	0	intergen
4	77789956	77790091	MACS_peak_15253	1746.96	135	0	1	0	gen
4	77889046	77889400	MACS_peak_15254	159.56	354	0	1	0	gen
4	78193609	78193925	MACS_peak_15255	84.4	316	0	1	0	gen
4	78302092	78302478	MACS_peak_15256	82.33	386	0	1	0	gen
4	78348153	78348575	MACS_peak_15257	81.5	422	0	1	0	gen
4	78349545	78349785	MACS_peak_15258	62.1	240	0	1	0	gen
4	78669635	78669866	MACS_peak_15259	831.63	231	0	0	1	other
4	78718144	78718403	MACS_peak_15260	201.59	259	0	0	0	intergen
4	78758971	78759306	MACS_peak_15261	57.8	335	0	0	0	intergen
4	78864423	78864765	MACS_peak_15262	1191.46	342	0	1	0	gen
4	78980268	78980614	MACS_peak_15263	79.98	346	0	0	1	other
4	79271007	79271388	MACS_peak_15264	51.22	381	0	1	1	gen
4	79519712	79519972	MACS_peak_15265	198.49	260	0	0	1	other
4	79538376	79538699	MACS_peak_15266	551.66	323	0	0	1	other
4	79967608	79967923	MACS_peak_15268	76.02	315	0	1	0	gen
4	80163701	80163908	MACS_peak_15269	780.06	207	0	0	0	intergen
4	80291298	80291545	MACS_peak_15270	66.01	247	0	1	0	gen
4	80778393	80778685	MACS_peak_15271	569.49	292	0	1	0	gen
4	80858768	80859007	MACS_peak_15274	96.03	239	0	1	0	gen
4	81188481	81188763	MACS_peak_15276	100.02	282	0	1	1	gen
4	81275612	81275869	MACS_peak_15277	595.98	257	0	0	0	intergen
4	81297504	81297794	MACS_peak_15278	506.92	290	0	0	0	intergen
4	81467234	81467625	MACS_peak_15279	509.31	391	0	1	0	gen
4	81594146	81594395	MACS_peak_15280	420.1	249	0	1	0	gen
4	82008894	82009157	MACS_peak_15282	54.08	263	0	1	0	gen
4	82113934	82114390	MACS_peak_15283	58.28	456	0	0	0	intergen
4	82300427	82300861	MACS_peak_15284	101.68	434	0	0	1	other
4	82739345	82739647	MACS_peak_15285	820.61	302	0	1	0	gen
4	82785365	82785558	MACS_peak_15286	678.9	193	0	1	0	gen
4	82898243	82898579	MACS_peak_15287	423.21	336	1	1	1	promoter
4	82909290	82909545	MACS_peak_15288	470.06	255	1	1	0	promoter
4	83055036	83055238	MACS_peak_15289	500.39	202	0	1	0	gen
4	83095330	83095603	MACS_peak_15290	2563.9	273	0	1	0	gen
4	83165525	83165722	MACS_peak_15291	226.81	197	0	0	0	intergen
4	83167972	83168355	MACS_peak_15292	191.93	383	0	0	0	intergen
4	83320564	83320742	MACS_peak_15293	763.02	178	0	1	0	gen
4	83401087	83401418	MACS_peak_15294	82.43	331	0	0	0	intergen
4	83639936	83640260	MACS_peak_15295	429.45	324	0	0	0	intergen
4	83805647	83805916	MACS_peak_15296	103.45	269	0	0	1	other
4	84073522	84073876	MACS_peak_15297	52.66	354	0	0	1	other
4	84524588	84525000	MACS_peak_15299	101.39	412	0	0	0	intergen
4	84760691	84760936	MACS_peak_15300	124.01	245	0	1	0	gen
4	84761795	84762248	MACS_peak_15301	71.7	453	0	1	0	gen
4	84990566	84990777	MACS_peak_15302	87.52	211	0	0	1	other
4	85014009	85014257	MACS_peak_15303	153.19	248	0	0	0	intergen
4	85084421	85084662	MACS_peak_15304	501.16	241	0	0	0	intergen
4	85183751	85184115	MACS_peak_15305	348.12	364	0	0	0	intergen
4	85318297	85318615	MACS_peak_15306	419.41	318	0	0	0	intergen
4	85381202	85381601	MACS_peak_15307	127.15	399	0	0	0	intergen
4	85487559	85487932	MACS_peak_15308	890.79	373	0	1	0	gen
4	85622986	85623352	MACS_peak_15309	54.69	366	0	1	0	gen
4	86626189	86626483	MACS_peak_15313	509.32	294	0	1	0	gen
4	86919205	86919345	MACS_peak_15314	1921	140	0	1	0	gen
4	86922424	86922663	MACS_peak_15315	645.81	239	0	1	0	gen
4	87072358	87072491	MACS_peak_15316	1201.31	133	0	1	0	gen
4	87142511	87142644	MACS_peak_15317	710.42	133	0	0	0	intergen
4	87226560	87226998	MACS_peak_15318	599.79	438	0	1	0	gen
4	87235870	87236128	MACS_peak_15319	374.96	258	0	1	0	gen
4	87305229	87305407	MACS_peak_15320	678.04	178	1	0	0	promoter
4	87308361	87308635	MACS_peak_15321	142.05	274	1	0	0	promoter
4	87347792	87348119	MACS_peak_15322	92.37	327	0	1	0	gen
4	87710789	87711123	MACS_peak_15323	96.37	334	0	0	1	other
4	87714444	87714741	MACS_peak_15324	92.48	297	0	0	1	other
4	87774270	87774628	MACS_peak_15325	73.07	358	0	0	0	intergen
4	87797866	87798277	MACS_peak_15326	114.31	411	1	0	0	promoter
4	88161759	88161977	MACS_peak_15327	76.21	218	0	1	0	gen
4	88602374	88602543	MACS_peak_15329	1243.44	169	0	2	0	gen
4	88659391	88659706	MACS_peak_15330	943.22	315	0	1	0	gen
4	88873027	88873329	MACS_peak_15331	52.99	302	0	1	0	gen
4	88921624	88922011	MACS_peak_15333	173.31	387	0	1	0	gen
4	88924769	88925144	MACS_peak_15334	51.26	375	0	1	0	gen
4	89157259	89157601	MACS_peak_15335	603.02	342	0	0	0	intergen
4	89158887	89159198	MACS_peak_15336	812.5	311	0	0	0	intergen
4	89692750	89692992	MACS_peak_15337	501.16	242	0	0	1	other
4	89700033	89700417	MACS_peak_15338	617.81	384	0	0	1	other
4	89901774	89902118	MACS_peak_15339	414.37	344	0	1	0	gen
4	90231236	90231687	MACS_peak_15340	71.12	451	0	1	0	gen
4	90271770	90271992	MACS_peak_15341	461.43	222	0	1	0	gen
4	90293374	90293678	MACS_peak_15342	818.02	304	0	1	0	gen
4	90303301	90303761	MACS_peak_15343	107.03	460	0	1	0	gen
4	90492532	90492850	MACS_peak_15344	237.25	318	0	1	0	gen
4	90957353	90957702	MACS_peak_15345	670.53	349	0	1	0	gen
4	91082566	91082885	MACS_peak_15346	50.92	319	0	1	0	gen
4	91138390	91138641	MACS_peak_15347	59.09	251	0	1	0	gen
4	91481747	91482176	MACS_peak_15348	164.26	429	0	1	0	gen
4	91522784	91523096	MACS_peak_15349	197.56	312	0	1	0	gen
4	91638597	91638805	MACS_peak_15350	770.35	208	0	0	0	intergen
4	91734658	91734923	MACS_peak_15351	464.09	265	0	0	0	intergen
4	91789059	91789319	MACS_peak_15352	67.21	260	0	0	0	intergen
4	91978459	91978820	MACS_peak_15353	77.28	361	0	0	0	intergen
4	91980641	91980995	MACS_peak_15354	56.05	354	0	0	0	intergen
4	92201984	92202440	MACS_peak_15355	57.47	456	0	0	0	intergen
4	92687940	92688169	MACS_peak_15357	257.34	229	0	1	0	gen
4	92953700	92953923	MACS_peak_15358	367.28	223	0	1	0	gen
4	93157867	93158279	MACS_peak_15359	614.43	412	0	1	0	gen
4	93591010	93591237	MACS_peak_15360	66.66	227	0	1	0	gen
4	93593132	93593497	MACS_peak_15361	59.51	365	0	1	0	gen
4	93594401	93594789	MACS_peak_15362	220.79	388	0	1	0	gen
4	93638491	93638809	MACS_peak_15363	60.03	318	0	1	0	gen
4	93681713	93682147	MACS_peak_15365	102.96	434	0	1	0	gen
4	93727863	93728254	MACS_peak_15366	106.86	391	0	1	0	gen
4	93791645	93791885	MACS_peak_15367	645.81	240	0	1	0	gen
4	94406743	94406993	MACS_peak_15368	726.99	250	0	0	0	intergen
4	94595991	94596183	MACS_peak_15369	678.9	192	0	1	0	gen
4	95049328	95049471	MACS_peak_15371	898.3	143	0	1	0	gen
4	95196711	95197142	MACS_peak_15372	1963.13	431	0	1	0	gen
4	95510129	95510496	MACS_peak_15373	642.17	367	0	1	0	gen
4	95751829	95752161	MACS_peak_15374	79.37	332	0	0	0	intergen
4	95752388	95752727	MACS_peak_15375	60.94	339	0	0	0	intergen
4	95794548	95794864	MACS_peak_15376	75.02	316	0	0	0	intergen
4	95916787	95917196	MACS_peak_15377	54.31	409	0	0	0	intergen
4	95917351	95917792	MACS_peak_15378	68.11	441	0	0	0	intergen
4	96020459	96020763	MACS_peak_15379	561.16	304	0	0	0	intergen
4	96172599	96172864	MACS_peak_15380	856.77	265	0	0	0	intergen
4	96293123	96293513	MACS_peak_15381	750.16	390	0	0	0	intergen
4	96385252	96385385	MACS_peak_15382	877.68	133	0	0	1	other
4	96765414	96765647	MACS_peak_15383	532.66	233	0	0	1	other
4	97161146	97161535	MACS_peak_15384	81.72	389	0	0	0	intergen
4	97257795	97258158	MACS_peak_15385	156.58	363	0	1	0	gen
4	97259297	97259670	MACS_peak_15386	50.92	373	0	1	0	gen
4	97273853	97274181	MACS_peak_15387	95.4	328	0	1	0	gen
4	97720784	97721076	MACS_peak_15389	334.33	292	0	1	0	gen
4	97849558	97849894	MACS_peak_15391	51.88	336	0	1	0	gen
4	97904469	97904887	MACS_peak_15392	110.62	418	0	1	0	gen
4	97908535	97908901	MACS_peak_15393	65.81	366	0	1	0	gen
4	97987116	97987367	MACS_peak_15394	485.56	251	0	1	0	gen
4	98092909	98093172	MACS_peak_15395	465.4	263	0	1	0	gen
4	98150484	98150773	MACS_peak_15396	449.12	289	0	0	0	intergen
4	98413554	98413927	MACS_peak_15397	67.3	373	0	1	0	gen
4	98475792	98476101	MACS_peak_15398	437.6	309	0	1	0	gen
4	98725666	98726030	MACS_peak_15399	107.27	364	0	0	0	intergen
4	99116169	99116482	MACS_peak_15401	108.02	313	0	0	1	other
4	99405605	99405850	MACS_peak_15402	918.92	245	0	0	0	intergen
4	99462929	99463275	MACS_peak_15403	481.23	346	0	0	0	intergen
4	100093399	100093661	MACS_peak_15404	466.05	262	0	0	1	other
4	100372543	100372841	MACS_peak_15405	453.1	298	0	0	0	intergen
4	100382946	100383309	MACS_peak_15406	80.08	363	0	0	0	intergen
4	100421450	100421785	MACS_peak_15407	541.11	335	0	1	0	gen
4	100473454	100473646	MACS_peak_15408	1023.52	192	0	1	0	gen
4	100528867	100529246	MACS_peak_15409	159.55	379	0	1	0	gen
4	100645645	100645906	MACS_peak_15410	1001.77	261	0	1	0	gen
4	100717981	100718273	MACS_peak_15411	54.15	292	0	1	0	gen
4	100806576	100806909	MACS_peak_15412	424.75	333	0	1	0	gen
4	101008283	101008446	MACS_peak_15413	848.95	163	0	0	0	intergen
4	101090761	101091065	MACS_peak_15414	369.79	304	0	1	0	gen
4	101292094	101292279	MACS_peak_15415	1116.4	185	0	1	0	gen
4	101509952	101510355	MACS_peak_15416	139.49	403	0	1	0	gen
4	101749750	101750129	MACS_peak_15417	178.37	379	0	1	0	gen
4	101839845	101840060	MACS_peak_15418	354.25	215	0	1	0	gen
4	101858606	101859017	MACS_peak_15419	615.01	411	0	1	0	gen
4	101908429	101908694	MACS_peak_15420	79.64	265	0	1	0	gen
4	102055839	102056151	MACS_peak_15422	435.94	312	0	1	0	gen
4	102484700	102485036	MACS_peak_15423	80.67	336	0	0	0	intergen
4	102701574	102701920	MACS_peak_15424	68.2	346	0	1	0	gen
4	102952214	102952511	MACS_peak_15425	63.25	297	0	1	0	gen
4	103187810	103188125	MACS_peak_15426	72.01	315	0	1	0	gen
4	103253793	103254097	MACS_peak_15427	51.72	304	0	0	0	intergen
4	104136935	104137133	MACS_peak_15429	162.14	198	0	0	0	intergen
4	104279117	104279419	MACS_peak_15430	603.02	302	0	0	1	other
4	104323456	104323868	MACS_peak_15431	76.47	412	0	0	1	other
4	104451707	104452036	MACS_peak_15432	721.05	329	0	0	0	intergen
4	104634233	104634511	MACS_peak_15433	455.81	278	0	0	1	other
4	104692026	104692378	MACS_peak_15434	65.32	352	0	0	2	other
4	104860587	104860849	MACS_peak_15435	591.97	262	0	0	1	other
4	105222700	105222970	MACS_peak_15436	62.38	270	0	1	0	gen
4	105322120	105322417	MACS_peak_15437	64.74	297	0	0	0	intergen
4	105322449	105322759	MACS_peak_15438	64.04	310	0	0	0	intergen
4	105449216	105449366	MACS_peak_15439	432.57	150	0	1	0	gen
4	105561374	105561584	MACS_peak_15440	597.38	210	0	1	0	gen
4	105730412	105730800	MACS_peak_15441	89.02	388	0	2	0	gen
4	105863554	105863858	MACS_peak_15442	108.34	304	0	1	0	gen
4	105865118	105865547	MACS_peak_15443	68.83	429	0	1	0	gen
4	106329059	106329406	MACS_peak_15444	533.85	347	0	1	0	gen
4	106613253	106613405	MACS_peak_15445	429.41	152	0	0	0	intergen
4	106721113	106721419	MACS_peak_15446	74.03	306	0	0	0	intergen
4	106870094	106870226	MACS_peak_15447	920.05	132	0	0	0	intergen
4	106898692	106898950	MACS_peak_15448	444.53	258	0	0	0	intergen
4	106938605	106939040	MACS_peak_15450	71.7	435	0	1	0	gen
4	107556202	107556510	MACS_peak_15453	953.02	308	0	0	0	intergen
4	108009966	108010103	MACS_peak_15454	1420.82	137	0	1	0	gen
4	108018534	108018899	MACS_peak_15455	768.37	365	0	1	0	gen
4	108040733	108040983	MACS_peak_15456	70.53	250	0	0	0	intergen
4	108438083	108438357	MACS_peak_15457	108.84	274	0	0	0	intergen
4	108810264	108810472	MACS_peak_15458	780.06	208	1	0	0	promoter
4	109826823	109827041	MACS_peak_15460	580.62	218	1	0	0	promoter
4	109894950	109895273	MACS_peak_15461	59.66	323	0	0	0	intergen
4	109978027	109978389	MACS_peak_15462	645.47	362	0	1	0	gen
4	110079765	110080105	MACS_peak_15463	69	340	0	1	0	gen
4	110082164	110082549	MACS_peak_15464	68.83	385	0	1	0	gen
4	110211331	110211544	MACS_peak_15465	698.01	213	0	0	0	intergen
4	110419773	110420028	MACS_peak_15466	308.41	255	0	1	0	gen
4	110760728	110761047	MACS_peak_15467	76.09	319	0	0	0	intergen
4	110873995	110874398	MACS_peak_15468	60.9	403	0	0	0	intergen
4	111060073	111060396	MACS_peak_15469	287.85	323	0	0	0	intergen
4	111150802	111151140	MACS_peak_15470	109.84	338	0	0	0	intergen
4	111195636	111195868	MACS_peak_15471	116.72	232	0	0	0	intergen
4	111283083	111283422	MACS_peak_15472	661.26	339	0	0	0	intergen
4	111342339	111342680	MACS_peak_15473	72.11	341	0	0	0	intergen
4	111395798	111396021	MACS_peak_15474	138.14	223	0	0	0	intergen
4	111420759	111421138	MACS_peak_15475	84.4	379	0	0	0	intergen
4	111474937	111475286	MACS_peak_15476	416.71	349	0	0	0	intergen
4	111631782	111632154	MACS_peak_15477	380.3	372	0	0	0	intergen
4	111642111	111642422	MACS_peak_15478	556.45	311	0	0	1	other
4	111728613	111728893	MACS_peak_15479	415.79	280	0	0	0	intergen
4	111847823	111847994	MACS_peak_15480	934.99	171	0	0	1	other
4	111894945	111895395	MACS_peak_15482	193	450	0	0	1	other
4	111951250	111951433	MACS_peak_15483	479.34	183	0	0	1	other
4	112060319	112060571	MACS_peak_15484	470.06	252	0	0	1	other
4	112088757	112089119	MACS_peak_15485	86.52	362	0	0	0	intergen
4	112482821	112483266	MACS_peak_15486	114.09	445	0	0	0	intergen
4	112683919	112684201	MACS_peak_15487	440.04	282	0	0	0	intergen
4	113852642	113853024	MACS_peak_15488	132.32	382	0	0	0	intergen
4	113923957	113924180	MACS_peak_15489	712.32	223	0	1	0	gen
4	113942322	113942606	MACS_peak_15490	462.87	284	0	1	0	gen
4	113988113	113988367	MACS_peak_15491	79.5	254	0	0	0	intergen
4	114207266	114207525	MACS_peak_15492	603.02	259	0	0	0	intergen
4	114384724	114384958	MACS_peak_15493	814.37	234	0	0	0	intergen
4	114386672	114387035	MACS_peak_15494	524.58	363	0	0	0	intergen
4	114539151	114539484	MACS_peak_15495	424.75	333	0	0	0	intergen
4	114659427	114659647	MACS_peak_15496	883.81	220	0	1	0	gen
4	115172915	115173285	MACS_peak_15497	147.17	370	0	0	0	intergen
4	115815405	115815762	MACS_peak_15499	50.92	357	0	0	0	intergen
4	116253963	116254187	MACS_peak_15500	106.25	224	0	0	1	other
4	116330225	116330553	MACS_peak_15501	125.63	328	0	0	0	intergen
4	116406796	116407094	MACS_peak_15502	89.95	298	0	0	0	intergen
4	116410818	116411256	MACS_peak_15503	51.32	438	0	0	0	intergen
4	116499501	116499860	MACS_peak_15504	399.3	359	0	0	1	other
4	116808366	116808839	MACS_peak_15505	69.92	473	0	0	0	intergen
4	116849000	116849256	MACS_peak_15506	234.17	256	0	0	0	intergen
4	117198472	117198770	MACS_peak_15507	534.92	298	0	0	0	intergen
4	117659322	117659636	MACS_peak_15508	122.69	314	0	0	1	other
4	117682300	117682689	MACS_peak_15509	81.72	389	0	0	1	other
4	117945476	117945868	MACS_peak_15510	133.25	392	0	0	0	intergen
4	117952292	117952537	MACS_peak_15511	105.82	245	0	0	0	intergen
4	118162640	118163122	MACS_peak_15513	137.84	482	0	1	0	gen
4	118270472	118270786	MACS_peak_15514	554.47	314	0	0	0	intergen
4	118424118	118424383	MACS_peak_15515	520.18	265	0	0	0	intergen
4	118539307	118539664	MACS_peak_15516	468.18	357	0	0	1	other
4	119043935	119044073	MACS_peak_15517	1043.77	138	0	1	0	gen
4	119067374	119067691	MACS_peak_15518	171.7	317	0	0	0	intergen
4	119078814	119079119	MACS_peak_15519	79.12	305	0	0	0	intergen
4	119286460	119286690	MACS_peak_15520	517.97	230	0	1	0	gen
4	119410632	119411073	MACS_peak_15521	514.14	441	0	0	1	other
4	119676064	119676289	MACS_peak_15522	866.35	225	0	0	0	intergen
4	120045902	120046037	MACS_peak_15523	1717.19	135	0	0	0	intergen
4	120121676	120121896	MACS_peak_15524	734.14	220	0	0	1	other
4	120251207	120251549	MACS_peak_15525	68.17	342	0	0	1	other
4	120253973	120254253	MACS_peak_15526	108.6	280	0	0	1	other
4	120286909	120287261	MACS_peak_15527	778.35	352	0	0	1	other
4	120478108	120478376	MACS_peak_15528	68.44	268	0	0	0	intergen
4	120679594	120679819	MACS_peak_15530	533.53	225	0	0	0	intergen
4	121112589	121112864	MACS_peak_15531	581.92	275	0	0	0	intergen
4	121302863	121303145	MACS_peak_15533	488.85	282	0	0	0	intergen
4	121370705	121371026	MACS_peak_15534	549.92	321	0	1	0	gen
4	122110982	122111360	MACS_peak_15535	87.93	378	0	0	0	intergen
4	122310067	122310442	MACS_peak_15536	404.42	375	0	1	0	gen
4	122447733	122447969	MACS_peak_15537	797.63	236	1	0	0	promoter
4	122571829	122572227	MACS_peak_15538	64.79	398	0	0	0	intergen
4	122652373	122652750	MACS_peak_15539	284.37	377	0	0	1	other
4	122999907	123000237	MACS_peak_15541	55.53	330	0	1	0	gen
4	123017245	123017456	MACS_peak_15542	365.38	211	0	1	0	gen
4	123096096	123096330	MACS_peak_15543	532.66	234	0	1	0	gen
4	123117395	123117600	MACS_peak_15544	896.36	205	0	1	0	gen
4	123196446	123196654	MACS_peak_15545	1320.51	208	0	1	0	gen
4	123512379	123512594	MACS_peak_15546	66.31	215	0	0	2	other
4	124130253	124130478	MACS_peak_15547	182.05	225	0	0	0	intergen
4	124217386	124217717	MACS_peak_15548	100.86	331	0	0	1	other
4	124286463	124286936	MACS_peak_15549	55.88	473	0	0	0	intergen
4	124613029	124613279	MACS_peak_15550	62.16	250	0	0	0	intergen
4	124614593	124614957	MACS_peak_15551	77.26	364	0	0	0	intergen
4	124785606	124785933	MACS_peak_15552	546.09	327	0	0	0	intergen
4	124857367	124857602	MACS_peak_15553	440.38	235	0	0	0	intergen
4	125313525	125313728	MACS_peak_15554	629.38	203	1	0	0	promoter
4	125863691	125864081	MACS_peak_15555	52.16	390	0	0	0	intergen
4	126033836	126034093	MACS_peak_15556	81.12	257	0	0	0	intergen
4	126219639	126219954	MACS_peak_15557	51.44	315	0	0	0	intergen
4	126454846	126455108	MACS_peak_15558	859.93	262	0	0	0	intergen
4	126674746	126675104	MACS_peak_15559	56.38	358	0	0	0	intergen
4	126865153	126865507	MACS_peak_15560	52.17	354	0	0	0	intergen
4	126932402	126932782	MACS_peak_15561	64.79	380	0	0	0	intergen
4	127066921	127067377	MACS_peak_15562	52.21	456	0	0	1	other
4	127593913	127594372	MACS_peak_15564	123.79	459	0	0	0	intergen
4	127654777	127655064	MACS_peak_15565	139.27	287	0	1	0	gen
4	127851697	127851924	MACS_peak_15566	736.56	227	0	0	0	intergen
4	128897309	128897685	MACS_peak_15567	118.57	376	0	1	0	gen
4	128898321	128898699	MACS_peak_15568	75.01	378	0	1	0	gen
4	129182699	129182994	MACS_peak_15570	96.06	295	0	0	0	intergen
4	129362783	129362995	MACS_peak_15571	763.02	212	0	0	0	intergen
4	129526885	129527083	MACS_peak_15572	642.68	198	0	0	0	intergen
4	129590797	129591150	MACS_peak_15573	103.45	353	0	0	0	intergen
4	129597185	129597467	MACS_peak_15574	443.52	282	0	0	0	intergen
4	130015747	130016121	MACS_peak_15577	427.9	374	0	0	0	intergen
4	130049831	130050211	MACS_peak_15578	94.4	380	0	0	0	intergen
4	130070493	130070907	MACS_peak_15579	82.07	414	0	0	0	intergen
4	130425117	130425320	MACS_peak_15580	274.86	203	0	0	0	intergen
4	131034498	131034697	MACS_peak_15581	1007.8	199	0	0	0	intergen
4	131074056	131074404	MACS_peak_15582	65.49	348	0	0	0	intergen
4	131420188	131420515	MACS_peak_15583	69	327	0	0	1	other
4	131585110	131585480	MACS_peak_15584	640.22	370	0	0	0	intergen
4	131677553	131677833	MACS_peak_15585	93.4	280	0	0	0	intergen
4	132309470	132309673	MACS_peak_15586	793.98	203	0	0	0	intergen
4	132459613	132459997	MACS_peak_15587	168.06	384	0	0	0	intergen
4	132634497	132634830	MACS_peak_15588	101.68	333	0	0	1	other
4	132650809	132651081	MACS_peak_15589	366.02	272	0	0	1	other
4	133146798	133147047	MACS_peak_15590	485.56	249	1	0	1	promoter
4	134212888	134213169	MACS_peak_15591	50.92	281	0	0	0	intergen
4	134567737	134568191	MACS_peak_15592	953.02	454	0	0	0	intergen
4	134831454	134831683	MACS_peak_15593	282.04	229	0	0	0	intergen
4	134906567	134906776	MACS_peak_15594	473.4	209	0	0	0	intergen
4	135007736	135008090	MACS_peak_15595	834.03	354	0	0	0	intergen
4	135179369	135179676	MACS_peak_15596	54.02	307	0	0	0	intergen
4	135179797	135180040	MACS_peak_15597	61.35	243	0	0	0	intergen
4	135181521	135181848	MACS_peak_15598	140.21	327	0	0	0	intergen
4	135182442	135182812	MACS_peak_15599	53.58	370	0	0	0	intergen
4	135182815	135183188	MACS_peak_15600	165.34	373	0	0	0	intergen
4	135864485	135864693	MACS_peak_15601	459.7	208	0	0	0	intergen
4	136835868	136836001	MACS_peak_15602	960.62	133	0	0	1	other
4	136864597	136864903	MACS_peak_15603	722.05	306	0	0	1	other
4	137164663	137165080	MACS_peak_15604	611.54	417	0	0	1	other
4	137268618	137268844	MACS_peak_15605	848.95	226	0	0	0	intergen
4	137501767	137502094	MACS_peak_15606	89.02	327	0	0	0	intergen
4	137831344	137831545	MACS_peak_15607	333.06	201	0	0	0	intergen
4	138035721	138036034	MACS_peak_15608	488.85	313	0	0	1	other
4	138357447	138357736	MACS_peak_15610	149.97	289	0	0	1	other
4	138442867	138443110	MACS_peak_15612	495.06	243	0	0	0	intergen
4	138860397	138860780	MACS_peak_15613	178.37	383	0	0	1	other
4	139619709	139619916	MACS_peak_15614	1134.69	207	0	0	1	other
4	139831885	139832122	MACS_peak_15615	406.23	237	0	1	0	gen
4	139944617	139944991	MACS_peak_15616	57.86	374	0	1	0	gen
4	140360108	140360378	MACS_peak_15617	460.86	270	0	1	1	gen
4	140416199	140416601	MACS_peak_15618	64.42	402	0	1	0	gen
4	140523798	140524032	MACS_peak_15619	385.26	234	1	0	0	promoter
4	140884497	140884793	MACS_peak_15620	445	296	0	1	0	gen
4	140919952	140920355	MACS_peak_15621	63.13	403	0	1	0	gen
4	141346204	141346450	MACS_peak_15622	485.56	246	0	0	0	intergen
4	141383489	141383781	MACS_peak_15623	69	292	0	0	0	intergen
4	141703606	141703757	MACS_peak_15624	1434.33	151	0	1	0	gen
4	142255769	142256039	MACS_peak_15625	88.77	270	0	1	0	gen
4	142693475	142693631	MACS_peak_15626	562.95	156	0	1	0	gen
4	142782812	142783053	MACS_peak_15627	52.82	241	0	1	0	gen
4	142917436	142917568	MACS_peak_15628	792.17	132	0	0	0	intergen
4	143085368	143085656	MACS_peak_15629	449.72	288	0	0	1	other
4	143171675	143171940	MACS_peak_15630	69.69	265	0	0	1	other
4	143238337	143238475	MACS_peak_15631	1148.16	138	0	0	0	intergen
4	143303255	143303387	MACS_peak_15632	1116.4	132	0	0	1	other
4	143449180	143449562	MACS_peak_15633	52.41	382	0	1	0	gen
4	143659434	143659854	MACS_peak_15634	61.72	420	0	1	1	gen
4	143676115	143676476	MACS_peak_15635	72.39	361	0	1	1	gen
4	143804875	143805108	MACS_peak_15636	131.91	233	0	0	1	other
4	143810500	143810852	MACS_peak_15637	2877.68	352	0	0	1	other
4	144021679	144021957	MACS_peak_15639	442.5	278	0	0	1	other
4	144143023	144143277	MACS_peak_15640	511.33	254	0	0	2	other
4	144239699	144239947	MACS_peak_15641	90.78	248	0	1	1	gen
4	144684128	144684274	MACS_peak_15642	1064.75	146	0	2	1	gen
4	144748488	144748702	MACS_peak_15643	164.16	214	0	1	1	gen
4	144811202	144811578	MACS_peak_15644	58.28	376	0	1	1	gen
4	145009917	145010205	MACS_peak_15645	96.57	288	0	2	0	gen
4	145378121	145378476	MACS_peak_15646	106.53	355	0	0	0	intergen
4	145609813	145610209	MACS_peak_15647	506.71	396	0	1	0	gen
4	145895624	145895876	MACS_peak_15648	613.04	252	0	1	0	gen
4	146001102	146001354	MACS_peak_15649	108.7	252	0	0	0	intergen
4	146304989	146305267	MACS_peak_15650	103.94	278	0	1	0	gen
4	146342679	146342918	MACS_peak_15651	516.86	239	0	1	0	gen
4	146350989	146351373	MACS_peak_15652	67.33	384	0	1	0	gen
4	146353438	146353655	MACS_peak_15653	56.85	217	0	1	0	gen
4	146668709	146669122	MACS_peak_15654	69.82	413	0	0	0	intergen
4	146814704	146814857	MACS_peak_15655	506.18	153	0	1	0	gen
4	146893184	146893652	MACS_peak_15656	147.58	468	0	1	0	gen
4	146916572	146917001	MACS_peak_15657	974.86	429	0	1	0	gen
4	147160962	147161253	MACS_peak_15658	830.86	291	0	0	0	intergen
4	147452486	147452914	MACS_peak_15660	103.55	428	0	0	0	intergen
4	147468216	147468562	MACS_peak_15661	53.59	346	0	0	0	intergen
4	147470215	147470516	MACS_peak_15662	203.85	301	0	0	0	intergen
4	147708220	147708618	MACS_peak_15663	1048.74	398	0	0	0	intergen
4	147784382	147784709	MACS_peak_15664	546.09	327	0	1	0	gen
4	147784735	147784978	MACS_peak_15665	501.16	243	0	1	0	gen
4	147837331	147837718	MACS_peak_15666	629.43	387	0	1	0	gen
4	147866784	147867051	MACS_peak_15667	462.79	267	0	1	0	gen
4	148241121	148241439	MACS_peak_15668	103.45	318	0	1	0	gen
4	148667152	148667474	MACS_peak_15669	430.51	322	0	0	0	intergen
4	148977953	148978283	MACS_peak_15670	142.05	330	0	0	0	intergen
4	149088909	149089378	MACS_peak_15671	66.96	469	0	0	0	intergen
4	149130151	149130569	MACS_peak_15672	114.31	418	0	0	0	intergen
4	149131259	149131712	MACS_peak_15673	110.89	453	0	0	0	intergen
4	149356294	149356566	MACS_peak_15674	69	272	1	0	0	promoter
4	149524754	149524979	MACS_peak_15675	794.58	225	0	1	0	gen
4	149592693	149592981	MACS_peak_15676	55.56	288	0	1	0	gen
4	149593833	149594242	MACS_peak_15677	146.38	409	0	1	0	gen
4	149816178	149816549	MACS_peak_15678	64.33	371	0	1	0	gen
4	149817843	149818048	MACS_peak_15679	61.89	205	0	1	0	gen
4	149917926	149918306	MACS_peak_15681	77.14	380	0	0	0	intergen
4	149918436	149918748	MACS_peak_15682	51.44	312	0	0	0	intergen
4	149918943	149919370	MACS_peak_15683	75.11	427	0	0	0	intergen
4	150174951	150175217	MACS_peak_15685	790	266	0	1	0	gen
4	150195164	150195519	MACS_peak_15686	1069.92	355	0	1	0	gen
4	150559672	150560034	MACS_peak_15687	896.32	362	0	1	0	gen
4	151198289	151198520	MACS_peak_15688	483.43	231	0	1	0	gen
4	151234577	151234868	MACS_peak_15689	314.21	291	0	1	0	gen
4	151591674	151592021	MACS_peak_15690	172.42	347	0	1	0	gen
4	152139478	152139901	MACS_peak_15691	93.33	423	0	0	0	intergen
4	152631692	152631940	MACS_peak_15692	389.4	248	0	1	0	gen
4	152922121	152922388	MACS_peak_15693	67.03	267	0	0	0	intergen
4	152923131	152923438	MACS_peak_15694	59.31	307	0	0	0	intergen
4	154104257	154104547	MACS_peak_15695	63.52	290	0	0	0	intergen
4	154170308	154170500	MACS_peak_15696	124.93	192	0	0	1	other
4	154172219	154172555	MACS_peak_15697	114.74	336	0	0	1	other
4	154622632	154623029	MACS_peak_15698	1271.44	397	1	0	0	promoter
4	154807088	154807356	MACS_peak_15699	587.27	268	0	1	0	gen
4	154928777	154929043	MACS_peak_15700	995.85	266	0	0	0	intergen
4	155031579	155031832	MACS_peak_15701	302.07	253	0	0	0	intergen
4	155861588	155861795	MACS_peak_15703	613.04	207	0	2	0	gen
4	156289473	156289810	MACS_peak_15704	113.53	337	0	0	0	intergen
4	156475468	156475780	MACS_peak_15705	555.79	312	0	0	0	intergen
4	156494815	156495076	MACS_peak_15706	592.77	261	0	0	0	intergen
4	156617835	156618113	MACS_peak_15707	455.81	278	0	0	0	intergen
4	156968469	156968873	MACS_peak_15708	619.12	404	0	1	0	gen
4	156983347	156983701	MACS_peak_15709	529.74	354	0	0	0	intergen
4	157355810	157356179	MACS_peak_15710	894.13	369	0	1	0	gen
4	158089601	158089913	MACS_peak_15711	102.99	312	0	0	0	intergen
4	158479354	158479558	MACS_peak_15712	343.13	204	0	1	0	gen
4	158546638	158547009	MACS_peak_15713	59.69	371	0	1	0	gen
4	158856893	158857144	MACS_peak_15714	613.04	251	0	1	0	gen
4	159146011	159146379	MACS_peak_15715	488.85	368	0	1	0	gen
4	159316087	159316472	MACS_peak_15716	950.42	385	0	1	0	gen
4	159446438	159446787	MACS_peak_15717	466.95	349	0	0	0	intergen
4	159807020	159807354	MACS_peak_15718	60.1	334	0	0	0	intergen
4	159900704	159901048	MACS_peak_15719	405.97	344	0	0	0	intergen
4	159931881	159932358	MACS_peak_15720	58.39	477	0	0	0	intergen
4	160278802	160279154	MACS_peak_15721	110.41	352	0	0	0	intergen
4	160331654	160331789	MACS_peak_15722	574.63	135	0	0	0	intergen
4	160477987	160478326	MACS_peak_15724	365.42	339	0	0	0	intergen
4	160568444	160568719	MACS_peak_15725	457.69	275	0	0	1	other
4	160623443	160623792	MACS_peak_15726	486.39	349	0	0	0	intergen
4	160660296	160660606	MACS_peak_15727	477.04	310	0	0	0	intergen
4	160705869	160706170	MACS_peak_15728	85.72	301	0	0	0	intergen
4	160851186	160851396	MACS_peak_15729	780.06	210	0	0	0	intergen
4	160872098	160872315	MACS_peak_15730	496.96	217	0	0	0	intergen
4	161550977	161551298	MACS_peak_15731	57.3	321	0	1	0	gen
4	161563151	161563409	MACS_peak_15732	864.19	258	0	1	0	gen
4	161564309	161564676	MACS_peak_15733	522.32	367	0	1	0	gen
4	161613334	161613481	MACS_peak_15734	1061.69	147	0	1	0	gen
4	161618229	161618631	MACS_peak_15735	69.98	402	0	1	0	gen
4	161619005	161619253	MACS_peak_15736	120.49	248	0	1	0	gen
4	161832327	161832641	MACS_peak_15737	155.34	314	0	1	0	gen
4	162131323	162131621	MACS_peak_15738	692.37	298	0	1	0	gen
4	162695869	162696318	MACS_peak_15739	506.92	449	0	0	0	intergen
4	163548540	163548820	MACS_peak_15740	454.58	280	0	1	0	gen
4	163550180	163550618	MACS_peak_15741	599.79	438	0	1	0	gen
4	163554928	163555303	MACS_peak_15742	760.94	375	0	1	0	gen
4	163637961	163638287	MACS_peak_15743	153.59	326	0	1	0	gen
4	164340914	164341046	MACS_peak_15746	1116.4	132	0	1	0	gen
4	164545795	164546134	MACS_peak_15747	58.54	339	0	0	0	intergen
4	164546803	164547090	MACS_peak_15748	51.22	287	0	0	0	intergen
4	164671078	164671487	MACS_peak_15749	57.86	409	0	0	0	intergen
4	164742410	164742566	MACS_peak_15750	988	156	0	0	0	intergen
4	165340713	165340917	MACS_peak_15751	629.38	204	0	1	0	gen
4	165350074	165350215	MACS_peak_15752	616.1	141	0	0	0	intergen
4	166118197	166118359	MACS_peak_15754	770.61	162	0	0	0	intergen
4	166270841	166271261	MACS_peak_15755	192.53	420	0	0	0	intergen
4	166408877	166409143	MACS_peak_15756	488.85	266	0	0	1	other
4	166603710	166603871	MACS_peak_15758	472.38	161	0	0	0	intergen
4	166643435	166643673	MACS_peak_15759	406.99	238	0	0	0	intergen
4	166950374	166950778	MACS_peak_15760	50.05	404	0	1	0	gen
4	166953282	166953598	MACS_peak_15761	69.69	316	0	1	0	gen
4	167059102	167059484	MACS_peak_15762	52.69	382	0	1	0	gen
4	167109221	167109613	MACS_peak_15763	508.79	392	0	1	0	gen
4	167205243	167205672	MACS_peak_15764	1511.93	429	0	1	0	gen
4	167272664	167272996	MACS_peak_15765	58.73	332	0	0	0	intergen
4	167276204	167276490	MACS_peak_15766	51.57	286	0	0	0	intergen
4	167278282	167278614	MACS_peak_15767	58.33	332	0	0	0	intergen
4	167314339	167314595	MACS_peak_15768	69	256	0	0	0	intergen
4	167498315	167498561	MACS_peak_15769	485.56	246	0	0	0	intergen
4	167574167	167574523	MACS_peak_15770	413.31	356	0	0	0	intergen
4	167631457	167631769	MACS_peak_15771	265.34	312	0	0	0	intergen
4	167707941	167708320	MACS_peak_15772	56.38	379	0	0	0	intergen
4	168445800	168446087	MACS_peak_15774	82.13	287	0	1	0	gen
4	168870267	168870532	MACS_peak_15775	464.09	265	0	2	0	gen
4	169810235	169810590	MACS_peak_15776	529.16	355	0	0	0	intergen
4	169931478	169931762	MACS_peak_15777	575.25	284	0	0	1	other
4	169960045	169960369	MACS_peak_15778	662.91	324	0	0	2	other
4	170047795	170048068	MACS_peak_15779	749.8	273	0	0	0	intergen
4	170081277	170081553	MACS_peak_15780	443.74	276	0	1	0	gen
4	170254662	170254887	MACS_peak_15781	220.52	225	0	0	0	intergen
4	170264122	170264550	MACS_peak_15782	51.48	428	0	0	0	intergen
4	170473427	170473757	MACS_peak_15783	172.39	330	0	0	0	intergen
4	170592036	170592251	MACS_peak_15785	575.31	215	0	0	1	other
4	170785524	170785913	MACS_peak_15786	64.79	389	0	0	0	intergen
4	170853407	170853711	MACS_peak_15787	954.27	304	0	0	0	intergen
4	171517228	171517370	MACS_peak_15788	868.02	142	0	0	0	intergen
4	171785469	171785668	MACS_peak_15789	809.56	199	0	0	0	intergen
4	172296520	172296866	MACS_peak_15790	62.38	346	0	1	0	gen
4	172442469	172442705	MACS_peak_15791	438.57	236	0	1	0	gen
4	172452043	172452278	MACS_peak_15792	640.49	235	0	1	0	gen
4	172736579	172736780	MACS_peak_15793	550.57	201	0	1	0	gen
4	172981666	172981816	MACS_peak_15794	1162.47	150	0	1	0	gen
4	173013447	173013825	MACS_peak_15795	516.25	378	0	1	0	gen
4	173268334	173268553	MACS_peak_15796	729.14	219	0	1	0	gen
4	173483100	173483362	MACS_peak_15797	466.05	262	0	0	0	intergen
4	173732318	173732453	MACS_peak_15800	1079.97	135	0	0	0	intergen
4	173739521	173739759	MACS_peak_15801	281.68	238	0	0	0	intergen
4	173813884	173814143	MACS_peak_15802	488.85	259	0	0	0	intergen
4	173888806	173889268	MACS_peak_15803	662.91	462	0	0	1	other
4	173965048	173965339	MACS_peak_15804	151.15	291	0	0	1	other
4	174089542	174089704	MACS_peak_15805	1074.92	162	0	0	0	intergen
4	174305804	174306148	MACS_peak_15806	657.74	344	0	1	0	gen
4	174319067	174319490	MACS_peak_15807	1382.4	423	0	1	0	gen
4	174414621	174414911	MACS_peak_15808	50.92	290	0	0	0	intergen
4	174414953	174415165	MACS_peak_15809	122	212	0	0	0	intergen
4	174632185	174632511	MACS_peak_15810	670.69	326	1	0	0	promoter
4	174724424	174724724	MACS_peak_15811	1241.27	300	0	1	0	gen
4	174764127	174764452	MACS_peak_15812	1236.43	325	0	1	0	gen
4	174862943	174863168	MACS_peak_15813	669.59	225	0	1	0	gen
4	175020840	175021207	MACS_peak_15814	170.56	367	0	0	0	intergen
4	175257673	175257978	MACS_peak_15815	50.92	305	0	0	0	intergen
4	175269940	175270246	MACS_peak_15816	795.66	306	0	0	0	intergen
4	175312433	175312682	MACS_peak_15817	605.32	249	0	0	0	intergen
4	175535667	175535971	MACS_peak_15819	84.53	304	0	0	0	intergen
4	175666495	175666730	MACS_peak_15821	516.86	235	0	1	0	gen
4	175812194	175812345	MACS_peak_15822	1111.86	151	0	1	0	gen
4	176693318	176693734	MACS_peak_15824	88.4	416	0	1	1	gen
4	176983709	176983852	MACS_peak_15825	1264.23	143	0	0	0	intergen
4	177587425	177587701	MACS_peak_15826	457.06	276	0	0	1	other
4	177870217	177870433	MACS_peak_15827	411.95	216	0	0	2	other
4	178017923	178018217	MACS_peak_15828	142.72	294	0	0	0	intergen
4	179638464	179638828	MACS_peak_15829	57.32	364	0	0	0	intergen
4	179647721	179647985	MACS_peak_15830	380.3	264	0	0	0	intergen
4	179868857	179869012	MACS_peak_15831	901.33	155	0	0	0	intergen
4	180348797	180348934	MACS_peak_15832	480.85	137	0	0	0	intergen
4	180507609	180507988	MACS_peak_15834	178.37	379	0	0	0	intergen
4	181318931	181319076	MACS_peak_15836	539.27	145	0	0	0	intergen
4	181577060	181577427	MACS_peak_15837	249.91	367	0	0	0	intergen
4	182935408	182935755	MACS_peak_15838	63.89	347	0	0	0	intergen
4	184759530	184759847	MACS_peak_15839	63.13	317	1	0	0	promoter
4	186044580	186044894	MACS_peak_15840	210.76	314	0	0	0	intergen
4	186362959	186363275	MACS_peak_15841	553.16	316	0	0	1	other
4	187131321	187131678	MACS_peak_15842	69	357	0	0	0	intergen
4	187169365	187169644	MACS_peak_15843	1123.24	279	0	0	0	intergen
4	187828484	187828627	MACS_peak_15844	667.47	143	0	0	0	intergen
4	188621075	188621290	MACS_peak_15845	1078.36	215	0	0	1	other
4	189202224	189202590	MACS_peak_15846	408.57	366	0	0	1	other
4	189904470	189904677	MACS_peak_15847	397.9	207	0	0	1	other
4	189912300	189912501	MACS_peak_15848	1034.57	201	0	0	1	other
4	190047648	190047921	MACS_peak_15849	616.54	273	0	0	0	intergen
4	190104818	190105166	MACS_peak_15850	404.2	348	0	0	0	intergen
5	21682	21940	MACS_peak_15858	626.84	258	0	0	0	intergen
5	60738	61001	MACS_peak_15859	149.97	263	0	0	0	intergen
5	188472	188800	MACS_peak_15860	427.34	328	1	1	0	promoter
5	650037	650389	MACS_peak_15861	229.83	352	0	1	0	gen
5	903171	903433	MACS_peak_15862	1002.15	262	0	1	0	gen
5	993204	993479	MACS_peak_15863	265.34	275	0	0	1	other
5	1008601	1008794	MACS_peak_15864	678.9	193	1	0	0	promoter
5	1307679	1307923	MACS_peak_15865	501.16	244	0	0	0	intergen
5	1641653	1641943	MACS_peak_15866	586.2	290	0	0	0	intergen
5	1646347	1646680	MACS_peak_15867	84.22	333	0	0	0	intergen
5	1653891	1654251	MACS_peak_15868	1035.18	360	0	0	0	intergen
5	1713299	1713676	MACS_peak_15869	87.64	377	0	0	0	intergen
5	2146201	2146543	MACS_peak_15873	208.27	342	0	0	0	intergen
5	3057010	3057227	MACS_peak_15875	496.96	217	0	0	0	intergen
5	3443654	3444025	MACS_peak_15876	51.33	371	0	0	1	other
5	3508774	3508933	MACS_peak_15877	592.81	159	0	0	1	other
5	4190946	4191159	MACS_peak_15879	561.02	213	0	0	0	intergen
5	4566715	4567026	MACS_peak_15880	312.33	311	0	0	1	other
5	4862623	4862918	MACS_peak_15881	567.38	295	0	0	1	other
5	5467435	5467694	MACS_peak_15882	578.34	259	0	1	0	gen
5	5680904	5681121	MACS_peak_15883	580.62	217	0	0	0	intergen
5	6647227	6647512	MACS_peak_15884	158.81	285	0	1	0	gen
5	6765740	6766080	MACS_peak_15885	660.56	340	0	0	0	intergen
5	6967247	6967701	MACS_peak_15886	113.5	454	0	0	1	other
5	7173111	7173392	MACS_peak_15887	91.45	281	0	0	1	other
5	7197971	7198338	MACS_peak_15888	67.7	367	0	0	1	other
5	7605276	7605758	MACS_peak_15889	66.62	482	0	1	0	gen
5	7816321	7816541	MACS_peak_15891	883.81	220	0	1	0	gen
5	7839853	7840033	MACS_peak_15892	701.06	180	0	1	0	gen
5	7868113	7868381	MACS_peak_15893	853.65	268	0	2	0	gen
5	8161490	8161882	MACS_peak_15894	201.68	392	0	0	0	intergen
5	8162252	8162658	MACS_peak_15895	73.1	406	0	0	0	intergen
5	8163255	8163608	MACS_peak_15896	60.54	353	0	0	0	intergen
5	8352483	8352741	MACS_peak_15897	468.72	258	0	0	1	other
5	8993045	8993400	MACS_peak_15899	341.31	355	0	0	0	intergen
5	9387704	9388012	MACS_peak_15900	435.51	308	0	1	1	gen
5	9758995	9759196	MACS_peak_15901	551.87	201	0	0	1	other
5	9840757	9840899	MACS_peak_15902	740.33	142	0	0	1	other
5	9898400	9898758	MACS_peak_15903	412.35	358	0	0	1	other
5	10060065	10060279	MACS_peak_15904	746.04	214	0	0	0	intergen
5	10249796	10250027	MACS_peak_15905	1377.45	231	1	0	0	promoter
5	10347393	10347779	MACS_peak_15907	511.95	386	0	0	0	intergen
5	10452772	10452976	MACS_peak_15908	1171.45	204	0	1	0	gen
5	10759588	10759799	MACS_peak_15909	936.57	211	0	1	0	gen
5	10863840	10864100	MACS_peak_15910	467.38	260	0	0	0	intergen
5	11267279	11267574	MACS_peak_15912	1298.93	295	0	1	0	gen
5	11349491	11349754	MACS_peak_15913	454.55	263	0	1	0	gen
5	11740291	11740619	MACS_peak_15915	89.02	328	0	1	0	gen
5	12080357	12080581	MACS_peak_15916	564.54	224	0	0	0	intergen
5	12130684	12130987	MACS_peak_15917	150.39	303	0	0	0	intergen
5	12253058	12253460	MACS_peak_15918	56.28	402	0	0	0	intergen
5	12352445	12352636	MACS_peak_15919	866.35	191	0	0	0	intergen
5	12705006	12705207	MACS_peak_15920	814.37	201	0	0	1	other
5	13478952	13479267	MACS_peak_15921	808.97	315	0	0	0	intergen
5	13976865	13977161	MACS_peak_15922	445	296	0	0	0	intergen
5	14353162	14353295	MACS_peak_15923	1365.09	133	0	1	0	gen
5	14399107	14399438	MACS_peak_15924	425.78	331	0	1	0	gen
5	14416106	14416286	MACS_peak_15925	701.06	180	0	1	0	gen
5	14519360	14519824	MACS_peak_15926	1351.63	464	0	1	0	gen
5	14975324	14975457	MACS_peak_15927	1011.74	133	0	0	0	intergen
5	15003572	15003741	MACS_peak_15928	1025.76	169	0	0	0	intergen
5	15013853	15014234	MACS_peak_15929	401.71	381	0	0	0	intergen
5	15235781	15236165	MACS_peak_15930	631.3	384	0	0	1	other
5	15272371	15272682	MACS_peak_15931	129.15	311	0	0	0	intergen
5	15274257	15274640	MACS_peak_15932	51.83	383	0	0	0	intergen
5	15276950	15277230	MACS_peak_15933	62.38	280	0	0	0	intergen
5	15875558	15875915	MACS_peak_15934	183.06	357	0	1	0	gen
5	16022973	16023153	MACS_peak_15935	644.42	180	0	0	0	intergen
5	16456292	16456517	MACS_peak_15936	866.35	225	1	0	0	promoter
5	16550406	16550652	MACS_peak_15937	763.02	246	0	1	0	gen
5	16666855	16667194	MACS_peak_15938	421.69	339	0	0	0	intergen
5	16845018	16845212	MACS_peak_15939	848.95	194	0	1	0	gen
5	16934121	16934391	MACS_peak_15940	460.86	270	0	1	0	gen
5	17012026	17012205	MACS_peak_15941	531.2	179	0	0	0	intergen
5	17190490	17190817	MACS_peak_15942	1372.86	327	0	1	1	gen
5	17812137	17812452	MACS_peak_15943	279.24	315	0	0	1	other
5	17826834	17827073	MACS_peak_15944	468.75	239	0	0	1	other
5	17840528	17840859	MACS_peak_15945	69	331	0	0	1	other
5	18016053	18016265	MACS_peak_15946	580.75	212	0	0	0	intergen
5	18041085	18041447	MACS_peak_15947	60.06	362	0	0	0	intergen
5	18062197	18062568	MACS_peak_15948	128.66	371	0	0	0	intergen
5	18113816	18114051	MACS_peak_15949	670.71	235	0	0	0	intergen
5	18401709	18401886	MACS_peak_15950	763.02	177	0	0	0	intergen
5	18477340	18477673	MACS_peak_15951	204.25	333	0	0	0	intergen
5	18603891	18604136	MACS_peak_15952	629.38	245	0	0	0	intergen
5	18698672	18699057	MACS_peak_15953	612.17	385	0	0	0	intergen
5	19133543	19133756	MACS_peak_15955	488.19	213	0	0	1	other
5	19163839	19164249	MACS_peak_15956	62.5	410	0	0	0	intergen
5	19166868	19167098	MACS_peak_15957	162.57	230	0	0	0	intergen
5	19220527	19220907	MACS_peak_15958	402.16	380	0	0	0	intergen
5	19220934	19221194	MACS_peak_15959	467.38	260	0	0	0	intergen
5	19374453	19374788	MACS_peak_15960	924.1	335	0	0	0	intergen
5	19409292	19409509	MACS_peak_15961	827.31	217	0	0	0	intergen
5	19559593	19559851	MACS_peak_15962	468.72	258	0	1	0	gen
5	19665678	19666130	MACS_peak_15963	790.81	452	0	1	0	gen
5	19871456	19871725	MACS_peak_15964	586.5	269	0	1	0	gen
5	19967900	19968281	MACS_peak_15965	81.72	381	0	1	0	gen
5	20152003	20152440	MACS_peak_15966	600.34	437	0	1	0	gen
5	20501361	20501659	MACS_peak_15967	603.02	298	0	1	0	gen
5	20870098	20870390	MACS_peak_15968	447.34	292	0	0	1	other
5	21005188	21005429	MACS_peak_15969	1031.52	241	0	0	0	intergen
5	21051738	21051937	MACS_peak_15970	67.56	199	0	0	0	intergen
5	21107851	21108224	MACS_peak_15971	56.93	373	0	0	0	intergen
5	21160079	21160276	MACS_peak_15974	586.19	197	0	0	0	intergen
5	21419433	21419652	MACS_peak_15976	580.62	219	0	0	1	other
5	21459282	21459491	MACS_peak_15977	609.78	209	0	0	1	other
5	21469863	21470213	MACS_peak_15978	361.13	350	0	0	1	other
5	21479549	21479889	MACS_peak_15979	133.6	340	0	0	1	other
5	21485560	21485833	MACS_peak_15980	312.83	273	0	0	1	other
5	21486251	21486582	MACS_peak_15981	101.68	331	0	0	1	other
5	21490061	21490373	MACS_peak_15982	84.4	312	0	0	1	other
5	21529174	21529351	MACS_peak_15983	571.49	177	0	0	1	other
5	21543384	21543601	MACS_peak_15984	1434.33	217	0	0	1	other
5	21591131	21591386	MACS_peak_15985	1171.45	255	0	0	0	intergen
5	21644488	21644746	MACS_peak_15986	1372.86	258	0	0	1	other
5	21698161	21698451	MACS_peak_15987	448.52	290	0	0	1	other
5	21802918	21803224	MACS_peak_15989	554.9	306	0	1	0	gen
5	21810675	21811007	MACS_peak_15990	845.32	332	0	1	0	gen
5	21840316	21840634	MACS_peak_15992	158.81	318	0	1	0	gen
5	22029359	22029627	MACS_peak_15993	80.47	268	0	1	0	gen
5	22266958	22267232	MACS_peak_15994	547.96	274	0	1	0	gen
5	22482501	22482789	MACS_peak_15995	765.65	288	0	1	0	gen
5	22996404	22996636	MACS_peak_15996	863.14	232	0	0	0	intergen
5	23130694	23131156	MACS_peak_15997	953.02	462	0	0	0	intergen
5	23208963	23209135	MACS_peak_15998	1226.97	172	0	0	0	intergen
5	23332634	23332994	MACS_peak_15999	411.4	360	0	0	0	intergen
5	23553347	23553631	MACS_peak_16000	837.6	284	0	0	0	intergen
5	23635027	23635247	MACS_peak_16001	767.82	220	0	0	0	intergen
5	23796629	23796858	MACS_peak_16002	810.23	229	0	0	0	intergen
5	23994615	23995010	MACS_peak_16003	507.23	395	0	0	1	other
5	24097241	24097527	MACS_peak_16004	702.3	286	0	0	1	other
5	24110131	24110408	MACS_peak_16005	710.04	277	0	0	1	other
5	24384291	24384464	MACS_peak_16006	989.9	173	0	0	0	intergen
5	24445382	24445626	MACS_peak_16007	612.68	244	0	0	0	intergen
5	24642160	24642371	MACS_peak_16008	511.33	211	0	1	0	gen
5	24822509	24822761	MACS_peak_16009	470.06	252	0	0	0	intergen
5	25108051	25108268	MACS_peak_16010	1079.97	217	0	0	1	other
5	25314408	25314555	MACS_peak_16011	432.91	147	0	0	1	other
5	25913243	25913495	MACS_peak_16013	470.06	252	0	0	0	intergen
5	25937227	25937571	MACS_peak_16014	147.82	344	0	0	0	intergen
5	26093882	26094109	MACS_peak_16015	498.19	227	0	0	0	intergen
5	26255182	26255588	MACS_peak_16016	950.42	406	0	0	0	intergen
5	26289417	26289708	MACS_peak_16017	103	291	0	0	0	intergen
5	26890680	26890924	MACS_peak_16019	1198.86	244	0	1	0	gen
5	27020886	27021341	MACS_peak_16020	707.93	455	0	1	0	gen
5	27366390	27366752	MACS_peak_16021	440.76	362	0	0	0	intergen
5	27967436	27967646	MACS_peak_16022	613.04	210	0	0	0	intergen
5	28249417	28249594	MACS_peak_16024	639.19	177	0	0	0	intergen
5	28352541	28352918	MACS_peak_16025	81.66	377	0	0	0	intergen
5	28473608	28473915	MACS_peak_16026	345.66	307	0	0	0	intergen
5	28658432	28658728	MACS_peak_16028	960.24	296	0	0	0	intergen
5	28692526	28692814	MACS_peak_16029	1069.92	288	0	0	0	intergen
5	28895939	28896202	MACS_peak_16030	708.18	263	0	0	0	intergen
5	28896920	28897291	MACS_peak_16031	639.57	371	0	0	0	intergen
5	28978080	28978213	MACS_peak_16032	960.62	133	0	0	0	intergen
5	29187761	29188050	MACS_peak_16033	56.85	289	0	0	1	other
5	29398434	29398695	MACS_peak_16034	466.72	261	0	0	0	intergen
5	29991150	29991344	MACS_peak_16035	654.22	194	0	0	0	intergen
5	30040548	30040811	MACS_peak_16036	465.4	263	0	0	0	intergen
5	30401556	30401821	MACS_peak_16037	589.61	265	0	0	0	intergen
5	31232377	31232565	MACS_peak_16038	695.57	188	0	1	1	gen
5	31929293	31929580	MACS_peak_16039	380.3	287	0	1	0	gen
5	32418030	32418366	MACS_peak_16040	178.37	336	0	1	0	gen
5	32637964	32638105	MACS_peak_16041	943.85	141	0	0	0	intergen
5	32794074	32794521	MACS_peak_16042	545.42	447	0	0	0	intergen
5	32855989	32856313	MACS_peak_16043	547.99	324	0	0	0	intergen
5	32966144	32966450	MACS_peak_16044	816.97	306	0	0	1	other
5	33057328	33057566	MACS_peak_16045	111.22	238	0	0	1	other
5	33171890	33172233	MACS_peak_16047	104.56	343	0	0	1	other
5	33435800	33436140	MACS_peak_16048	291.74	340	1	0	1	promoter
5	33470501	33470839	MACS_peak_16049	422.19	338	0	0	0	intergen
5	33934775	33935095	MACS_peak_16050	804.62	320	1	0	0	promoter
5	34148386	34148731	MACS_peak_16051	56.92	345	0	0	0	intergen
5	34188390	34188643	MACS_peak_16052	220.75	253	0	0	1	other
5	34245075	34245541	MACS_peak_16053	689.15	466	0	0	0	intergen
5	34335377	34335598	MACS_peak_16054	564.54	221	0	0	0	intergen
5	34417691	34417966	MACS_peak_16055	312.33	275	0	0	0	intergen
5	34474561	34474784	MACS_peak_16056	955.46	223	0	0	0	intergen
5	34641626	34642005	MACS_peak_16057	79.45	379	0	0	0	intergen
5	34643235	34643463	MACS_peak_16058	119.43	228	0	0	0	intergen
5	34780088	34780450	MACS_peak_16059	50.92	362	0	1	0	gen
5	35003456	35003683	MACS_peak_16060	548.55	227	0	1	0	gen
5	35053163	35053410	MACS_peak_16062	485.56	247	1	0	0	promoter
5	35106896	35107198	MACS_peak_16063	69	302	0	1	0	gen
5	35397404	35397658	MACS_peak_16064	164.73	254	0	0	0	intergen
5	35399747	35400126	MACS_peak_16065	75.01	379	0	0	0	intergen
5	35400475	35400740	MACS_peak_16066	62.63	265	0	0	0	intergen
5	35445263	35445679	MACS_peak_16067	87.75	416	0	0	0	intergen
5	35473876	35474010	MACS_peak_16068	1630.94	134	0	0	0	intergen
5	35496211	35496512	MACS_peak_16069	137.01	301	0	0	0	intergen
5	35651208	35651434	MACS_peak_16070	548.55	226	0	1	0	gen
5	35713759	35714041	MACS_peak_16071	440.04	282	0	1	1	gen
5	36474934	36475283	MACS_peak_16073	112.75	349	0	0	0	intergen
5	36739726	36739947	MACS_peak_16074	696.45	221	0	0	0	intergen
5	36777127	36777406	MACS_peak_16075	455.19	279	0	0	0	intergen
5	36812502	36812928	MACS_peak_16076	77.09	426	0	0	0	intergen
5	36870537	36870923	MACS_peak_16077	752.99	386	0	0	1	other
5	36917542	36917851	MACS_peak_16078	64.39	309	0	1	0	gen
5	36944566	36944935	MACS_peak_16079	640.87	369	0	1	0	gen
5	36973212	36973494	MACS_peak_16080	265.34	282	0	1	0	gen
5	37005998	37006346	MACS_peak_16081	417.2	348	0	1	0	gen
5	37098384	37098631	MACS_peak_16082	369	247	0	0	0	intergen
5	37332060	37332196	MACS_peak_16083	1435.06	136	0	1	0	gen
5	37412968	37413279	MACS_peak_16084	1350.42	311	0	1	0	gen
5	38172403	38172639	MACS_peak_16086	54.96	236	0	0	1	other
5	38265605	38265862	MACS_peak_16087	595.98	257	0	1	0	gen
5	38515659	38515968	MACS_peak_16088	814.28	309	0	1	0	gen
5	38628383	38628749	MACS_peak_16089	92.13	366	0	0	1	other
5	38659080	38659267	MACS_peak_16090	879.27	187	0	0	1	other
5	38922219	38922427	MACS_peak_16091	760.34	208	0	1	0	gen
5	39038677	39039060	MACS_peak_16092	52.39	383	0	1	0	gen
5	39376301	39376539	MACS_peak_16093	1116.4	238	1	1	0	promoter
5	39488701	39489070	MACS_peak_16094	521.2	369	0	0	0	intergen
5	39692070	39692370	MACS_peak_16095	442.68	300	0	0	0	intergen
5	39791777	39792187	MACS_peak_16097	50.28	410	0	0	0	intergen
5	39975978	39976374	MACS_peak_16098	453.78	396	0	0	1	other
5	40174606	40174899	MACS_peak_16099	965.74	293	0	0	0	intergen
5	40708217	40708685	MACS_peak_16100	111.81	468	0	1	0	gen
5	40736412	40736647	MACS_peak_16101	1134.69	235	0	1	0	gen
5	40856485	40856964	MACS_peak_16102	117.8	479	0	1	0	gen
5	40879480	40879732	MACS_peak_16103	856.51	252	0	0	0	intergen
5	40904752	40905056	MACS_peak_16104	664.14	304	1	0	0	promoter
5	41077100	41077402	MACS_peak_16105	82.76	302	0	0	0	intergen
5	41270449	41270658	MACS_peak_16106	780.06	209	0	0	0	intergen
5	41364899	41365077	MACS_peak_16107	954.29	178	0	1	0	gen
5	41403611	41403864	MACS_peak_16108	91.94	253	0	1	0	gen
5	41490741	41491122	MACS_peak_16109	98.95	381	0	1	0	gen
5	41599540	41599914	MACS_peak_16110	109.53	374	0	0	0	intergen
5	41843554	41843855	MACS_peak_16111	262.32	301	0	1	0	gen
5	42221923	42222055	MACS_peak_16113	1116.4	132	0	0	0	intergen
5	42258073	42258452	MACS_peak_16114	143.31	379	0	0	0	intergen
5	42635964	42636241	MACS_peak_16115	356.34	277	0	1	0	gen
5	42636513	42636711	MACS_peak_16116	514.01	198	0	1	0	gen
5	42661404	42661768	MACS_peak_16117	59.47	364	0	1	0	gen
5	42662498	42662795	MACS_peak_16118	87.33	297	0	1	0	gen
5	42889382	42889643	MACS_peak_16120	860.98	261	0	0	0	intergen
5	42912242	42912542	MACS_peak_16121	1241.27	300	0	0	0	intergen
5	42933269	42933716	MACS_peak_16122	174.33	447	0	0	0	intergen
5	42936960	42937401	MACS_peak_16123	133.79	441	0	0	0	intergen
5	42937793	42938027	MACS_peak_16124	347.48	234	0	0	0	intergen
5	43056270	43056609	MACS_peak_16127	106.26	339	0	0	1	other
5	43105712	43106037	MACS_peak_16128	800.34	325	0	1	0	gen
5	43227662	43227882	MACS_peak_16129	513.05	220	0	1	0	gen
5	43261467	43261824	MACS_peak_16130	76.3	357	0	1	0	gen
5	43389739	43390075	MACS_peak_16131	540.49	336	0	1	0	gen
5	43670339	43670551	MACS_peak_16132	209.52	212	0	1	0	gen
5	43722586	43722911	MACS_peak_16133	55.24	325	0	0	0	intergen
5	43969821	43970284	MACS_peak_16134	70.3	463	0	0	0	intergen
5	44152261	44152630	MACS_peak_16135	77.92	369	0	0	0	intergen
5	44265604	44265742	MACS_peak_16136	921.52	138	0	0	0	intergen
5	44433850	44434105	MACS_peak_16137	470.06	255	0	0	0	intergen
5	44524843	44525059	MACS_peak_16138	265.19	216	0	0	0	intergen
5	44536624	44537014	MACS_peak_16139	679.18	390	0	0	0	intergen
5	44569766	44570071	MACS_peak_16140	426.57	305	0	0	0	intergen
5	44574415	44574553	MACS_peak_16141	660.03	138	0	0	0	intergen
5	44759571	44760014	MACS_peak_16143	62.52	443	0	0	2	other
5	44830743	44830983	MACS_peak_16145	481.5	240	0	0	0	intergen
5	44843339	44843585	MACS_peak_16146	485.56	246	0	0	0	intergen
5	45315321	45315581	MACS_peak_16147	84.4	260	0	1	0	gen
5	45351649	45351924	MACS_peak_16148	64.65	275	0	1	0	gen
5	45373894	45374256	MACS_peak_16151	487.59	362	0	1	0	gen
5	45375001	45375377	MACS_peak_16152	433.1	376	0	1	0	gen
5	45505199	45505495	MACS_peak_16154	127.15	296	0	1	0	gen
5	45696374	45696654	MACS_peak_16156	578.19	280	0	0	0	intergen
5	45834884	45835293	MACS_peak_16157	71.17	409	0	0	0	intergen
5	45896100	45896302	MACS_peak_16158	814.37	202	0	0	0	intergen
5	45904623	45904755	MACS_peak_16159	1116.4	132	0	0	0	intergen
5	45970565	45970880	MACS_peak_16160	158.81	315	0	0	0	intergen
5	46030625	46030983	MACS_peak_16161	75.01	358	0	0	0	intergen
5	46065630	46065857	MACS_peak_16162	695.57	227	0	0	0	intergen
5	46230748	46230972	MACS_peak_16163	712.32	224	0	0	0	intergen
5	46324749	46325061	MACS_peak_16164	66.2	312	0	0	0	intergen
5	46327680	46327901	MACS_peak_16165	88.59	221	0	0	0	intergen
5	46328999	46329298	MACS_peak_16166	51.77	299	0	0	0	intergen
5	46336102	46336339	MACS_peak_16169	776.64	237	0	0	0	intergen
5	46336833	46337066	MACS_peak_16170	83.4	233	0	0	0	intergen
5	46337196	46337598	MACS_peak_16171	112.76	402	0	0	0	intergen
5	46339891	46340178	MACS_peak_16172	79.14	287	0	0	0	intergen
5	46340590	46340800	MACS_peak_16173	190.92	210	0	0	0	intergen
5	46343162	46343540	MACS_peak_16174	75.71	378	0	0	0	intergen
5	46344863	46345317	MACS_peak_16175	85.74	454	0	0	0	intergen
5	46345684	46346129	MACS_peak_16176	64.25	445	0	0	0	intergen
5	46352333	46352771	MACS_peak_16178	363.63	438	0	0	0	intergen
5	46353935	46354376	MACS_peak_16179	60	441	0	0	0	intergen
5	46356763	46357132	MACS_peak_16180	109.53	369	0	0	0	intergen
5	46360017	46360329	MACS_peak_16182	81.3	312	0	0	0	intergen
5	46363912	46364186	MACS_peak_16183	95.63	274	0	0	0	intergen
5	46370170	46370398	MACS_peak_16185	103.69	228	0	0	0	intergen
5	46384875	46385093	MACS_peak_16188	87.51	218	0	0	0	intergen
5	46391493	46391735	MACS_peak_16189	146.2	242	0	0	0	intergen
5	46391956	46392345	MACS_peak_16190	208.72	389	0	0	0	intergen
5	46395846	46396218	MACS_peak_16191	65.49	372	0	0	0	intergen
5	46403033	46403404	MACS_peak_16192	56.38	371	0	0	0	intergen
5	46404835	46405297	MACS_peak_16193	182.82	462	0	0	0	intergen
5	50154680	50154950	MACS_peak_16195	55.51	270	0	0	0	intergen
5	50168554	50168764	MACS_peak_16196	294.49	210	0	0	0	intergen
5	50178116	50178478	MACS_peak_16197	202.06	362	0	0	0	intergen
5	50189016	50189341	MACS_peak_16198	81.72	325	0	0	0	intergen
5	50202735	50203009	MACS_peak_16199	172.95	274	0	0	0	intergen
5	50221241	50221540	MACS_peak_16200	100.2	299	0	0	0	intergen
5	50234095	50234251	MACS_peak_16201	423.54	156	0	0	0	intergen
5	50245593	50246059	MACS_peak_16202	62.5	466	0	0	0	intergen
5	50263464	50263719	MACS_peak_16203	197.81	255	0	0	0	intergen
5	50293758	50293954	MACS_peak_16204	259.76	196	0	0	0	intergen
5	50309844	50310114	MACS_peak_16205	190.02	270	0	0	0	intergen
5	50325218	50325640	MACS_peak_16206	462.26	422	0	0	0	intergen
5	50360281	50360506	MACS_peak_16207	548.55	225	0	0	0	intergen
5	50377986	50378299	MACS_peak_16208	83.67	313	0	0	0	intergen
5	50380269	50380587	MACS_peak_16209	114.74	318	0	0	0	intergen
5	50498792	50499172	MACS_peak_16210	64.17	380	0	0	0	intergen
5	50512995	50513341	MACS_peak_16211	488.85	346	0	0	0	intergen
5	50963037	50963284	MACS_peak_16213	389.4	247	0	0	0	intergen
5	51257966	51258280	MACS_peak_16214	232.66	314	0	0	0	intergen
5	51641476	51641783	MACS_peak_16215	100.52	307	0	0	0	intergen
5	51960963	51961171	MACS_peak_16216	582.71	208	0	0	0	intergen
5	52086918	52087282	MACS_peak_16217	71.45	364	0	0	0	intergen
5	52091355	52091697	MACS_peak_16218	84.21	342	0	0	0	intergen
5	52134238	52134579	MACS_peak_16219	537.45	341	0	0	0	intergen
5	52356405	52356682	MACS_peak_16220	710.04	277	0	0	0	intergen
5	52613605	52613852	MACS_peak_16221	60.61	247	0	0	0	intergen
5	52698320	52698776	MACS_peak_16222	58.75	456	0	0	1	other
5	52973897	52974240	MACS_peak_16223	154.62	343	0	0	1	other
5	53004807	53005027	MACS_peak_16224	625.11	220	0	1	0	gen
5	53146240	53146570	MACS_peak_16225	72.48	330	0	0	0	intergen
5	53280338	53280589	MACS_peak_16226	59.77	251	0	0	0	intergen
5	53662103	53662411	MACS_peak_16227	64.74	308	0	1	0	gen
5	54234615	54234986	MACS_peak_16229	520.09	371	0	1	0	gen
5	54243491	54243770	MACS_peak_16230	842.51	279	0	1	0	gen
5	54419055	54419481	MACS_peak_16231	721.05	426	0	0	0	intergen
5	54419658	54419982	MACS_peak_16232	277.38	324	0	0	0	intergen
5	54489488	54489659	MACS_peak_16233	718.95	171	0	0	0	intergen
5	54517501	54517743	MACS_peak_16235	501.16	242	1	0	0	promoter
5	54809818	54810037	MACS_peak_16236	305.82	219	0	0	1	other
5	54905906	54906232	MACS_peak_16237	670.69	326	0	0	0	intergen
5	55077468	55077830	MACS_peak_16238	164.26	362	0	0	1	other
5	55105956	55106380	MACS_peak_16239	579.03	424	1	0	0	promoter
5	55292431	55292607	MACS_peak_16240	972.07	176	0	1	1	gen
5	55344346	55344774	MACS_peak_16241	975.66	428	0	1	0	gen
5	55587949	55588320	MACS_peak_16242	65.22	371	0	0	0	intergen
5	55748718	55748926	MACS_peak_16243	382.9	208	0	2	0	gen
5	55754779	55754977	MACS_peak_16244	122.27	198	0	2	0	gen
5	55764497	55764815	MACS_peak_16245	419.41	318	0	2	0	gen
5	55936157	55936466	MACS_peak_16246	1230.02	309	1	0	1	promoter
5	56203982	56204386	MACS_peak_16248	55.71	404	0	1	0	gen
5	56778662	56778982	MACS_peak_16249	84.86	320	0	0	0	intergen
5	56891799	56892176	MACS_peak_16250	62.6	377	0	1	0	gen
5	57195973	57196114	MACS_peak_16251	345.1	141	0	1	0	gen
5	57377767	57378089	MACS_peak_16252	53.8	322	0	0	0	intergen
5	57869441	57869757	MACS_peak_16253	103.45	316	0	0	0	intergen
5	57889727	57889959	MACS_peak_16254	678.9	232	0	0	0	intergen
5	58051761	58052089	MACS_peak_16255	51.73	328	0	0	0	intergen
5	58220660	58220989	MACS_peak_16256	96.08	329	0	0	0	intergen
5	58553249	58553615	MACS_peak_16257	87.75	366	0	0	1	other
5	58871721	58872037	MACS_peak_16259	433.75	316	0	0	0	intergen
5	58891698	58892114	MACS_peak_16260	857.05	416	0	0	0	intergen
5	59174174	59174528	MACS_peak_16262	650.84	354	0	1	0	gen
5	59256822	59257061	MACS_peak_16263	645.81	239	0	1	0	gen
5	59380387	59380757	MACS_peak_16264	869.39	370	0	1	0	gen
5	59396679	59397108	MACS_peak_16265	95.25	429	0	1	0	gen
5	59472051	59472288	MACS_peak_16266	2932.55	237	0	1	0	gen
5	59506162	59506626	MACS_peak_16267	702.58	464	0	1	0	gen
5	59573941	59574252	MACS_peak_16268	722.05	311	0	1	0	gen
5	59660871	59661080	MACS_peak_16269	954.29	209	0	1	0	gen
5	59800049	59800473	MACS_peak_16270	492.72	424	0	1	0	gen
5	59873603	59873865	MACS_peak_16271	466.05	262	0	1	0	gen
5	60048149	60048454	MACS_peak_16272	69.97	305	0	1	0	gen
5	60318309	60318628	MACS_peak_16273	102.16	319	0	1	0	gen
5	60649377	60649638	MACS_peak_16274	576.74	261	0	1	0	gen
5	60667882	60668355	MACS_peak_16275	697.34	473	0	1	0	gen
5	60862806	60863179	MACS_peak_16276	89.75	373	0	0	0	intergen
5	60960589	60961026	MACS_peak_16277	718.97	437	0	1	0	gen
5	61768759	61768971	MACS_peak_16279	596.79	212	0	0	0	intergen
5	62143663	62143928	MACS_peak_16281	720.77	265	0	0	0	intergen
5	62223280	62223738	MACS_peak_16282	972.61	458	0	0	0	intergen
5	62225048	62225377	MACS_peak_16283	335.28	329	0	0	0	intergen
5	62443855	62444149	MACS_peak_16284	446.16	294	0	2	0	gen
5	62460540	62460845	MACS_peak_16285	439.84	305	0	2	0	gen
5	62676989	62677354	MACS_peak_16286	115.52	365	0	0	0	intergen
5	62867254	62867633	MACS_peak_16288	172.19	379	0	0	0	intergen
5	63025871	63026149	MACS_peak_16289	834.03	278	0	0	0	intergen
5	63230291	63230685	MACS_peak_16290	91.1	394	0	0	0	intergen
5	63584993	63585396	MACS_peak_16291	71.03	403	0	0	0	intergen
5	63628038	63628408	MACS_peak_16292	51.6	370	0	0	0	intergen
5	63902920	63903137	MACS_peak_16293	901.33	217	0	0	0	intergen
5	63963225	63963479	MACS_peak_16294	470.06	254	1	0	1	promoter
5	64074421	64074806	MACS_peak_16295	1146.54	385	0	0	0	intergen
5	64132215	64132495	MACS_peak_16297	65.58	280	0	0	0	intergen
5	64133393	64133651	MACS_peak_16298	84.4	258	0	0	0	intergen
5	64635124	64635353	MACS_peak_16299	548.55	229	0	0	0	intergen
5	64712847	64713138	MACS_peak_16300	56.46	291	0	1	0	gen
5	64958815	64959069	MACS_peak_16301	470.06	254	0	1	0	gen
5	65164357	65164713	MACS_peak_16302	74.77	356	0	1	0	gen
5	65165744	65166136	MACS_peak_16303	102.68	392	0	1	0	gen
5	65696610	65696842	MACS_peak_16305	532.66	232	0	1	0	gen
5	66018364	66018774	MACS_peak_16306	953.02	410	0	1	0	gen
5	66040728	66040860	MACS_peak_16307	1116.4	132	0	1	0	gen
5	66050761	66050913	MACS_peak_16308	548.25	152	0	1	0	gen
5	66060780	66061159	MACS_peak_16309	87.49	379	0	1	0	gen
5	66386595	66386806	MACS_peak_16310	111.64	211	0	0	0	intergen
5	66447434	66447805	MACS_peak_16311	56.38	371	0	0	0	intergen
5	66522259	66522714	MACS_peak_16312	1542.43	455	0	0	0	intergen
5	66753229	66753500	MACS_peak_16314	51.07	271	0	1	0	gen
5	66814493	66814689	MACS_peak_16315	827.89	196	0	1	0	gen
5	66864580	66864874	MACS_peak_16316	695.63	294	0	1	0	gen
5	66917249	66917445	MACS_peak_16317	662.31	196	0	1	0	gen
5	66987917	66988288	MACS_peak_16318	763.88	371	0	1	0	gen
5	67080901	67081211	MACS_peak_16319	406.81	310	0	1	0	gen
5	67156905	67157347	MACS_peak_16320	1094.3	442	0	1	0	gen
5	67224197	67224346	MACS_peak_16321	1579.8	149	0	0	0	intergen
5	67246062	67246316	MACS_peak_16323	273.01	254	0	0	0	intergen
5	67739165	67739489	MACS_peak_16324	61.31	324	0	0	2	other
5	68071417	68071627	MACS_peak_16326	528.42	210	0	0	0	intergen
5	68238971	68239103	MACS_peak_16327	1116.4	132	0	1	0	gen
5	68286316	68286719	MACS_peak_16328	1707.69	403	0	1	0	gen
5	68460206	68460460	MACS_peak_16329	470.06	254	0	0	0	intergen
5	68536675	68536930	MACS_peak_16330	710.43	255	0	0	0	intergen
5	68696511	68696769	MACS_peak_16332	126.66	258	0	0	0	intergen
5	68717218	68717403	MACS_peak_16333	188.17	185	0	0	0	intergen
5	69024188	69024502	MACS_peak_16334	434.84	314	0	0	1	other
5	69373593	69373806	MACS_peak_16335	602.31	213	1	0	0	promoter
5	69629633	69629837	MACS_peak_16336	182.8	204	0	0	0	intergen
5	69630292	69630568	MACS_peak_16337	114.26	276	0	0	0	intergen
5	69646975	69647336	MACS_peak_16338	94.28	361	0	0	1	other
5	69650715	69651121	MACS_peak_16339	81.15	406	0	0	1	other
5	69651580	69651856	MACS_peak_16340	284.36	276	0	0	1	other
5	69710846	69711118	MACS_peak_16341	1158.48	272	0	0	0	intergen
5	69751384	69751587	MACS_peak_16342	394.43	203	0	0	0	intergen
5	69803676	69803879	MACS_peak_16343	392.97	203	0	0	0	intergen
5	69844168	69844430	MACS_peak_16344	562.81	262	0	0	0	intergen
5	69904655	69904872	MACS_peak_16345	345.87	217	0	0	1	other
5	69905373	69905733	MACS_peak_16346	555.91	360	0	0	1	other
5	69909111	69909472	MACS_peak_16347	56.38	361	0	0	1	other
5	70208664	70209025	MACS_peak_16348	56.38	361	0	0	0	intergen
5	70212406	70212812	MACS_peak_16349	417.7	406	0	0	0	intergen
5	70213271	70213454	MACS_peak_16350	251.56	183	0	0	0	intergen
5	70226714	70227075	MACS_peak_16351	58.18	361	0	0	1	other
5	70230456	70230841	MACS_peak_16352	474.88	385	0	0	1	other
5	70231321	70231597	MACS_peak_16353	295.58	276	0	0	1	other
5	70290578	70290848	MACS_peak_16354	739.02	270	0	0	0	intergen
5	70331329	70331619	MACS_peak_16355	306.6	290	0	0	0	intergen
5	70400895	70401185	MACS_peak_16356	637.91	290	0	0	0	intergen
5	70485173	70485423	MACS_peak_16357	234.8	250	0	0	0	intergen
5	70485931	70486207	MACS_peak_16358	303.42	276	0	0	0	intergen
5	70492690	70493030	MACS_peak_16359	79.28	340	0	0	0	intergen
5	70501810	70502171	MACS_peak_16360	56.38	361	0	0	0	intergen
5	70505547	70505928	MACS_peak_16361	276.09	381	0	0	0	intergen
5	70506408	70506648	MACS_peak_16362	300.97	240	0	0	0	intergen
5	70523091	70523452	MACS_peak_16363	60.35	361	0	0	1	other
5	70526832	70527233	MACS_peak_16364	271.15	401	0	0	1	other
5	70527697	70527973	MACS_peak_16365	223.71	276	0	0	1	other
5	70540943	70541149	MACS_peak_16366	471.91	206	0	0	1	other
5	70586101	70586363	MACS_peak_16367	564.34	262	0	0	0	intergen
5	70626697	70626900	MACS_peak_16368	354.7	203	0	0	0	intergen
5	70678484	70678774	MACS_peak_16369	306.6	290	0	0	0	intergen
5	70719260	70719530	MACS_peak_16370	928.11	270	0	0	0	intergen
5	70764044	70764244	MACS_peak_16371	382.03	200	0	0	1	other
5	70779662	70779938	MACS_peak_16372	290.51	276	0	0	1	other
5	70780422	70780799	MACS_peak_16373	255.36	377	0	0	1	other
5	70784177	70784538	MACS_peak_16374	64.91	361	0	0	1	other
5	71032452	71032692	MACS_peak_16375	457.25	240	1	0	0	promoter
5	71212770	71213171	MACS_peak_16376	261.26	401	0	0	0	intergen
5	71213635	71213911	MACS_peak_16377	371.07	276	0	0	0	intergen
5	71230901	71231134	MACS_peak_16378	253.43	233	0	0	1	other
5	71231656	71231932	MACS_peak_16379	238.3	276	0	0	1	other
5	71260255	71260634	MACS_peak_16380	158.81	379	0	0	0	intergen
5	71290097	71290367	MACS_peak_16381	1053.37	270	0	0	0	intergen
5	71330644	71330934	MACS_peak_16382	288.1	290	0	0	0	intergen
5	71447300	71447630	MACS_peak_16383	382	330	0	0	0	intergen
5	71829139	71829473	MACS_peak_16385	541.72	334	0	0	0	intergen
5	71835482	71835812	MACS_peak_16386	253.22	330	0	0	0	intergen
5	71851849	71852132	MACS_peak_16387	106.51	283	0	0	0	intergen
5	72532183	72532521	MACS_peak_16388	721.05	338	0	0	0	intergen
5	72536840	72537102	MACS_peak_16389	466.05	262	0	0	0	intergen
5	72730461	72730687	MACS_peak_16390	102.43	226	0	0	1	other
5	72906173	72906318	MACS_peak_16391	847.8	145	0	1	0	gen
5	72972159	72972462	MACS_peak_16392	105.12	303	0	1	0	gen
5	72974526	72974870	MACS_peak_16393	87.3	344	0	1	0	gen
5	73027497	73027835	MACS_peak_16394	412.43	338	0	1	0	gen
5	73201992	73202252	MACS_peak_16395	467.38	260	0	0	0	intergen
5	73387192	73387372	MACS_peak_16396	1010.11	180	0	0	1	other
5	73469047	73469417	MACS_peak_16397	128.68	370	0	0	1	other
5	73792783	73793024	MACS_peak_16398	797.18	241	0	1	0	gen
5	74006994	74007244	MACS_peak_16399	485.56	250	0	0	0	intergen
5	74349432	74349787	MACS_peak_16400	99.04	355	0	0	0	intergen
5	74708168	74708530	MACS_peak_16401	93.09	362	0	1	0	gen
5	74746454	74746679	MACS_peak_16402	844.95	225	0	1	0	gen
5	74903509	74903769	MACS_peak_16403	441.71	260	0	0	0	intergen
5	75049831	75050069	MACS_peak_16404	797.18	238	0	0	1	other
5	75136510	75136870	MACS_peak_16405	103.45	360	0	1	0	gen
5	75265747	75266042	MACS_peak_16406	694.81	295	0	0	0	intergen
5	75681344	75681588	MACS_peak_16407	918.92	244	0	1	0	gen
5	75698050	75698432	MACS_peak_16408	62.28	382	0	1	0	gen
5	75700052	75700399	MACS_peak_16409	52.3	347	0	1	0	gen
5	75700505	75700739	MACS_peak_16410	85.56	234	0	1	0	gen
5	75752340	75752584	MACS_peak_16411	918.92	244	0	0	0	intergen
5	75790437	75790732	MACS_peak_16412	212.87	295	0	0	0	intergen
5	75897531	75897939	MACS_peak_16414	63.14	408	0	0	0	intergen
5	76214562	76214916	MACS_peak_16415	488.85	354	0	1	0	gen
5	76256387	76256651	MACS_peak_16416	451.4	264	0	1	0	gen
5	76641597	76641859	MACS_peak_16417	466.05	262	0	1	0	gen
5	76774643	76774943	MACS_peak_16418	427.96	300	0	0	0	intergen
5	76780331	76780725	MACS_peak_16419	396.94	394	0	0	0	intergen
5	76836706	76836896	MACS_peak_16420	830.25	190	0	0	0	intergen
5	77107211	77107452	MACS_peak_16421	438.69	241	0	2	1	gen
5	77752163	77752389	MACS_peak_16423	400.49	226	0	1	0	gen
5	77809519	77809822	MACS_peak_16424	89.02	303	0	1	0	gen
5	78121932	78122302	MACS_peak_16425	55.64	370	0	1	0	gen
5	78127949	78128223	MACS_peak_16426	317.69	274	0	1	0	gen
5	78278412	78278733	MACS_peak_16427	69	321	0	1	0	gen
5	78320536	78320774	MACS_peak_16428	876.89	238	0	0	0	intergen
5	78456775	78457107	MACS_peak_16429	53.45	332	0	1	0	gen
5	78467840	78468049	MACS_peak_16430	876.89	209	0	1	0	gen
5	78472472	78472739	MACS_peak_16431	449.45	267	0	1	0	gen
5	78583969	78584297	MACS_peak_16432	50.25	328	0	1	0	gen
5	78619935	78620383	MACS_peak_16433	66.96	448	0	1	0	gen
5	78711058	78711374	MACS_peak_16434	69	316	0	1	1	gen
5	78760811	78761055	MACS_peak_16435	629.38	244	0	1	0	gen
5	78872962	78873221	MACS_peak_16436	141.44	259	0	1	0	gen
5	78911376	78911706	MACS_peak_16437	178.37	330	0	1	0	gen
5	78947372	78947677	MACS_peak_16438	278.37	305	0	1	0	gen
5	79021062	79021362	MACS_peak_16439	563.9	300	0	1	0	gen
5	79024986	79025281	MACS_peak_16440	1883.37	295	0	1	0	gen
5	79100478	79100944	MACS_peak_16441	64.65	466	0	1	0	gen
5	79133126	79133405	MACS_peak_16442	455.19	279	0	1	0	gen
5	79133746	79133968	MACS_peak_16443	564.54	222	0	1	0	gen
5	79253961	79254150	MACS_peak_16444	1079.97	189	0	1	0	gen
5	79464829	79465099	MACS_peak_16445	1134.59	270	0	1	0	gen
5	79539772	79539908	MACS_peak_16446	830.31	136	0	0	0	intergen
5	79858226	79858499	MACS_peak_16447	1130.76	273	0	0	0	intergen
5	79904351	79904633	MACS_peak_16448	72.48	282	0	0	0	intergen
5	79906201	79906453	MACS_peak_16449	75.51	252	0	0	0	intergen
5	79907166	79907515	MACS_peak_16450	164.46	349	0	0	0	intergen
5	80314295	80314548	MACS_peak_16451	77.48	253	0	0	0	intergen
5	80345951	80346316	MACS_peak_16452	379.66	365	0	0	0	intergen
5	80421151	80421521	MACS_peak_16453	129.45	370	0	1	0	gen
5	80521071	80521245	MACS_peak_16454	508.84	174	0	1	0	gen
5	80581098	80581453	MACS_peak_16455	51.89	355	0	0	0	intergen
5	80600097	80600490	MACS_peak_16456	1188.74	393	0	0	0	intergen
5	80903152	80903376	MACS_peak_16458	435.1	224	0	0	0	intergen
5	81108501	81108697	MACS_peak_16459	827.89	196	0	1	0	gen
5	81595506	81595928	MACS_peak_16460	147.82	422	0	1	0	gen
5	81620771	81621120	MACS_peak_16461	68.08	349	0	1	0	gen
5	81886567	81886719	MACS_peak_16462	477.58	152	0	0	0	intergen
5	82110350	82110713	MACS_peak_16463	81.72	363	0	1	0	gen
5	82174672	82174991	MACS_peak_16464	1217.91	319	0	1	0	gen
5	82259303	82259532	MACS_peak_16465	695.57	229	0	1	0	gen
5	82312409	82312580	MACS_peak_16466	797.18	171	0	1	0	gen
5	82472519	82472903	MACS_peak_16468	428.85	384	0	0	0	intergen
5	82641528	82641782	MACS_peak_16469	470.06	254	0	0	0	intergen
5	82793915	82794192	MACS_peak_16470	456.44	277	0	0	0	intergen
5	82934298	82934580	MACS_peak_16471	74.87	282	0	0	0	intergen
5	83398939	83399244	MACS_peak_16472	86.45	305	0	0	0	intergen
5	83430482	83430800	MACS_peak_16473	551.85	318	0	0	0	intergen
5	83461871	83462243	MACS_peak_16474	62.22	372	0	0	0	intergen
5	83718269	83718486	MACS_peak_16475	1079.97	217	0	1	0	gen
5	83722264	83722610	MACS_peak_16476	418.18	346	0	0	0	intergen
5	83809417	83809594	MACS_peak_16477	763.02	177	0	0	0	intergen
5	83904042	83904464	MACS_peak_16478	91.14	422	0	0	0	intergen
5	84055685	84056015	MACS_peak_16479	77.46	330	0	1	0	gen
5	84132200	84132597	MACS_peak_16480	1552.83	397	0	1	0	gen
5	84419142	84419426	MACS_peak_16481	182.33	284	0	0	1	other
5	84807637	84808005	MACS_peak_16482	91.07	368	0	0	0	intergen
5	84939638	84939991	MACS_peak_16483	56.38	353	0	0	0	intergen
5	85087135	85087278	MACS_peak_16484	575.83	143	0	0	0	intergen
5	85422433	85422724	MACS_peak_16485	139.57	291	0	0	0	intergen
5	85476346	85476665	MACS_peak_16486	675.92	319	0	0	0	intergen
5	85659672	85660007	MACS_peak_16487	68.21	335	0	0	0	intergen
5	85660799	85661223	MACS_peak_16488	92.94	424	0	0	0	intergen
5	85856158	85856407	MACS_peak_16489	485.56	249	0	0	0	intergen
5	85856628	85856963	MACS_peak_16490	423.72	335	0	0	0	intergen
5	85908905	85909359	MACS_peak_16491	879.24	454	0	0	0	intergen
5	85917682	85917909	MACS_peak_16492	424.5	227	0	0	0	intergen
5	86265206	86265547	MACS_peak_16493	55.96	341	0	0	0	intergen
5	86381349	86381652	MACS_peak_16495	688.35	303	0	0	0	intergen
5	86501870	86502119	MACS_peak_16496	485.56	249	0	0	0	intergen
5	86665423	86665782	MACS_peak_16497	312.33	359	0	0	0	intergen
5	86679578	86679876	MACS_peak_16498	1100.44	298	0	0	0	intergen
5	86729585	86729903	MACS_peak_16499	138.65	318	0	0	0	intergen
5	86770371	86770508	MACS_peak_16500	744.12	137	0	0	0	intergen
5	87157369	87157525	MACS_peak_16501	492.3	156	0	0	0	intergen
5	87257656	87258041	MACS_peak_16502	512.49	385	0	0	0	intergen
5	87400347	87400676	MACS_peak_16503	544.83	329	0	1	0	gen
5	87541665	87541864	MACS_peak_16504	1007.8	199	0	0	0	intergen
5	87605026	87605234	MACS_peak_16505	613.04	208	0	0	0	intergen
5	87606224	87606531	MACS_peak_16506	559.13	307	0	0	0	intergen
5	88023098	88023237	MACS_peak_16507	1608.09	139	0	0	0	intergen
5	88053359	88053768	MACS_peak_16508	54.31	409	0	0	0	intergen
5	88189577	88189783	MACS_peak_16509	629.38	206	1	0	0	promoter
5	88350646	88351006	MACS_peak_16510	164.26	360	0	0	1	other
5	88729643	88729893	MACS_peak_16511	485.56	250	0	1	0	gen
5	88964989	88965245	MACS_peak_16512	596.79	256	0	0	1	other
5	88969201	88969430	MACS_peak_16513	548.55	229	0	0	1	other
5	89068105	89068357	MACS_peak_16514	447.89	252	0	0	1	other
5	89856204	89856417	MACS_peak_16515	918.92	213	0	0	0	intergen
5	90151672	90151944	MACS_peak_16517	95.47	272	0	0	0	intergen
5	90213778	90214243	MACS_peak_16518	83.55	465	0	0	1	other
5	90265304	90265615	MACS_peak_16519	682.05	311	0	0	1	other
5	90560872	90561130	MACS_peak_16520	468.72	258	0	1	0	gen
5	90562073	90562328	MACS_peak_16521	3100	255	0	1	0	gen
5	90606577	90606852	MACS_peak_16522	457.69	275	0	1	0	gen
5	90665916	90666221	MACS_peak_16523	74.41	305	0	1	0	gen
5	90686438	90686670	MACS_peak_16524	67.51	232	0	1	0	gen
5	90802816	90803137	MACS_peak_16525	443.18	321	0	1	0	gen
5	90972156	90972548	MACS_peak_16527	105	392	0	1	0	gen
5	90973085	90973438	MACS_peak_16528	99.75	353	0	1	0	gen
5	91188651	91188785	MACS_peak_16529	1359.65	134	0	0	1	other
5	91273538	91274011	MACS_peak_16530	100.89	473	0	0	1	other
5	91384897	91385260	MACS_peak_16531	769.88	363	0	0	1	other
5	91657337	91657612	MACS_peak_16532	488.85	275	0	0	0	intergen
5	91872520	91872772	MACS_peak_16533	470.06	252	0	0	0	intergen
5	91929154	91929474	MACS_peak_16534	431.58	320	0	0	0	intergen
5	92185248	92185386	MACS_peak_16535	472.91	138	0	0	1	other
5	92193407	92193608	MACS_peak_16536	188.84	201	0	0	1	other
5	92282448	92282830	MACS_peak_16537	105.15	382	0	0	1	other
5	92576541	92576736	MACS_peak_16538	848.95	195	0	0	1	other
5	92909491	92909800	MACS_peak_16539	437.6	309	0	0	1	other
5	92916037	92916283	MACS_peak_16540	485.56	246	0	0	1	other
5	93095786	93096089	MACS_peak_16541	63.13	303	0	0	0	intergen
5	93216729	93217138	MACS_peak_16542	83.01	409	0	0	0	intergen
5	93263152	93263498	MACS_peak_16543	56.95	346	0	0	0	intergen
5	93521402	93521627	MACS_peak_16545	614.29	225	0	0	1	other
5	93692979	93693345	MACS_peak_16546	129.12	366	0	1	0	gen
5	93771391	93771662	MACS_peak_16547	88.33	271	0	1	0	gen
5	93801330	93801590	MACS_peak_16548	1147.67	260	0	1	0	gen
5	94019003	94019343	MACS_peak_16549	186.49	340	0	1	0	gen
5	94226518	94226928	MACS_peak_16550	189.51	410	0	1	0	gen
5	94737961	94738170	MACS_peak_16551	771.58	209	0	2	0	gen
5	94850407	94850811	MACS_peak_16552	2458.64	404	0	1	0	gen
5	94968391	94968866	MACS_peak_16553	1197.42	475	0	1	0	gen
5	94969190	94969548	MACS_peak_16554	1174.11	358	0	1	0	gen
5	95061318	95061457	MACS_peak_16555	560.85	139	0	1	0	gen
5	95098438	95098719	MACS_peak_16556	151.3	281	0	1	0	gen
5	95167959	95168237	MACS_peak_16558	64.43	278	0	1	0	gen
5	95201379	95201527	MACS_peak_16559	911.89	148	0	1	0	gen
5	95847116	95847409	MACS_peak_16560	568.79	293	0	0	1	other
5	96336390	96336749	MACS_peak_16561	526.85	359	0	0	1	other
5	96560605	96560884	MACS_peak_16562	73.7	279	0	1	1	gen
5	96652060	96652339	MACS_peak_16563	455.19	279	0	1	0	gen
5	96752428	96752769	MACS_peak_16564	761.56	341	0	1	0	gen
5	96868819	96869211	MACS_peak_16565	626.35	392	0	0	1	other
5	96954810	96955151	MACS_peak_16566	142.05	341	0	1	0	gen
5	97017048	97017404	MACS_peak_16567	413.31	356	0	1	0	gen
5	97213307	97213559	MACS_peak_16568	883.81	252	0	0	1	other
5	97231052	97231280	MACS_peak_16569	623.74	228	0	0	1	other
5	97294244	97294582	MACS_peak_16570	59.68	338	0	0	1	other
5	97382785	97383115	MACS_peak_16571	72.11	330	0	0	1	other
5	97721165	97721488	MACS_peak_16573	84.4	323	0	0	0	intergen
5	97748513	97748987	MACS_peak_16574	940.67	474	0	0	0	intergen
5	97766815	97767141	MACS_peak_16575	51.4	326	0	0	0	intergen
5	97812742	97813144	MACS_peak_16576	82.07	402	0	0	0	intergen
5	97850145	97850399	MACS_peak_16577	470.06	254	0	0	0	intergen
5	98115410	98115790	MACS_peak_16578	52.93	380	0	0	1	other
5	98548206	98548544	MACS_peak_16581	73.45	338	0	0	0	intergen
5	98550610	98550977	MACS_peak_16582	57.25	367	0	0	0	intergen
5	98615946	98616240	MACS_peak_16583	568.08	294	0	0	0	intergen
5	98764451	98764623	MACS_peak_16584	1007.8	172	1	0	0	promoter
5	98769085	98769413	MACS_peak_16585	427.34	328	1	0	0	promoter
5	98771475	98771918	MACS_peak_16586	715.24	443	1	0	1	promoter
5	98796340	98796690	MACS_peak_16587	416.22	350	0	1	0	gen
5	98851079	98851334	MACS_peak_16588	602.09	255	1	0	0	promoter
5	98955435	98955686	MACS_peak_16589	80	251	0	0	1	other
5	99060371	99060694	MACS_peak_16590	722.05	323	0	0	0	intergen
5	99104591	99104867	MACS_peak_16591	710.92	276	0	0	0	intergen
5	99153805	99154084	MACS_peak_16592	335.88	279	0	0	0	intergen
5	99254276	99254533	MACS_peak_16593	1589.91	257	0	0	0	intergen
5	99438683	99439042	MACS_peak_16594	3100	359	0	0	0	intergen
5	99526928	99527145	MACS_peak_16595	307.55	217	0	0	0	intergen
5	99691222	99691635	MACS_peak_16596	92.19	413	0	0	0	intergen
5	99860110	99860285	MACS_peak_16597	146.19	175	0	0	0	intergen
5	100014488	100014795	MACS_peak_16598	685.18	307	0	0	0	intergen
5	100387190	100387430	MACS_peak_16599	216.66	240	0	0	0	intergen
5	100423733	100423993	MACS_peak_16600	201.59	260	0	0	0	intergen
5	100430202	100430643	MACS_peak_16601	839.04	441	0	0	0	intergen
5	100479154	100479400	MACS_peak_16602	622.49	246	0	0	1	other
5	100493334	100493774	MACS_peak_16603	598.7	440	0	0	1	other
5	100497681	100498018	MACS_peak_16604	1484.34	337	0	0	1	other
5	100623733	100624029	MACS_peak_16605	566.68	296	0	0	0	intergen
5	101003394	101003647	MACS_peak_16606	343.81	253	0	0	0	intergen
5	101058900	101059205	MACS_peak_16607	89.06	305	0	0	0	intergen
5	101059229	101059498	MACS_peak_16608	84.4	269	0	0	0	intergen
5	101161681	101162005	MACS_peak_16609	423.97	324	0	0	0	intergen
5	101447134	101447588	MACS_peak_16611	92.97	454	0	0	0	intergen
5	101678720	101678980	MACS_peak_16612	862.05	260	0	0	0	intergen
5	101805337	101805469	MACS_peak_16613	1028.85	132	0	0	0	intergen
5	101890125	101890500	MACS_peak_16614	105.65	375	0	0	0	intergen
5	101942235	101942489	MACS_peak_16615	470.06	254	0	0	0	intergen
5	102001845	102002082	MACS_peak_16616	516.86	237	0	0	0	intergen
5	102111716	102112056	MACS_peak_16617	104.52	340	0	0	0	intergen
5	102194801	102195093	MACS_peak_16619	81.72	292	0	0	0	intergen
5	102206989	102207288	MACS_peak_16620	53.38	299	0	0	0	intergen
5	102223846	102224251	MACS_peak_16621	994.64	405	0	0	0	intergen
5	102354096	102354511	MACS_peak_16622	231.17	415	0	0	0	intergen
5	102634480	102634729	MACS_peak_16623	482.83	249	0	0	1	other
5	102675942	102676358	MACS_peak_16625	70.73	416	0	0	0	intergen
5	102685958	102686293	MACS_peak_16626	75.01	335	0	0	0	intergen
5	102758066	102758207	MACS_peak_16627	676.31	141	1	0	0	promoter
5	102816929	102817130	MACS_peak_16628	1348.41	201	0	1	0	gen
5	102907259	102907573	MACS_peak_16629	53.44	314	0	1	0	gen
5	103048621	103049082	MACS_peak_16630	103.6	461	0	0	0	intergen
5	103049611	103049833	MACS_peak_16631	287.98	222	0	0	0	intergen
5	103050847	103051082	MACS_peak_16632	81.05	235	0	0	0	intergen
5	103065889	103066026	MACS_peak_16633	914.41	137	0	0	0	intergen
5	103256305	103256499	MACS_peak_16634	678.9	194	1	0	0	promoter
5	103854051	103854185	MACS_peak_16635	1666.76	134	0	0	0	intergen
5	104237501	104237779	MACS_peak_16636	455.81	278	0	0	0	intergen
5	104519122	104519540	MACS_peak_16637	79.83	418	0	0	1	other
5	104656865	104657120	MACS_peak_16638	1320.51	255	0	0	1	other
5	104659929	104660234	MACS_peak_16639	1234.98	305	0	0	1	other
5	104718257	104718626	MACS_peak_16640	81.43	369	0	0	1	other
5	104718735	104719122	MACS_peak_16641	69.44	387	0	0	1	other
5	105445803	105446010	MACS_peak_16643	780.06	207	0	0	0	intergen
5	105589167	105589528	MACS_peak_16644	547.37	361	0	0	0	intergen
5	105599415	105599623	MACS_peak_16645	362.81	208	0	0	0	intergen
5	105771645	105771934	MACS_peak_16646	178.37	289	0	0	0	intergen
5	106361313	106361501	MACS_peak_16648	1079.97	188	0	0	0	intergen
5	106386321	106386563	MACS_peak_16649	645.81	242	0	0	0	intergen
5	106387597	106387875	MACS_peak_16650	709.17	278	0	0	0	intergen
5	106388937	106389261	MACS_peak_16651	532.07	324	0	0	0	intergen
5	106430253	106430534	MACS_peak_16652	125.94	281	0	0	0	intergen
5	106801312	106801571	MACS_peak_16654	540.64	259	0	0	0	intergen
5	107248043	107248364	MACS_peak_16656	549.92	321	0	0	0	intergen
5	107572078	107572319	MACS_peak_16657	501.16	241	0	1	0	gen
5	107591857	107592119	MACS_peak_16658	1236.43	262	0	1	0	gen
5	108681267	108681578	MACS_peak_16659	619.62	311	0	0	0	intergen
5	108920756	108921115	MACS_peak_16660	775.13	359	0	1	0	gen
5	109070745	109071046	MACS_peak_16661	876.84	301	0	1	0	gen
5	109103734	109104177	MACS_peak_16662	715.24	443	0	1	0	gen
5	109163086	109163262	MACS_peak_16663	763.02	176	0	1	0	gen
5	109602713	109602882	MACS_peak_16666	151.54	169	0	0	0	intergen
5	109844215	109844527	MACS_peak_16667	946.19	312	0	1	0	gen
5	110144196	110144529	MACS_peak_16668	422.11	333	0	0	0	intergen
5	110152639	110152780	MACS_peak_16669	1282.94	141	0	0	0	intergen
5	110236359	110236623	MACS_peak_16670	75.01	264	0	0	0	intergen
5	110252580	110252998	MACS_peak_16671	660.32	418	0	0	0	intergen
5	110279102	110279568	MACS_peak_16672	81.3	466	0	0	0	intergen
5	110281640	110281929	MACS_peak_16673	122.15	289	0	0	0	intergen
5	110282539	110282987	MACS_peak_16674	127.91	448	0	0	0	intergen
5	110414516	110414707	MACS_peak_16675	695.57	191	0	1	0	gen
5	110598313	110598682	MACS_peak_16676	84.21	369	0	1	0	gen
5	110777153	110777429	MACS_peak_16677	70.88	276	0	0	0	intergen
5	110937237	110937565	MACS_peak_16678	64.12	328	0	0	0	intergen
5	110939048	110939356	MACS_peak_16679	113.69	308	0	0	0	intergen
5	111063742	111064057	MACS_peak_16680	553.81	315	0	0	0	intergen
5	111461384	111461695	MACS_peak_16681	436.49	311	0	1	0	gen
5	111531770	111531974	MACS_peak_16682	486.85	204	0	0	1	other
5	111579252	111579612	MACS_peak_16683	68.83	360	0	0	1	other
5	111835353	111835627	MACS_peak_16684	458.32	274	0	1	0	gen
5	111882900	111883239	MACS_peak_16685	51	339	0	1	0	gen
5	111989335	111989772	MACS_peak_16686	58.14	437	0	1	1	gen
5	112146924	112147241	MACS_peak_16687	536.57	317	1	0	0	promoter
5	112324537	112324881	MACS_peak_16688	374.96	344	0	1	0	gen
5	112873088	112873220	MACS_peak_16689	977.06	132	1	1	0	promoter
5	112996106	112996309	MACS_peak_16690	989.9	203	0	1	0	gen
5	113295037	113295238	MACS_peak_16691	795.29	201	0	1	0	gen
5	113510846	113511192	MACS_peak_16692	418.18	346	1	0	0	promoter
5	113533437	113533782	MACS_peak_16693	405.47	345	0	1	0	gen
5	113711112	113711322	MACS_peak_16695	613.04	210	0	0	0	intergen
5	113932318	113932638	MACS_peak_16696	62.38	320	0	0	0	intergen
5	114160590	114160899	MACS_peak_16697	120.03	309	0	1	0	gen
5	114291952	114292179	MACS_peak_16698	130.15	227	0	1	0	gen
5	114358399	114358714	MACS_peak_16699	135.26	315	0	1	0	gen
5	114379367	114379844	MACS_peak_16700	1195.69	477	0	1	0	gen
5	114540350	114540588	MACS_peak_16701	514.01	238	0	0	1	other
5	114675471	114675894	MACS_peak_16702	54.47	423	0	0	0	intergen
5	115298007	115298395	MACS_peak_16703	180.31	388	0	0	0	intergen
5	115411727	115412073	MACS_peak_16704	72.05	346	0	0	0	intergen
5	115603783	115603916	MACS_peak_16705	1087.62	133	0	1	1	gen
5	115679139	115679572	MACS_peak_16706	106.71	433	0	0	0	intergen
5	115690984	115691305	MACS_peak_16707	93.4	321	0	0	0	intergen
5	115831231	115831526	MACS_peak_16708	694.81	295	1	0	0	promoter
5	115839080	115839347	MACS_peak_16709	718.95	267	1	1	0	promoter
5	115888122	115888358	MACS_peak_16710	516.86	236	0	1	0	gen
5	116068060	116068389	MACS_peak_16711	1102.85	329	0	0	0	intergen
5	116137845	116138246	MACS_peak_16712	868.4	401	0	1	0	gen
5	116425931	116426112	MACS_peak_16713	860.3	181	0	0	0	intergen
5	117018146	117018420	MACS_peak_16714	458.32	274	0	0	0	intergen
5	117114426	117114817	MACS_peak_16715	100.83	391	0	0	0	intergen
5	117158325	117158573	MACS_peak_16716	485.56	248	0	0	0	intergen
5	117529176	117529483	MACS_peak_16717	87.45	307	0	0	1	other
5	117543451	117543812	MACS_peak_16719	106.71	361	0	0	1	other
5	117607703	117607915	MACS_peak_16720	369.33	212	0	0	0	intergen
5	117799186	117799446	MACS_peak_16721	972.38	260	0	0	0	intergen
5	117930874	117931232	MACS_peak_16723	62.38	358	0	0	1	other
5	118062000	118062301	MACS_peak_16724	488.85	301	0	0	1	other
5	118385926	118386306	MACS_peak_16725	66.8	380	0	0	0	intergen
5	118543198	118543641	MACS_peak_16727	963.84	443	0	0	1	other
5	118543713	118544014	MACS_peak_16728	563.21	301	0	0	1	other
5	118941519	118941839	MACS_peak_16729	73.59	320	0	1	0	gen
5	118988097	118988578	MACS_peak_16730	432.62	481	0	0	0	intergen
5	119021983	119022176	MACS_peak_16731	647.86	193	0	0	1	other
5	119062947	119063310	MACS_peak_16732	407.35	363	0	1	1	gen
5	119298355	119298660	MACS_peak_16733	63.13	305	0	1	0	gen
5	119470924	119471165	MACS_peak_16734	797.18	241	0	1	0	gen
5	119550460	119550715	MACS_peak_16735	470.06	255	0	1	0	gen
5	119601349	119601611	MACS_peak_16736	69	262	0	1	0	gen
5	120310354	120310646	MACS_peak_16737	136.82	292	0	0	1	other
5	120311184	120311402	MACS_peak_16738	69.68	218	0	0	1	other
5	120409874	120410223	MACS_peak_16739	158.81	349	0	0	0	intergen
5	120753756	120754017	MACS_peak_16740	724.45	261	0	0	0	intergen
5	120754287	120754672	MACS_peak_16741	1012.06	385	0	0	0	intergen
5	121145839	121146141	MACS_peak_16742	562.53	302	0	0	0	intergen
5	121214771	121214990	MACS_peak_16743	174.78	219	0	0	1	other
5	121237155	121237429	MACS_peak_16744	69.75	274	0	0	1	other
5	121558114	121558443	MACS_peak_16745	78.9	329	0	0	0	intergen
5	121648392	121648624	MACS_peak_16746	124.31	232	0	0	0	intergen
5	121826810	121827013	MACS_peak_16747	629.38	203	0	0	0	intergen
5	121905254	121905560	MACS_peak_16748	845.32	306	0	0	0	intergen
5	121951371	121951636	MACS_peak_16749	75.5	265	0	0	0	intergen
5	122210026	122210330	MACS_peak_16750	76.3	304	0	0	0	intergen
5	122498281	122498529	MACS_peak_16751	901.33	248	0	0	0	intergen
5	122514821	122515262	MACS_peak_16752	83.54	441	0	0	0	intergen
5	122516107	122516555	MACS_peak_16753	134.58	448	0	0	0	intergen
5	122595839	122596199	MACS_peak_16754	89.02	360	0	0	0	intergen
5	122633424	122633769	MACS_peak_16755	54.77	345	0	0	1	other
5	122704203	122704592	MACS_peak_16756	510.37	389	0	0	1	other
5	122914451	122914670	MACS_peak_16757	219.2	219	0	1	0	gen
5	123279212	123279417	MACS_peak_16758	629.38	205	0	0	0	intergen
5	123545654	123545876	MACS_peak_16759	712.32	222	0	1	0	gen
5	123611130	123611593	MACS_peak_16760	1777.03	463	0	1	0	gen
5	123671028	123671218	MACS_peak_16761	1017.77	190	0	0	0	intergen
5	124427370	124427661	MACS_peak_16762	127.5	291	0	0	0	intergen
5	124525564	124525996	MACS_peak_16763	75.01	432	0	0	1	other
5	124735869	124736152	MACS_peak_16764	452.74	283	0	1	0	gen
5	124758069	124758216	MACS_peak_16765	855.7	147	0	0	0	intergen
5	125016532	125016693	MACS_peak_16767	785.04	161	0	0	1	other
5	125152176	125152406	MACS_peak_16769	535.45	230	0	0	1	other
5	125362241	125362642	MACS_peak_16770	71.73	401	0	0	1	other
5	125508342	125508618	MACS_peak_16771	603.02	276	0	0	1	other
5	125617608	125617801	MACS_peak_16774	117.59	193	0	0	0	intergen
5	125762887	125763199	MACS_peak_16775	406.81	312	0	0	0	intergen
5	125843163	125843581	MACS_peak_16776	603.62	418	0	0	0	intergen
5	125907500	125907705	MACS_peak_16777	629.38	205	0	0	0	intergen
5	126234648	126234967	MACS_peak_16780	312.33	319	0	0	1	other
5	126463672	126463886	MACS_peak_16781	371.18	214	0	1	1	gen
5	126630625	126630846	MACS_peak_16782	564.54	221	1	0	0	promoter
5	126656383	126656707	MACS_peak_16783	547.99	324	0	0	0	intergen
5	126739462	126739879	MACS_peak_16784	832.49	417	0	0	0	intergen
5	127267988	127268291	MACS_peak_16785	62.38	303	0	0	0	intergen
5	127492969	127493270	MACS_peak_16786	563.21	301	0	0	0	intergen
5	127573030	127573260	MACS_peak_16787	532.66	230	0	0	0	intergen
5	127751016	127751273	MACS_peak_16788	71.49	257	0	1	0	gen
5	127774083	127774256	MACS_peak_16789	989.9	173	0	1	0	gen
5	127881695	127881947	MACS_peak_16790	264.57	252	0	1	0	gen
5	127909168	127909408	MACS_peak_16791	797.18	240	0	1	0	gen
5	128269627	128269911	MACS_peak_16792	462.87	284	0	1	0	gen
5	128905530	128905853	MACS_peak_16793	429.98	323	0	1	0	gen
5	128940806	128941175	MACS_peak_16794	110.32	369	0	1	0	gen
5	128957618	128957876	MACS_peak_16795	188.27	258	0	1	0	gen
5	129053466	129053874	MACS_peak_16796	737.78	408	0	0	0	intergen
5	129125504	129125864	MACS_peak_16797	526.28	360	0	0	0	intergen
5	129172619	129172836	MACS_peak_16798	746.04	217	0	0	0	intergen
5	129541738	129541947	MACS_peak_16800	566.01	209	0	1	1	gen
5	129578056	129578436	MACS_peak_16801	279.24	380	0	1	1	gen
5	129594835	129595113	MACS_peak_16802	455.81	278	0	1	1	gen
5	129675057	129675308	MACS_peak_16803	471.88	251	0	1	1	gen
5	129767899	129768162	MACS_peak_16804	465.4	263	0	0	1	other
5	129771376	129771626	MACS_peak_16805	613.04	250	0	0	1	other
5	129897053	129897400	MACS_peak_16806	160.72	347	0	0	1	other
5	130720417	130720689	MACS_peak_16807	584.2	272	0	0	0	intergen
5	130786379	130786655	MACS_peak_16808	149.19	276	0	0	0	intergen
5	131089288	131089568	MACS_peak_16809	63.65	280	0	0	0	intergen
5	131110072	131110257	MACS_peak_16810	675.42	185	0	0	0	intergen
5	131381314	131381637	MACS_peak_16811	312.33	323	0	1	0	gen
5	131515955	131516170	MACS_peak_16812	630.08	215	0	2	0	gen
5	131589578	131589874	MACS_peak_16813	445	296	0	2	0	gen
5	131732334	131732574	MACS_peak_16814	198.25	240	0	2	0	gen
5	131734761	131735222	MACS_peak_16815	55.51	461	0	2	0	gen
5	131778363	131778710	MACS_peak_16816	94.4	347	0	2	0	gen
5	131873168	131873529	MACS_peak_16817	178.48	361	0	2	0	gen
5	131876373	131876600	MACS_peak_16818	140.98	227	0	2	0	gen
5	131893962	131894262	MACS_peak_16819	76.3	300	0	2	0	gen
5	132063477	132063744	MACS_peak_16820	588.05	267	1	0	0	promoter
5	132064677	132064898	MACS_peak_16821	729.14	221	1	0	0	promoter
5	132283464	132283726	MACS_peak_16823	466.05	262	0	1	0	gen
5	132982491	132982791	MACS_peak_16824	178.37	300	0	0	0	intergen
5	133025364	133025721	MACS_peak_16825	265.34	357	0	1	0	gen
5	133105993	133106245	MACS_peak_16826	460.18	252	0	1	0	gen
5	133135912	133136297	MACS_peak_16827	70.09	385	0	0	0	intergen
5	133583578	133583857	MACS_peak_16828	107.73	279	0	1	0	gen
5	133625986	133626365	MACS_peak_16829	428.64	379	0	0	0	intergen
5	133754557	133754817	MACS_peak_16830	467.38	260	0	0	0	intergen
5	133869124	133869504	MACS_peak_16831	1430.43	380	0	0	0	intergen
5	133944300	133944631	MACS_peak_16832	490.28	331	0	0	0	intergen
5	134026637	134026880	MACS_peak_16833	346.41	243	0	0	0	intergen
5	134039580	134039863	MACS_peak_16834	704.85	283	0	0	0	intergen
5	134083169	134083312	MACS_peak_16835	2430.3	143	0	0	0	intergen
5	134184082	134184478	MACS_peak_16836	488.85	396	0	1	0	gen
5	134321002	134321134	MACS_peak_16837	1028.85	132	0	1	1	gen
5	134480548	134480823	MACS_peak_16838	265.34	275	0	0	1	other
5	135191425	135191611	MACS_peak_16839	676.7	186	0	0	1	other
5	135553961	135554165	MACS_peak_16840	616.96	204	0	0	0	intergen
5	135566292	135566506	MACS_peak_16841	918.92	214	1	0	1	promoter
5	135830185	135830404	MACS_peak_16842	729.14	219	0	1	0	gen
5	136174210	136174408	MACS_peak_16843	662.31	198	0	1	0	gen
5	136249658	136249975	MACS_peak_16844	677.44	317	0	1	0	gen
5	136287686	136287820	MACS_peak_16845	583.66	134	0	1	0	gen
5	136686401	136686686	MACS_peak_16846	574.52	285	0	0	0	intergen
5	136770165	136770470	MACS_peak_16847	722.05	305	0	0	0	intergen
5	136781540	136781759	MACS_peak_16848	192.85	219	0	0	0	intergen
5	136824065	136824270	MACS_peak_16849	133.61	205	0	0	0	intergen
5	137075248	137075433	MACS_peak_16850	827.31	185	0	1	0	gen
5	137160463	137160762	MACS_peak_16851	587.13	299	0	1	0	gen
5	137434326	137434521	MACS_peak_16852	485.3	195	0	1	0	gen
5	137499304	137499648	MACS_peak_16853	394.13	344	0	1	0	gen
5	137629653	137629830	MACS_peak_16854	972.07	177	0	1	0	gen
5	137751993	137752134	MACS_peak_16855	1282.94	141	0	1	0	gen
5	137778884	137779315	MACS_peak_16856	1103.83	431	0	0	0	intergen
5	137969554	137969966	MACS_peak_16857	138.18	412	0	1	0	gen
5	138036097	138036270	MACS_peak_16858	780.06	173	0	1	1	gen
5	138195435	138195739	MACS_peak_16859	561.16	304	0	1	0	gen
5	138352355	138352710	MACS_peak_16860	650.16	355	1	0	0	promoter
5	138411122	138411447	MACS_peak_16861	1065.38	325	0	1	0	gen
5	138450038	138450221	MACS_peak_16862	918.92	183	0	0	0	intergen
5	138464014	138464374	MACS_peak_16863	526.28	360	1	0	0	promoter
5	138645128	138645493	MACS_peak_16864	409.04	365	0	1	0	gen
5	138671430	138671637	MACS_peak_16865	1098.53	207	0	1	0	gen
5	138682599	138682863	MACS_peak_16866	58.19	264	0	1	0	gen
5	138922968	138923286	MACS_peak_16867	806.35	318	0	1	0	gen
5	139262745	139262944	MACS_peak_16868	810.9	199	0	1	0	gen
5	139422397	139422714	MACS_peak_16869	544.99	317	0	1	0	gen
5	139517957	139518124	MACS_peak_16870	768.86	167	0	0	0	intergen
5	139548085	139548290	MACS_peak_16871	481.25	205	0	1	0	gen
5	139582556	139582755	MACS_peak_16872	740.33	199	0	1	0	gen
5	139610437	139610759	MACS_peak_16873	424.26	322	0	1	0	gen
5	139765426	139765668	MACS_peak_16874	501.16	242	0	0	0	intergen
5	139775159	139775452	MACS_peak_16875	568.79	293	0	0	0	intergen
5	139787489	139787711	MACS_peak_16876	564.54	222	0	0	0	intergen
5	139844492	139844688	MACS_peak_16877	662.31	196	1	0	0	promoter
5	140073238	140073526	MACS_peak_16878	572.35	288	0	0	1	other
5	140357728	140357963	MACS_peak_16879	516.86	235	1	0	0	promoter
5	140997231	140997444	MACS_peak_16881	596.79	213	0	15	0	gen
5	141041321	141041573	MACS_peak_16882	470.06	252	0	0	0	intergen
5	141100126	141100436	MACS_peak_16883	437.04	310	1	0	0	promoter
5	141198901	141199112	MACS_peak_16884	596.79	211	1	0	2	promoter
5	141326006	141326367	MACS_peak_16885	397.74	361	1	0	0	promoter
5	141330328	141330501	MACS_peak_16886	723.41	173	1	0	0	promoter
5	141349805	141350117	MACS_peak_16887	555.79	312	1	3	0	promoter
5	141512414	141512631	MACS_peak_16888	746.04	217	1	22	0	promoter
5	141524798	141525031	MACS_peak_16889	532.66	233	0	1	0	gen
5	141560994	141561238	MACS_peak_16890	501.16	244	0	1	1	gen
5	141564155	141564511	MACS_peak_16891	1605.51	356	0	1	1	gen
5	142151885	142152147	MACS_peak_16893	859.93	262	0	1	0	gen
5	142276278	142276574	MACS_peak_16894	826.15	296	0	0	0	intergen
5	142351705	142352049	MACS_peak_16895	915.87	344	0	0	1	other
5	142866972	142867352	MACS_peak_16896	402.16	380	0	1	1	gen
5	142880516	142880766	MACS_peak_16897	613.04	250	0	1	0	gen
5	142965385	142965681	MACS_peak_16898	1198.74	296	0	1	0	gen
5	143003040	143003341	MACS_peak_16899	442.11	301	0	1	0	gen
5	143016926	143017082	MACS_peak_16900	712.61	156	0	1	0	gen
5	143444597	143445074	MACS_peak_16901	1195.69	477	0	0	0	intergen
5	143968120	143968414	MACS_peak_16902	380.3	294	0	0	0	intergen
5	144299273	144299616	MACS_peak_16903	419.68	343	0	1	0	gen
5	144509398	144509835	MACS_peak_16905	101.64	437	0	0	0	intergen
5	144825171	144825597	MACS_peak_16906	148.8	426	0	0	0	intergen
5	144891175	144891501	MACS_peak_16907	51.4	326	0	0	0	intergen
5	145101223	145101532	MACS_peak_16908	393.18	309	0	0	0	intergen
5	145126840	145127104	MACS_peak_16909	574.38	264	0	0	0	intergen
5	145347048	145347400	MACS_peak_16910	652.21	352	0	0	1	other
5	145362977	145363136	MACS_peak_16911	866.35	159	0	0	1	other
5	145416066	145416275	MACS_peak_16913	79.26	209	0	0	0	intergen
5	145626996	145627225	MACS_peak_16915	436.6	229	0	1	0	gen
5	145741108	145741544	MACS_peak_16916	1232.74	436	0	1	0	gen
5	145742116	145742369	MACS_peak_16917	456.71	253	0	1	0	gen
5	145825693	145825994	MACS_peak_16918	563.21	301	0	1	0	gen
5	145894012	145894366	MACS_peak_16919	80.13	354	0	1	0	gen
5	145894974	145895295	MACS_peak_16920	137.34	321	0	1	0	gen
5	145903206	145903404	MACS_peak_16921	808.21	198	0	1	0	gen
5	146130554	146130787	MACS_peak_16922	538.37	233	0	1	0	gen
5	146622526	146622738	MACS_peak_16924	596.79	212	0	1	0	gen
5	146898426	146898818	MACS_peak_16925	75.06	392	0	1	0	gen
5	147011486	147011808	MACS_peak_16926	123.82	322	0	1	0	gen
5	147369777	147370089	MACS_peak_16927	555.79	312	0	1	0	gen
5	147857564	147857808	MACS_peak_16928	629.38	244	0	0	0	intergen
5	147887091	147887304	MACS_peak_16929	763.02	213	0	1	0	gen
5	147927998	147928217	MACS_peak_16930	443.84	219	0	0	0	intergen
5	148023017	148023391	MACS_peak_16931	61.51	374	1	0	0	promoter
5	148121142	148121284	MACS_peak_16932	1007.8	142	0	1	0	gen
5	148179320	148179607	MACS_peak_16933	519.51	287	0	0	0	intergen
5	148210241	148210571	MACS_peak_16934	544.21	330	0	1	0	gen
5	148212398	148212759	MACS_peak_16935	900.92	361	0	1	0	gen
5	148360671	148361107	MACS_peak_16936	63.13	436	0	0	1	other
5	148615272	148615545	MACS_peak_16937	56.27	273	0	1	0	gen
5	148671365	148671671	MACS_peak_16938	91.91	306	0	1	0	gen
5	148680837	148681203	MACS_peak_16939	408.57	366	0	0	0	intergen
5	148687617	148687967	MACS_peak_16940	416.22	350	0	0	0	intergen
5	148730995	148731317	MACS_peak_16941	673.67	322	0	0	0	intergen
5	148741361	148741561	MACS_peak_16942	645.81	200	0	0	0	intergen
5	148944150	148944537	MACS_peak_16943	72.39	387	0	1	0	gen
5	149035386	149035747	MACS_peak_16944	900.92	361	0	1	0	gen
5	149114795	149115089	MACS_peak_16945	568.08	294	0	0	0	intergen
5	149269044	149269348	MACS_peak_16946	440.4	304	1	0	2	promoter
5	149317250	149317480	MACS_peak_16947	532.66	230	0	1	0	gen
5	149669277	149669614	MACS_peak_16949	145.82	337	0	0	0	intergen
5	149829953	149830271	MACS_peak_16950	229.83	318	0	1	0	gen
5	149853103	149853330	MACS_peak_16951	1007.8	227	1	1	0	promoter
5	149990777	149991091	MACS_peak_16952	809.85	314	1	1	0	promoter
5	150484246	150484381	MACS_peak_16953	944.23	135	1	0	1	promoter
5	150561089	150561292	MACS_peak_16954	629.38	203	0	0	0	intergen
5	150737303	150737493	MACS_peak_16955	568.54	190	0	1	0	gen
5	150747507	150747988	MACS_peak_16956	72.76	481	0	1	0	gen
5	150801012	150801359	MACS_peak_16957	913.18	347	0	0	0	intergen
5	150859521	150859862	MACS_peak_16958	56.38	341	0	1	0	gen
5	150924828	150925007	MACS_peak_16959	722.11	179	0	0	0	intergen
5	150967564	150967911	MACS_peak_16960	86.09	347	0	0	0	intergen
5	150968153	150968465	MACS_peak_16961	50.75	312	0	0	0	intergen
5	151115460	151115657	MACS_peak_16962	662.31	197	0	1	0	gen
5	151164813	151165147	MACS_peak_16963	792.81	334	0	0	0	intergen
5	151384663	151385060	MACS_peak_16965	623.31	397	0	0	1	other
5	151391522	151391829	MACS_peak_16966	83.36	307	0	0	1	other
5	151406440	151406662	MACS_peak_16967	564.54	222	0	0	1	other
5	151740628	151740913	MACS_peak_16968	451.52	285	1	0	0	promoter
5	151775978	151776173	MACS_peak_16969	662.31	195	0	0	0	intergen
5	151825290	151825755	MACS_peak_16970	585.52	465	1	0	0	promoter
5	152142909	152143267	MACS_peak_16971	412.35	358	0	0	1	other
5	152309291	152309659	MACS_peak_16973	69	368	0	0	0	intergen
5	152407725	152407986	MACS_peak_16974	592.77	261	0	1	0	gen
5	152531374	152531561	MACS_peak_16975	614.29	187	0	0	0	intergen
5	152697926	152698344	MACS_peak_16977	432.99	418	0	0	1	other
5	152939890	152940253	MACS_peak_16978	60.41	363	0	0	1	other
5	153075563	153075902	MACS_peak_16979	64.5	339	0	0	1	other
5	153228369	153228618	MACS_peak_16981	126.83	249	0	0	0	intergen
5	153292052	153292357	MACS_peak_16982	54.69	305	0	0	0	intergen
5	153304088	153304525	MACS_peak_16983	81.3	437	0	0	0	intergen
5	153383899	153384185	MACS_peak_16984	109.61	286	0	0	0	intergen
5	153385010	153385426	MACS_peak_16985	94.06	416	0	0	0	intergen
5	153726942	153727311	MACS_peak_16986	100.31	369	0	1	0	gen
5	153838192	153838469	MACS_peak_16987	439.97	277	0	0	0	intergen
5	153974421	153974683	MACS_peak_16988	528.22	262	0	0	0	intergen
5	154180221	154180418	MACS_peak_16989	831.63	197	0	1	0	gen
5	154583292	154583636	MACS_peak_16990	312.33	344	0	0	0	intergen
5	154640293	154640584	MACS_peak_16991	447.93	291	0	0	0	intergen
5	154642537	154642767	MACS_peak_16992	831.63	230	0	0	0	intergen
5	154650230	154650682	MACS_peak_16993	988.19	452	0	0	0	intergen
5	154795852	154796206	MACS_peak_16994	776.79	354	0	1	0	gen
5	154935769	154936063	MACS_peak_16995	265.34	294	0	1	0	gen
5	154945776	154945951	MACS_peak_16996	972.07	175	1	0	0	promoter
5	154953354	154953492	MACS_peak_16997	1148.16	138	0	1	0	gen
5	154967497	154967760	MACS_peak_16998	722.6	263	0	1	0	gen
5	154972562	154972903	MACS_peak_16999	521.55	341	0	0	0	intergen
5	155035790	155036123	MACS_peak_17001	380.3	333	0	0	0	intergen
5	155124211	155124632	MACS_peak_17002	163.28	421	0	0	0	intergen
5	155139679	155139914	MACS_peak_17003	662.31	235	0	0	0	intergen
5	155499889	155500149	MACS_peak_17005	593.56	260	0	0	0	intergen
5	155616879	155617097	MACS_peak_17006	580.62	218	0	0	0	intergen
5	156413856	156414132	MACS_peak_17008	457.06	276	0	1	0	gen
5	156423153	156423511	MACS_peak_17009	1602.8	358	0	1	0	gen
5	156605353	156605736	MACS_peak_17010	71.09	383	0	1	0	gen
5	156606044	156606413	MACS_peak_17011	55.92	369	0	1	0	gen
5	156608784	156609150	MACS_peak_17012	52.99	366	0	1	0	gen
5	156664897	156665087	MACS_peak_17014	332.64	190	0	1	0	gen
5	156857005	156857150	MACS_peak_17015	658.5	145	0	0	0	intergen
5	157024132	157024499	MACS_peak_17016	437.98	367	0	0	0	intergen
5	157085373	157085711	MACS_peak_17017	141.66	338	1	0	0	promoter
5	157096045	157096366	MACS_peak_17018	312.33	321	0	1	0	gen
5	157253465	157253838	MACS_peak_17019	933.84	373	0	1	0	gen
5	157477041	157477205	MACS_peak_17020	972.46	164	0	1	0	gen
5	157816728	157817032	MACS_peak_17021	561.16	304	0	1	0	gen
5	157829086	157829422	MACS_peak_17022	384.23	336	0	1	0	gen
5	157917996	157918386	MACS_peak_17023	488.85	390	0	0	0	intergen
5	158229361	158229841	MACS_peak_17024	87.75	480	0	0	1	other
5	158408171	158408527	MACS_peak_17025	93.4	356	0	0	1	other
5	158441840	158442194	MACS_peak_17026	62.38	354	0	0	1	other
5	158756953	158757198	MACS_peak_17027	629.38	245	0	1	0	gen
5	159501876	159502228	MACS_peak_17028	101.68	352	0	0	2	other
5	159685295	159685621	MACS_peak_17029	58.69	326	0	0	1	other
5	159881176	159881427	MACS_peak_17030	810.91	251	0	1	1	gen
5	160021899	160022247	MACS_peak_17031	888.36	348	0	1	0	gen
5	160080882	160081263	MACS_peak_17032	406.81	381	0	1	0	gen
5	160438363	160438643	MACS_peak_17033	578.19	280	0	0	0	intergen
5	160597311	160597729	MACS_peak_17034	126.91	418	0	1	0	gen
5	160653557	160653936	MACS_peak_17036	402.61	379	0	1	0	gen
5	160663063	160663429	MACS_peak_17037	63.35	366	0	1	0	gen
5	160682839	160683165	MACS_peak_17038	312.33	326	0	1	0	gen
5	160686309	160686558	MACS_peak_17039	461.57	249	0	1	1	gen
5	160816931	160817162	MACS_peak_17040	125.57	231	0	1	0	gen
5	160944100	160944445	MACS_peak_17041	118.46	345	0	0	0	intergen
5	161553496	161553730	MACS_peak_17042	145.78	234	0	1	0	gen
5	161608932	161609139	MACS_peak_17043	126.29	207	0	1	0	gen
5	161676262	161676470	MACS_peak_17044	613.04	208	0	1	0	gen
5	161885728	161886019	MACS_peak_17045	447.93	291	0	1	0	gen
5	162035499	162035854	MACS_peak_17046	57.82	355	0	1	0	gen
5	162553195	162553596	MACS_peak_17047	69.58	401	0	0	1	other
5	162579451	162579716	MACS_peak_17048	71.58	265	0	0	1	other
5	162694477	162694888	MACS_peak_17049	160.03	411	0	0	1	other
5	162712778	162712977	MACS_peak_17050	113.93	199	0	0	1	other
5	162746736	162747002	MACS_peak_17051	588.83	266	0	0	1	other
5	162850211	162850556	MACS_peak_17052	122.85	345	0	0	1	other
5	162856337	162856679	MACS_peak_17053	56.38	342	0	0	1	other
5	163079621	163079977	MACS_peak_17054	393.68	356	0	0	1	other
5	163347671	163347911	MACS_peak_17055	516.86	240	0	0	1	other
5	163348732	163348929	MACS_peak_17056	721.03	197	0	0	1	other
5	163429244	163429694	MACS_peak_17057	574.93	450	0	0	1	other
5	163456483	163456703	MACS_peak_17058	564.54	220	1	1	0	promoter
5	163779775	163779997	MACS_peak_17059	85.48	222	0	0	0	intergen
5	164056473	164056729	MACS_peak_17060	729.14	256	0	0	0	intergen
5	164328690	164328955	MACS_peak_17061	419.41	265	0	0	1	other
5	164329380	164329765	MACS_peak_17062	512.49	385	0	0	1	other
5	164504241	164504452	MACS_peak_17064	757.07	211	0	0	1	other
5	164881038	164881170	MACS_peak_17065	1116.4	132	0	0	1	other
5	165044792	165045175	MACS_peak_17066	69	383	0	0	1	other
5	165159437	165159708	MACS_peak_17067	715.34	271	0	0	1	other
5	165209190	165209546	MACS_peak_17068	834.03	356	0	0	0	intergen
5	165331177	165331365	MACS_peak_17069	1034.21	188	0	0	0	intergen
5	165578436	165578737	MACS_peak_17070	821.52	301	0	0	1	other
5	165738507	165738783	MACS_peak_17071	457.06	276	0	0	1	other
5	165873019	165873305	MACS_peak_17072	702.3	286	0	0	0	intergen
5	165916602	165916948	MACS_peak_17073	238.69	346	0	0	0	intergen
5	166547369	166547722	MACS_peak_17074	63.76	353	0	0	0	intergen
5	166916686	166917005	MACS_peak_17075	265.34	319	0	0	1	other
5	167049140	167049377	MACS_peak_17076	516.86	237	0	0	0	intergen
5	167516233	167516515	MACS_peak_17077	977.65	282	0	1	0	gen
5	168078501	168078781	MACS_peak_17078	73.29	280	0	1	0	gen
5	168219883	168220064	MACS_peak_17079	1134.69	181	0	1	0	gen
5	168679551	168679874	MACS_peak_17080	429.98	323	0	1	0	gen
5	168706603	168706862	MACS_peak_17081	726.32	259	0	1	1	gen
5	169581693	169581956	MACS_peak_17082	452.06	263	1	0	0	promoter
5	169821286	169821564	MACS_peak_17083	113.31	278	0	1	0	gen
5	169824056	169824386	MACS_peak_17084	63.46	330	0	1	0	gen
5	170216320	170216678	MACS_peak_17085	1373.81	358	0	0	0	intergen
5	170225815	170226136	MACS_peak_17086	674.42	321	0	0	0	intergen
5	170245093	170245393	MACS_peak_17087	92.64	300	1	1	0	promoter
5	170267913	170268129	MACS_peak_17088	580.62	216	0	1	0	gen
5	170420900	170421163	MACS_peak_17089	722.6	263	0	1	1	gen
5	170623428	170623869	MACS_peak_17090	568.35	441	0	1	0	gen
5	170633091	170633427	MACS_peak_17091	540.49	336	0	1	0	gen
5	170933761	170934064	MACS_peak_17092	129.7	303	0	1	0	gen
5	171058735	171059008	MACS_peak_17093	107.9	273	0	1	0	gen
5	171124731	171125152	MACS_peak_17094	953.02	421	0	1	0	gen
5	171169916	171170218	MACS_peak_17095	956.32	302	0	1	0	gen
5	171630166	171630360	MACS_peak_17096	678.9	194	0	0	0	intergen
5	171912167	171912555	MACS_peak_17097	628.81	388	0	1	0	gen
5	171956095	171956364	MACS_peak_17098	461.5	269	0	1	0	gen
5	172002372	172002715	MACS_peak_17099	380.3	343	0	1	0	gen
5	172106841	172107158	MACS_peak_17100	1220.3	317	0	1	0	gen
5	172188683	172189112	MACS_peak_17101	604.75	429	0	0	0	intergen
5	172207814	172208067	MACS_peak_17102	596.79	253	1	0	0	promoter
5	172451264	172451508	MACS_peak_17103	629.38	244	0	1	0	gen
5	172462283	172462433	MACS_peak_17104	2225.97	150	0	0	0	intergen
5	172478957	172479231	MACS_peak_17105	458.32	274	0	0	0	intergen
5	172854218	172854399	MACS_peak_17106	746.04	181	0	1	0	gen
5	172939104	172939339	MACS_peak_17107	662.31	235	0	1	0	gen
5	172978798	172979029	MACS_peak_17108	527.71	231	1	0	0	promoter
5	173204299	173204509	MACS_peak_17109	780.06	210	0	0	0	intergen
5	173293992	173294291	MACS_peak_17110	443.26	299	0	0	0	intergen
5	173332066	173332443	MACS_peak_17111	516.8	377	0	0	0	intergen
5	174018875	174019283	MACS_peak_17112	58.84	408	0	0	0	intergen
5	174037119	174037342	MACS_peak_17113	1377.21	223	0	0	0	intergen
5	174045467	174045655	MACS_peak_17114	647	188	1	0	0	promoter
5	174311959	174312239	MACS_peak_17115	454.58	280	0	0	0	intergen
5	174327264	174327635	MACS_peak_17116	1460.36	371	0	0	0	intergen
5	174402131	174402456	MACS_peak_17117	380.3	325	0	0	1	other
5	174581509	174581865	MACS_peak_17118	528.58	356	0	0	0	intergen
5	175424438	175424703	MACS_peak_17119	1236.43	265	0	0	0	intergen
5	175669218	175669376	MACS_peak_17120	977.06	158	0	1	0	gen
5	175718945	175719163	MACS_peak_17121	273.71	218	0	0	0	intergen
5	175720011	175720356	MACS_peak_17122	66.55	345	0	0	0	intergen
5	175904700	175904889	MACS_peak_17123	1459.07	189	0	0	0	intergen
5	175951636	175951898	MACS_peak_17124	723.53	262	0	1	1	gen
5	176119503	176119807	MACS_peak_17125	201.59	304	0	1	0	gen
5	176279359	176279668	MACS_peak_17126	51.71	309	0	1	0	gen
5	176285375	176285827	MACS_peak_17127	71.18	452	0	1	0	gen
5	176327445	176327646	MACS_peak_17128	588.69	201	0	1	0	gen
5	176434516	176434892	MACS_peak_17129	93.4	376	0	0	0	intergen
5	176448109	176448342	MACS_peak_17130	416.25	233	1	0	0	promoter
5	176513086	176513495	MACS_peak_17131	370.61	409	0	0	0	intergen
5	176658124	176658322	MACS_peak_17132	831.63	198	0	1	0	gen
5	176812890	176813155	MACS_peak_17133	589.61	265	1	0	0	promoter
5	177071813	177072111	MACS_peak_17134	613.66	298	0	1	0	gen
5	177113955	177114160	MACS_peak_17135	1418.09	205	0	0	0	intergen
5	177185660	177186105	MACS_peak_17136	1091.75	445	0	1	0	gen
5	177309704	177309985	MACS_peak_17137	453.96	281	0	1	0	gen
5	177455418	177455800	MACS_peak_17138	401.26	382	1	1	0	promoter
5	177456386	177456629	MACS_peak_17139	936.57	243	1	0	0	promoter
5	177757644	177757933	MACS_peak_17140	56.85	289	0	1	0	gen
5	177758384	177758722	MACS_peak_17141	67.46	338	0	1	0	gen
5	177891848	177892100	MACS_peak_17142	1339.36	252	0	0	1	other
5	177934321	177934509	MACS_peak_17143	883.81	188	0	0	1	other
5	178062077	178062328	MACS_peak_17144	746.04	251	0	0	0	intergen
5	178075972	178076349	MACS_peak_17145	403.51	377	0	0	0	intergen
5	178130278	178130561	MACS_peak_17146	474.02	283	1	0	0	promoter
5	178551137	178551376	MACS_peak_17147	628.77	239	0	1	0	gen
5	179106627	179107044	MACS_peak_17148	144.59	417	1	0	0	promoter
5	179634446	179634695	MACS_peak_17149	547.91	249	0	1	0	gen
5	179657850	179658099	MACS_peak_17150	588.38	249	0	0	1	other
5	179763153	179763517	MACS_peak_17151	1594.76	364	0	1	0	gen
5	179993717	179994011	MACS_peak_17152	67.82	294	0	1	0	gen
5	180315791	180316015	MACS_peak_17153	839.47	224	0	1	0	gen
5	180372539	180372902	MACS_peak_17154	127.5	363	0	0	0	intergen
5	180471009	180471272	MACS_peak_17155	465.4	263	0	0	0	intergen
5	180539476	180539859	MACS_peak_17156	93.4	383	0	1	0	gen
5	180670627	180670809	MACS_peak_17157	729.14	182	0	0	0	intergen
5	180896638	180896973	MACS_peak_17158	180.31	335	1	0	0	promoter
5	181091222	181091647	MACS_peak_17161	217.12	425	0	0	0	intergen
5	181176137	181176283	MACS_peak_17162	1334.07	146	0	0	0	intergen
5	181319914	181320151	MACS_peak_17164	821.39	237	0	0	1	other
5	181323321	181323558	MACS_peak_17165	463.28	237	0	0	1	other
5	181324441	181324802	MACS_peak_17166	457.2	361	0	0	0	intergen
5	181369037	181369437	MACS_peak_17167	412.5	400	1	0	0	promoter
5	181383027	181383372	MACS_peak_17168	163.66	345	0	0	0	intergen
5	181388460	181388723	MACS_peak_17169	276.32	263	0	0	0	intergen
5	181416089	181416374	MACS_peak_17170	1112.81	285	0	0	0	intergen
5	181462769	181463175	MACS_peak_17174	1207.95	406	0	0	0	intergen
6	86122	86385	MACS_peak_17175	221.9	263	0	0	0	intergen
6	188743	189073	MACS_peak_17180	426.3	330	0	0	1	other
6	460676	460948	MACS_peak_17181	488.85	272	0	0	0	intergen
6	482770	483106	MACS_peak_17182	113.69	336	1	0	0	promoter
6	494938	495141	MACS_peak_17183	540.33	203	0	1	0	gen
6	605782	606012	MACS_peak_17185	189.46	230	0	1	0	gen
6	617510	617727	MACS_peak_17186	580.62	217	0	1	0	gen
6	624902	625195	MACS_peak_17187	696.46	293	0	1	0	gen
6	797580	797786	MACS_peak_17188	629.38	206	0	0	0	intergen
6	1205421	1205804	MACS_peak_17191	402.59	383	0	0	0	intergen
6	1336350	1336652	MACS_peak_17192	546.57	302	0	0	0	intergen
6	1397699	1397831	MACS_peak_17193	1116.4	132	0	0	0	intergen
6	1652357	1652664	MACS_peak_17194	458.99	307	0	1	0	gen
6	1730783	1731102	MACS_peak_17195	432.12	319	0	1	0	gen
6	1793036	1793241	MACS_peak_17196	797.18	205	0	1	0	gen
6	1813229	1813389	MACS_peak_17197	1011.74	160	0	1	0	gen
6	1928207	1928385	MACS_peak_17198	763.02	178	0	1	0	gen
6	2196105	2196315	MACS_peak_17200	613.04	210	0	1	0	gen
6	2209242	2209524	MACS_peak_17201	576.71	282	0	1	0	gen
6	2284262	2284527	MACS_peak_17202	589.61	265	0	0	1	other
6	2353897	2354222	MACS_peak_17203	671.43	325	0	0	1	other
6	2423171	2423541	MACS_peak_17205	50.82	370	0	0	1	other
6	2738457	2738722	MACS_peak_17206	932.22	265	0	1	0	gen
6	2952621	2952979	MACS_peak_17207	648.14	358	1	0	0	promoter
6	2998346	2998765	MACS_peak_17208	534.92	419	0	1	1	gen
6	3055878	3056302	MACS_peak_17209	1019.87	424	0	0	1	other
6	3851681	3852024	MACS_peak_17210	419.68	343	1	0	2	promoter
6	3863989	3864385	MACS_peak_17211	87.62	396	0	0	1	other
6	4210776	4211090	MACS_peak_17212	434.84	314	0	0	0	intergen
6	4469415	4469807	MACS_peak_17214	52.99	392	0	0	1	other
6	4832129	4832604	MACS_peak_17215	81.28	475	0	1	0	gen
6	4864079	4864465	MACS_peak_17216	603.02	386	0	1	0	gen
6	5143725	5144003	MACS_peak_17217	455.81	278	0	1	0	gen
6	5269054	5269347	MACS_peak_17218	140.77	293	0	1	0	gen
6	5379707	5379965	MACS_peak_17219	468.72	258	0	1	0	gen
6	5398526	5398759	MACS_peak_17220	532.66	233	0	1	0	gen
6	5402239	5402704	MACS_peak_17221	701.99	465	0	1	0	gen
6	5422408	5422606	MACS_peak_17222	831.63	198	0	1	0	gen
6	5471057	5471235	MACS_peak_17223	659.6	178	0	1	0	gen
6	5527988	5528214	MACS_peak_17224	1025.76	226	0	1	0	gen
6	6068516	6068859	MACS_peak_17225	214.22	343	0	0	0	intergen
6	6339085	6339390	MACS_peak_17226	560.48	305	0	0	0	intergen
6	6426227	6426440	MACS_peak_17227	312.91	213	0	0	1	other
6	6432341	6432699	MACS_peak_17228	214.6	358	0	0	1	other
6	6556908	6557280	MACS_peak_17229	519.54	372	0	0	1	other
6	6676811	6677174	MACS_peak_17230	526.64	363	0	0	0	intergen
6	6759198	6759506	MACS_peak_17231	558.46	308	0	0	0	intergen
6	6974151	6974461	MACS_peak_17232	437.04	310	0	0	0	intergen
6	7030226	7030492	MACS_peak_17233	115.87	266	0	0	0	intergen
6	7118698	7118929	MACS_peak_17234	153.55	231	0	1	0	gen
6	7243530	7243942	MACS_peak_17235	735.11	412	0	1	0	gen
6	7275976	7276189	MACS_peak_17236	451.43	213	0	1	0	gen
6	7718300	7718473	MACS_peak_17237	1109.31	173	0	0	0	intergen
6	7947095	7947450	MACS_peak_17238	189.55	355	0	1	0	gen
6	8253903	8254228	MACS_peak_17240	547.36	325	0	0	2	other
6	8434084	8434313	MACS_peak_17241	1171.45	229	0	1	1	gen
6	8707960	8708237	MACS_peak_17242	580.42	277	0	0	2	other
6	8888571	8888846	MACS_peak_17243	457.69	275	0	0	1	other
6	9189898	9190135	MACS_peak_17244	662.31	237	0	0	1	other
6	9458099	9458383	MACS_peak_17245	1063.78	284	0	0	0	intergen
6	9540539	9540765	MACS_peak_17246	1025.76	226	0	0	0	intergen
6	9684642	9685079	MACS_peak_17247	57.93	437	0	0	1	other
6	9686484	9686703	MACS_peak_17248	118.49	219	0	0	1	other
6	9887363	9887678	MACS_peak_17249	66.4	315	0	0	1	other
6	10031018	10031382	MACS_peak_17251	524.01	364	0	0	1	other
6	10435146	10435358	MACS_peak_17252	936.57	212	0	0	1	other
6	10478501	10478696	MACS_peak_17253	569.68	195	0	0	0	intergen
6	10582111	10582502	MACS_peak_17254	509.31	391	0	1	0	gen
6	10813040	10813328	MACS_peak_17255	229.83	288	0	3	0	gen
6	10904972	10905415	MACS_peak_17256	499.15	443	0	2	0	gen
6	11000979	11001216	MACS_peak_17257	662.31	237	0	1	0	gen
6	11032234	11032367	MACS_peak_17258	1072.4	133	0	1	0	gen
6	11044492	11044677	MACS_peak_17259	901.33	185	0	0	1	other
6	11455020	11455392	MACS_peak_17260	80.18	372	0	0	1	other
6	11456572	11456953	MACS_peak_17261	105.65	381	0	0	1	other
6	11575546	11575876	MACS_peak_17262	796.13	330	0	1	0	gen
6	11665322	11665745	MACS_peak_17263	772.1	423	0	0	0	intergen
6	11700043	11700490	MACS_peak_17264	712.78	447	0	0	0	intergen
6	11996749	11997057	MACS_peak_17265	721.05	308	0	0	0	intergen
6	12049614	12049831	MACS_peak_17266	580.62	217	0	1	0	gen
6	12092196	12092397	MACS_peak_17267	629.87	201	0	1	0	gen
6	12234107	12234340	MACS_peak_17268	661.2	233	0	0	0	intergen
6	12504439	12504711	MACS_peak_17269	459.58	272	0	0	0	intergen
6	12743744	12744099	MACS_peak_17271	55.51	355	0	1	0	gen
6	12893891	12894280	MACS_peak_17272	628.19	389	0	1	0	gen
6	12911337	12911648	MACS_peak_17273	436.49	311	0	1	0	gen
6	13867440	13867768	MACS_peak_17274	776.53	328	0	0	0	intergen
6	14337047	14337280	MACS_peak_17275	810.9	233	0	0	0	intergen
6	14414438	14414570	MACS_peak_17276	1116.4	132	0	0	0	intergen
6	14692673	14693040	MACS_peak_17277	522.32	367	0	0	1	other
6	14788673	14788820	MACS_peak_17278	972.07	147	0	0	1	other
6	14895230	14895422	MACS_peak_17279	678.9	192	0	0	1	other
6	15645654	15645908	MACS_peak_17280	858.55	254	0	1	0	gen
6	15691321	15691668	MACS_peak_17281	755.6	347	0	0	0	intergen
6	16013344	16013583	MACS_peak_17282	52.32	239	0	0	0	intergen
6	16184182	16184404	MACS_peak_17283	712.32	222	0	0	0	intergen
6	16331384	16331618	MACS_peak_17285	1440.18	234	0	1	0	gen
6	16759524	16759658	MACS_peak_17286	583.66	134	0	1	0	gen
6	16763030	16763262	MACS_peak_17287	532.66	232	0	0	0	intergen
6	16861210	16861563	MACS_peak_17288	55.9	353	0	0	0	intergen
6	16862088	16862232	MACS_peak_17289	514.38	144	0	0	0	intergen
6	16911348	16911531	MACS_peak_17290	688.95	183	0	0	0	intergen
6	17086457	17086680	MACS_peak_17291	866.35	223	0	0	0	intergen
6	17156176	17156383	MACS_peak_17292	780.06	207	0	0	0	intergen
6	17504859	17505314	MACS_peak_17293	478.31	455	0	1	0	gen
6	17585708	17586079	MACS_peak_17295	892.45	371	0	0	0	intergen
6	18324274	18324489	MACS_peak_17296	596.79	215	0	0	0	intergen
6	18437648	18437929	MACS_peak_17297	721.05	281	0	1	0	gen
6	18660296	18660597	MACS_peak_17298	201.59	301	0	0	1	other
6	18910633	18911084	MACS_peak_17299	76.53	451	0	0	0	intergen
6	18967580	18967904	MACS_peak_17300	78.7	324	0	0	0	intergen
6	18997418	18997644	MACS_peak_17301	1025.76	226	0	0	0	intergen
6	19165718	19165979	MACS_peak_17302	466.72	261	0	0	0	intergen
6	19485433	19485814	MACS_peak_17303	65.21	381	0	0	1	other
6	19498673	19499046	MACS_peak_17304	105.42	373	0	0	1	other
6	19621628	19622005	MACS_peak_17305	88.13	377	0	0	1	other
6	19770582	19771056	MACS_peak_17306	212.56	474	0	0	1	other
6	19861609	19861818	MACS_peak_17307	377.86	209	0	0	0	intergen
6	19976481	19976613	MACS_peak_17308	950.58	132	0	0	0	intergen
6	20056404	20056845	MACS_peak_17309	965.4	441	0	0	0	intergen
6	20183061	20183370	MACS_peak_17310	541.84	309	0	1	0	gen
6	20598450	20598754	MACS_peak_17311	504.31	304	0	1	0	gen
6	20875445	20875874	MACS_peak_17312	259	429	0	1	0	gen
6	21019532	21019987	MACS_peak_17313	829.41	455	0	1	0	gen
6	21203128	21203485	MACS_peak_17314	198.49	357	0	1	0	gen
6	21238442	21238692	MACS_peak_17315	613.04	250	0	0	0	intergen
6	21364175	21364533	MACS_peak_17316	132.14	358	0	0	0	intergen
6	21999618	21999871	MACS_peak_17317	470.06	253	0	0	1	other
6	22896281	22896455	MACS_peak_17320	780.06	174	0	0	1	other
6	22930194	22930532	MACS_peak_17321	789.53	338	0	0	1	other
6	23230645	23230982	MACS_peak_17322	155.45	337	0	0	0	intergen
6	23798707	23799025	MACS_peak_17324	76.3	318	0	0	0	intergen
6	23807750	23807964	MACS_peak_17325	111.64	214	0	0	0	intergen
6	24274604	24274816	MACS_peak_17326	596.79	212	0	1	0	gen
6	24389284	24389509	MACS_peak_17328	324.92	225	0	0	0	intergen
6	24942761	24943054	MACS_peak_17329	88.97	293	0	1	0	gen
6	25070783	25071114	MACS_peak_17330	531.83	331	0	0	2	other
6	25421191	25421403	MACS_peak_17331	149.54	212	0	1	1	gen
6	25556474	25556705	MACS_peak_17332	532.66	231	0	1	0	gen
6	25657926	25658127	MACS_peak_17333	252.32	201	0	1	0	gen
6	26205122	26205308	MACS_peak_17334	858.56	186	1	0	0	promoter
6	26248840	26248977	MACS_peak_17335	1162.25	137	3	0	0	promoter
6	26572649	26572906	MACS_peak_17336	469.39	257	0	0	1	other
6	26894672	26894912	MACS_peak_17337	411.81	240	0	0	1	other
6	26901772	26902107	MACS_peak_17338	131.45	335	0	0	1	other
6	26956850	26957060	MACS_peak_17339	661.56	210	0	0	0	intergen
6	27013318	27013670	MACS_peak_17340	94.93	352	0	0	1	other
6	27038063	27038379	MACS_peak_17341	433.75	316	0	0	0	intergen
6	27100412	27100608	MACS_peak_17342	451.06	196	0	0	0	intergen
6	27161908	27162280	MACS_peak_17343	891.62	372	0	0	0	intergen
6	27188916	27189168	MACS_peak_17344	470.06	252	0	0	0	intergen
6	27484061	27484385	MACS_peak_17345	164.26	324	0	0	0	intergen
6	27550115	27550574	MACS_peak_17346	1639.86	459	0	0	0	intergen
6	27687522	27687775	MACS_peak_17347	470.06	253	0	0	0	intergen
6	27752330	27752624	MACS_peak_17348	568.08	294	0	0	0	intergen
6	27772419	27772711	MACS_peak_17349	437.52	292	0	0	0	intergen
6	27792172	27792552	MACS_peak_17350	265.34	380	0	0	0	intergen
6	28055418	28055783	MACS_peak_17351	507.59	365	0	0	0	intergen
6	28491101	28491371	MACS_peak_17352	460.86	270	0	0	0	intergen
6	28624210	28624498	MACS_peak_17353	171.7	288	0	0	0	intergen
6	28854008	28854293	MACS_peak_17354	122.91	285	0	0	0	intergen
6	29113347	29113588	MACS_peak_17355	351.25	241	0	1	0	gen
6	29221824	29222174	MACS_peak_17356	198.49	350	0	0	0	intergen
6	29589433	29589745	MACS_peak_17357	555.79	312	1	1	0	promoter
6	29648003	29648255	MACS_peak_17358	398.97	252	0	0	0	intergen
6	29650050	29650396	MACS_peak_17359	415.55	346	0	0	0	intergen
6	29653452	29653766	MACS_peak_17360	434.84	314	1	0	0	promoter
6	29753021	29753406	MACS_peak_17361	753.71	385	0	0	1	other
6	29781747	29782074	MACS_peak_17362	56.38	327	0	0	0	intergen
6	29834926	29835144	MACS_peak_17363	901.33	218	0	0	0	intergen
6	30013433	30013651	MACS_peak_17364	729.14	218	0	0	1	other
6	30037261	30037571	MACS_peak_17365	813.39	310	0	0	1	other
6	30116816	30116949	MACS_peak_17366	1098.16	133	0	0	0	intergen
6	30131048	30131338	MACS_peak_17367	1254.18	290	0	0	0	intergen
6	30544733	30544955	MACS_peak_17368	564.54	222	1	0	0	promoter
6	30678863	30679236	MACS_peak_17369	518.99	373	1	0	0	promoter
6	30722685	30723043	MACS_peak_17370	903.5	358	1	0	0	promoter
6	30868799	30869110	MACS_peak_17371	488.85	311	0	0	1	other
6	30959071	30959204	MACS_peak_17372	1176.51	133	0	0	0	intergen
6	31070695	31070968	MACS_peak_17373	583.44	273	0	0	0	intergen
6	31079893	31080084	MACS_peak_17374	1061.85	191	0	0	0	intergen
6	31087626	31087854	MACS_peak_17375	677.53	228	0	0	0	intergen
6	31128053	31128364	MACS_peak_17376	436.49	311	0	1	0	gen
6	31137441	31137710	MACS_peak_17377	911.65	269	2	1	0	promoter
6	31397001	31397264	MACS_peak_17379	575.16	263	1	0	0	promoter
6	31427963	31428228	MACS_peak_17380	573.59	265	0	0	1	other
6	31493705	31494035	MACS_peak_17381	426.3	330	1	0	0	promoter
6	31772914	31773134	MACS_peak_17382	413.13	220	1	1	0	promoter
6	31795913	31796140	MACS_peak_17383	548.55	227	1	0	0	promoter
6	31989450	31989679	MACS_peak_17384	635.07	229	0	1	0	gen
6	32022188	32022417	MACS_peak_17385	635.07	229	0	1	0	gen
6	32087679	32087881	MACS_peak_17386	814.37	202	0	1	0	gen
6	32259763	32260116	MACS_peak_17387	69	353	0	0	1	other
6	32267215	32267555	MACS_peak_17388	383.01	340	0	0	1	other
6	32413515	32413706	MACS_peak_17389	850.72	191	0	0	0	intergen
6	32415339	32415723	MACS_peak_17390	881.79	384	0	0	0	intergen
6	32692047	32692484	MACS_peak_17391	538.64	437	0	0	0	intergen
6	33391173	33391547	MACS_peak_17392	1022.03	374	1	0	0	promoter
6	33484558	33484924	MACS_peak_17393	72.96	366	0	0	0	intergen
6	34258405	34258764	MACS_peak_17394	339.44	359	0	0	1	other
6	34609636	34609884	MACS_peak_17395	712.61	248	0	1	0	gen
6	34843438	34843817	MACS_peak_17396	682.47	379	0	1	0	gen
6	35146481	35146655	MACS_peak_17397	780.06	174	0	1	0	gen
6	35279407	35279577	MACS_peak_17398	729.92	170	0	1	1	gen
6	35305134	35305324	MACS_peak_17399	1079.97	190	0	1	0	gen
6	35342308	35342498	MACS_peak_17400	474.18	190	1	0	0	promoter
6	35415304	35415674	MACS_peak_17401	380.3	370	0	1	0	gen
6	35560358	35560559	MACS_peak_17402	755.27	201	0	0	0	intergen
6	35624475	35624782	MACS_peak_17403	425.44	307	0	1	0	gen
6	35775015	35775147	MACS_peak_17404	932.35	132	1	0	0	promoter
6	35956052	35956265	MACS_peak_17405	763.02	213	0	1	0	gen
6	36095186	36095449	MACS_peak_17406	465.4	263	0	1	0	gen
6	36123904	36124120	MACS_peak_17407	944.23	216	1	0	0	promoter
6	36360532	36360797	MACS_peak_17408	589.61	265	0	1	0	gen
6	36429036	36429414	MACS_peak_17409	403.06	378	0	1	0	gen
6	36623491	36623750	MACS_peak_17410	468.05	259	0	0	0	intergen
6	36759228	36759415	MACS_peak_17411	901.33	187	0	1	0	gen
6	37044490	37044717	MACS_peak_17412	548.55	227	0	0	0	intergen
6	37172254	37172476	MACS_peak_17413	564.54	222	1	0	0	promoter
6	37210555	37210768	MACS_peak_17414	593.82	213	1	0	0	promoter
6	37303974	37304234	MACS_peak_17415	593.56	260	0	1	0	gen
6	37346040	37346277	MACS_peak_17416	105.89	237	0	0	0	intergen
6	37347496	37347732	MACS_peak_17417	371.92	236	0	0	0	intergen
6	37382973	37383211	MACS_peak_17418	516.86	238	0	1	0	gen
6	37860279	37860561	MACS_peak_17419	1235.43	282	0	1	0	gen
6	38289875	38290143	MACS_peak_17420	312.33	268	0	1	0	gen
6	38570826	38571155	MACS_peak_17421	722.05	329	0	1	0	gen
6	38611061	38611279	MACS_peak_17422	710.43	218	0	1	0	gen
6	38872040	38872302	MACS_peak_17423	1145.01	262	0	1	0	gen
6	39578218	39578352	MACS_peak_17424	1630.94	134	0	1	0	gen
6	39650377	39650620	MACS_peak_17425	3005.77	243	0	1	0	gen
6	39740595	39740947	MACS_peak_17426	54.66	352	0	0	0	intergen
6	39981096	39981397	MACS_peak_17427	821.52	301	0	0	1	other
6	40058906	40059229	MACS_peak_17428	265.34	323	0	0	0	intergen
6	40308831	40309032	MACS_peak_17430	645.81	201	0	0	0	intergen
6	40577642	40577961	MACS_peak_17431	229.83	319	0	1	0	gen
6	40636804	40637098	MACS_peak_17432	446.16	294	0	0	0	intergen
6	41066871	41067146	MACS_peak_17433	457.69	275	0	1	0	gen
6	41368756	41369227	MACS_peak_17434	1910.74	471	0	0	0	intergen
6	41683712	41683902	MACS_peak_17435	695.57	190	1	0	0	promoter
6	41921337	41921581	MACS_peak_17436	525.6	244	1	0	0	promoter
6	42580892	42581024	MACS_peak_17437	797.63	132	0	1	0	gen
6	42726642	42726911	MACS_peak_17438	448.17	269	0	0	0	intergen
6	42845075	42845245	MACS_peak_17439	1268.27	170	0	1	0	gen
6	43129900	43130062	MACS_peak_17441	848.95	162	0	1	0	gen
6	43470871	43471147	MACS_peak_17442	239.85	276	0	0	0	intergen
6	44151964	44152271	MACS_peak_17443	438.71	307	0	1	0	gen
6	44313323	44313497	MACS_peak_17444	780.06	174	0	1	0	gen
6	44418907	44419235	MACS_peak_17445	75.01	328	0	1	0	gen
6	44456372	44456701	MACS_peak_17446	297.13	329	0	0	0	intergen
6	44874231	44874457	MACS_peak_17447	66.4	226	0	1	0	gen
6	44959346	44959610	MACS_peak_17449	611.86	264	0	1	0	gen
6	45129507	45129795	MACS_peak_17450	439.89	288	0	1	0	gen
6	45322974	45323282	MACS_peak_17451	684.39	308	0	1	0	gen
6	45930512	45930807	MACS_peak_17452	445.58	295	0	1	0	gen
6	46090189	46090468	MACS_peak_17453	578.93	279	0	0	0	intergen
6	46142257	46142476	MACS_peak_17454	580.62	219	0	1	0	gen
6	46221266	46221597	MACS_peak_17455	337.29	331	1	0	0	promoter
6	46514577	46514981	MACS_peak_17456	1128.3	404	0	0	1	other
6	46781521	46781775	MACS_peak_17457	596.79	254	0	0	0	intergen
6	46855884	46856288	MACS_peak_17458	740.48	404	1	0	0	promoter
6	47047520	47047868	MACS_peak_17459	239.65	348	0	0	0	intergen
6	47212902	47213232	MACS_peak_17460	393.87	330	0	0	0	intergen
6	47217657	47217998	MACS_peak_17461	52.21	341	0	0	0	intergen
6	47638665	47638951	MACS_peak_17462	106.41	286	0	0	0	intergen
6	47788083	47788384	MACS_peak_17463	671.3	301	0	1	0	gen
6	48105606	48105985	MACS_peak_17464	56.38	379	0	0	0	intergen
6	48355445	48355702	MACS_peak_17465	456.04	257	0	0	0	intergen
6	48363641	48363994	MACS_peak_17466	159.53	353	0	0	0	intergen
6	48722161	48722542	MACS_peak_17467	52.99	381	0	0	0	intergen
6	48765423	48765662	MACS_peak_17468	645.81	239	0	0	0	intergen
6	48832722	48833099	MACS_peak_17470	635.71	377	0	0	0	intergen
6	48905452	48905651	MACS_peak_17471	352.52	199	0	0	0	intergen
6	49096550	49097026	MACS_peak_17472	489.97	476	0	0	0	intergen
6	49347245	49347501	MACS_peak_17474	405.24	256	0	0	0	intergen
6	49390854	49391169	MACS_peak_17475	58.47	315	0	0	0	intergen
6	49532043	49532451	MACS_peak_17476	1751.77	408	0	0	0	intergen
6	49607205	49607561	MACS_peak_17477	291.53	356	1	0	0	promoter
6	49623199	49623406	MACS_peak_17478	611.55	207	0	1	0	gen
6	49634643	49634872	MACS_peak_17479	548.55	229	0	1	0	gen
6	49791739	49792082	MACS_peak_17480	50.92	343	0	0	0	intergen
6	49849617	49849989	MACS_peak_17481	408.42	372	0	1	0	gen
6	50062126	50062404	MACS_peak_17483	455.81	278	0	0	0	intergen
6	50143502	50143701	MACS_peak_17484	809.56	199	0	0	1	other
6	50317937	50318232	MACS_peak_17485	1247.67	295	0	0	0	intergen
6	50623619	50623925	MACS_peak_17487	56.38	306	0	0	1	other
6	50655921	50656221	MACS_peak_17488	563.9	300	0	0	0	intergen
6	50757472	50757794	MACS_peak_17489	549.27	322	0	1	0	gen
6	50792007	50792252	MACS_peak_17490	501.16	245	0	0	0	intergen
6	50815416	50815780	MACS_peak_17491	1167.8	364	1	0	0	promoter
6	51101355	51101605	MACS_peak_17492	57.61	250	0	0	0	intergen
6	51123070	51123437	MACS_peak_17493	163.54	367	0	0	0	intergen
6	51124101	51124405	MACS_peak_17494	67.19	304	0	0	0	intergen
6	51350387	51350615	MACS_peak_17495	485.73	228	0	0	0	intergen
6	51482702	51482946	MACS_peak_17496	71.93	244	0	0	0	intergen
6	51494422	51494799	MACS_peak_17497	380.3	377	0	0	0	intergen
6	51541986	51542266	MACS_peak_17498	454.58	280	0	0	0	intergen
6	51896854	51897088	MACS_peak_17500	85.56	234	0	1	0	gen
6	51959947	51960145	MACS_peak_17501	808.21	198	0	1	0	gen
6	52163018	52163233	MACS_peak_17502	1453.47	215	0	0	0	intergen
6	52234208	52234505	MACS_peak_17503	565.98	297	1	0	0	promoter
6	52263839	52264023	MACS_peak_17504	729.14	184	1	0	0	promoter
6	52839623	52839910	MACS_peak_17505	573.07	287	0	1	0	gen
6	53093928	53094234	MACS_peak_17506	816.97	306	0	1	0	gen
6	53171865	53172258	MACS_peak_17507	625.74	393	0	0	0	intergen
6	53192083	53192228	MACS_peak_17508	703.94	145	0	0	0	intergen
6	53403701	53404077	MACS_peak_17509	95.47	376	0	0	0	intergen
6	53484692	53485021	MACS_peak_17510	800.41	329	0	0	0	intergen
6	53488206	53488532	MACS_peak_17511	62.68	326	0	0	0	intergen
6	53508381	53508582	MACS_peak_17512	645.81	201	0	1	0	gen
6	53509513	53509892	MACS_peak_17513	358.59	379	0	1	0	gen
6	53516976	53517376	MACS_peak_17514	776.48	400	0	1	0	gen
6	53544707	53544926	MACS_peak_17515	580.62	219	0	1	0	gen
6	53728690	53728907	MACS_peak_17516	580.62	217	0	0	0	intergen
6	53770104	53770303	MACS_peak_17517	831.63	199	0	0	1	other
6	53871325	53871601	MACS_peak_17518	581.17	276	0	1	0	gen
6	53956113	53956422	MACS_peak_17519	380.3	309	0	1	1	gen
6	53979535	53979794	MACS_peak_17520	841.73	259	0	1	2	gen
6	54297537	54297889	MACS_peak_17522	71.55	352	0	0	0	intergen
6	54408416	54408706	MACS_peak_17523	96.97	290	0	0	0	intergen
6	54505918	54506308	MACS_peak_17524	240.11	390	0	0	0	intergen
6	54604925	54605174	MACS_peak_17525	613.04	249	0	0	0	intergen
6	54727920	54728242	MACS_peak_17526	88.56	322	0	0	0	intergen
6	54964024	54964354	MACS_peak_17527	50.19	330	0	0	0	intergen
6	55059363	55059528	MACS_peak_17528	1061.85	165	0	0	0	intergen
6	55241349	55241748	MACS_peak_17529	466.64	399	0	1	0	gen
6	55276811	55277050	MACS_peak_17530	645.81	239	0	1	0	gen
6	55293959	55294181	MACS_peak_17531	549.18	222	0	0	0	intergen
6	55308459	55308830	MACS_peak_17532	50.92	371	0	0	0	intergen
6	55365371	55365732	MACS_peak_17533	73.89	361	0	1	0	gen
6	55477086	55477429	MACS_peak_17534	603.02	343	0	1	0	gen
6	55528632	55528936	MACS_peak_17535	380.3	304	0	1	0	gen
6	55627839	55628277	MACS_peak_17537	967.74	438	0	0	0	intergen
6	55736813	55737164	MACS_peak_17539	165.26	351	0	0	0	intergen
6	55740471	55740818	MACS_peak_17540	52.3	347	0	0	0	intergen
6	55767596	55767767	MACS_peak_17541	797.18	171	0	1	0	gen
6	55980686	55980946	MACS_peak_17542	539.85	260	0	0	0	intergen
6	56570854	56571069	MACS_peak_17545	746.04	215	0	1	0	gen
6	56709148	56709373	MACS_peak_17547	545.56	225	0	1	0	gen
6	56851816	56852094	MACS_peak_17548	709.17	278	0	1	1	gen
6	56902985	56903228	MACS_peak_17549	585.19	243	0	1	0	gen
6	56904610	56904865	MACS_peak_17550	543.04	255	0	1	0	gen
6	57268111	57268447	MACS_peak_17551	133.43	336	0	0	0	intergen
6	57335874	57336215	MACS_peak_17552	62.38	341	0	1	0	gen
6	57337828	57338306	MACS_peak_17553	70.93	478	0	1	0	gen
6	60347747	60348106	MACS_peak_17554	81.3	359	0	0	1	other
6	60397685	60397974	MACS_peak_17555	378.36	289	0	0	1	other
6	60477726	60478196	MACS_peak_17556	1341.76	470	0	0	1	other
6	60565632	60565902	MACS_peak_17557	437.5	270	0	0	0	intergen
6	60703656	60704048	MACS_peak_17558	233.06	392	0	0	0	intergen
6	60964828	60965067	MACS_peak_17560	302.27	239	0	0	0	intergen
6	57796794	57797195	MACS_peak_17561	662.91	401	0	0	0	intergen
6	57935766	57936024	MACS_peak_17562	178.37	258	0	0	1	other
6	57940670	57941103	MACS_peak_17563	222.57	433	0	0	1	other
6	58276422	58276633	MACS_peak_17564	156.63	211	0	0	1	other
6	61336538	61336848	MACS_peak_17565	74.86	310	0	0	0	intergen
6	61335297	61335567	MACS_peak_17566	125.19	270	0	0	0	intergen
6	61334826	61335126	MACS_peak_17567	82.07	300	0	0	0	intergen
6	61331643	61332063	MACS_peak_17568	139.27	420	0	0	0	intergen
6	61329840	61330112	MACS_peak_17569	210.11	272	0	0	0	intergen
6	61329346	61329684	MACS_peak_17570	58.28	338	0	0	0	intergen
6	61328227	61328526	MACS_peak_17571	203.1	299	0	0	0	intergen
6	61324078	61324388	MACS_peak_17573	390.73	310	0	0	0	intergen
6	61323609	61323922	MACS_peak_17574	53.9	313	0	0	0	intergen
6	62061830	62062195	MACS_peak_17576	65.72	365	0	1	0	gen
6	62150202	62150564	MACS_peak_17577	770.64	362	0	1	0	gen
6	62156325	62156657	MACS_peak_17578	431.27	332	0	1	0	gen
6	62314227	62314564	MACS_peak_17579	135.14	337	0	0	0	intergen
6	62367968	62368250	MACS_peak_17580	839.55	282	0	0	0	intergen
6	62384793	62385007	MACS_peak_17581	130.47	214	0	0	0	intergen
6	62556651	62557108	MACS_peak_17582	77.27	457	0	0	0	intergen
6	62775533	62775795	MACS_peak_17583	466.05	262	0	0	0	intergen
6	62777880	62778211	MACS_peak_17584	927.83	331	0	0	0	intergen
6	62781894	62782287	MACS_peak_17585	1138.75	393	0	0	0	intergen
6	63316365	63316781	MACS_peak_17586	496.62	416	0	1	0	gen
6	63406460	63406910	MACS_peak_17587	61.21	450	0	0	0	intergen
6	63419774	63420007	MACS_peak_17588	1690.59	233	0	0	0	intergen
6	63547382	63547534	MACS_peak_17589	602.31	152	0	1	0	gen
6	64012165	64012574	MACS_peak_17590	500.09	409	0	1	0	gen
6	64167547	64167861	MACS_peak_17591	434.84	314	0	1	0	gen
6	64280598	64280946	MACS_peak_17592	417.2	348	0	1	0	gen
6	64318373	64318706	MACS_peak_17593	514.46	333	0	1	0	gen
6	64689735	64690078	MACS_peak_17594	110.99	343	0	1	0	gen
6	64838812	64839043	MACS_peak_17595	532.66	231	0	1	0	gen
6	65256256	65256726	MACS_peak_17596	215.89	470	0	1	0	gen
6	65506934	65507188	MACS_peak_17597	696.33	254	0	1	0	gen
6	65594651	65594944	MACS_peak_17599	165.91	293	0	1	0	gen
6	65606334	65606610	MACS_peak_17600	406.81	276	0	1	0	gen
6	65776321	65776663	MACS_peak_17601	306.27	342	0	0	0	intergen
6	65850166	65850309	MACS_peak_17602	1007.8	143	0	0	0	intergen
6	65972237	65972542	MACS_peak_17603	114.74	305	0	0	0	intergen
6	66421633	66421894	MACS_peak_17604	470.12	261	0	0	0	intergen
6	66525535	66525799	MACS_peak_17605	172.39	264	0	0	0	intergen
6	66662252	66662568	MACS_peak_17606	603.02	316	0	0	0	intergen
6	66709075	66709208	MACS_peak_17607	757.5	133	0	0	0	intergen
6	66974378	66974594	MACS_peak_17608	580.56	216	0	0	0	intergen
6	67098044	67098329	MACS_peak_17609	154.12	285	0	0	0	intergen
6	67232706	67232997	MACS_peak_17610	447.93	291	0	0	0	intergen
6	67701799	67702105	MACS_peak_17611	611.86	306	0	0	0	intergen
6	67771032	67771248	MACS_peak_17612	580.56	216	0	0	0	intergen
6	67786716	67787009	MACS_peak_17613	69	293	0	0	0	intergen
6	67802074	67802532	MACS_peak_17614	952.43	458	0	0	0	intergen
6	67828000	67828313	MACS_peak_17615	680.5	313	0	0	0	intergen
6	68313965	68314264	MACS_peak_17616	443.26	299	0	0	1	other
6	68538052	68538302	MACS_peak_17617	271.64	250	0	0	0	intergen
6	68588993	68589261	MACS_peak_17618	718.04	268	0	0	0	intergen
6	68601681	68601964	MACS_peak_17620	51.12	283	0	0	0	intergen
6	68638352	68638674	MACS_peak_17621	430.51	322	1	0	0	promoter
6	69165029	69165231	MACS_peak_17622	645.81	202	0	1	0	gen
6	69413116	69413342	MACS_peak_17623	214.34	226	0	0	0	intergen
6	69443402	69443640	MACS_peak_17624	89.67	238	0	0	0	intergen
6	69719696	69719894	MACS_peak_17625	831.63	198	0	1	0	gen
6	69732645	69732950	MACS_peak_17626	2490.41	305	0	1	0	gen
6	70069190	70069464	MACS_peak_17628	274.43	274	0	1	0	gen
6	70103838	70104277	MACS_peak_17629	599.25	439	0	1	0	gen
6	70108123	70108569	MACS_peak_17630	439.97	446	0	1	0	gen
6	70686580	70686981	MACS_peak_17631	998.05	401	0	1	0	gen
6	70756985	70757370	MACS_peak_17632	70.09	385	0	1	0	gen
6	70786048	70786461	MACS_peak_17633	92.3	413	0	1	0	gen
6	70804566	70804868	MACS_peak_17634	114.74	302	0	1	0	gen
6	70884392	70884754	MACS_peak_17635	525.14	362	0	1	0	gen
6	70977265	70977605	MACS_peak_17636	63.13	340	0	0	0	intergen
6	71275514	71275962	MACS_peak_17637	69.92	448	0	0	1	other
6	71349370	71349675	MACS_peak_17638	395.39	305	0	0	2	other
6	71374938	71375243	MACS_peak_17639	662.91	305	0	0	3	other
6	71515646	71515968	MACS_peak_17640	406.81	322	0	0	0	intergen
6	71762669	71762990	MACS_peak_17641	431.05	321	0	0	0	intergen
6	72201837	72202086	MACS_peak_17642	485.56	249	0	1	0	gen
6	72412245	72412505	MACS_peak_17643	1601.1	260	0	0	0	intergen
6	72428893	72429206	MACS_peak_17644	127.5	313	0	0	0	intergen
6	72474310	72474707	MACS_peak_17645	82.41	397	0	0	0	intergen
6	72492089	72492413	MACS_peak_17646	119.44	324	0	0	0	intergen
6	72574448	72574929	MACS_peak_17647	103.16	481	0	0	0	intergen
6	73129879	73130240	MACS_peak_17648	472.58	361	0	1	0	gen
6	73147729	73148008	MACS_peak_17649	708.3	279	0	1	0	gen
6	73310895	73311265	MACS_peak_17650	137.06	370	0	0	0	intergen
6	73312278	73312658	MACS_peak_17651	62.38	380	0	0	0	intergen
6	73326508	73326904	MACS_peak_17652	453.78	396	0	0	0	intergen
6	73675550	73675789	MACS_peak_17653	516.86	239	0	0	0	intergen
6	73760136	73760440	MACS_peak_17654	1075.17	304	0	1	0	gen
6	73922132	73922450	MACS_peak_17655	90.08	318	0	0	0	intergen
6	73970069	73970291	MACS_peak_17657	1925.05	222	0	0	0	intergen
6	73998654	73999033	MACS_peak_17658	50.92	379	0	0	0	intergen
6	74007315	74007773	MACS_peak_17659	91.34	458	0	0	0	intergen
6	74280321	74280539	MACS_peak_17660	580.62	218	0	0	1	other
6	74401503	74401891	MACS_peak_17661	75.01	388	0	0	1	other
6	74416182	74416467	MACS_peak_17662	451.52	285	0	0	1	other
6	74487598	74487903	MACS_peak_17663	84.14	305	0	0	1	other
6	74719243	74719452	MACS_peak_17664	558.17	209	0	0	1	other
6	74883535	74883786	MACS_peak_17665	117.41	251	0	0	0	intergen
6	74884547	74884808	MACS_peak_17666	125.1	261	0	0	0	intergen
6	75009832	75010230	MACS_peak_17667	53.56	398	0	0	0	intergen
6	75017227	75017621	MACS_peak_17668	122.32	394	0	0	0	intergen
6	75030146	75030357	MACS_peak_17669	700.29	211	0	0	0	intergen
6	75186103	75186335	MACS_peak_17670	678.9	232	0	1	0	gen
6	75262751	75262939	MACS_peak_17671	695.57	188	0	1	0	gen
6	75266596	75267033	MACS_peak_17672	486.55	437	0	1	0	gen
6	75658881	75659103	MACS_peak_17673	555.12	222	0	1	0	gen
6	75660217	75660401	MACS_peak_17674	729.14	184	0	1	0	gen
6	75687619	75687893	MACS_peak_17675	233.74	274	0	1	0	gen
6	75747205	75747342	MACS_peak_17676	914.41	137	1	0	0	promoter
6	75855124	75855303	MACS_peak_17677	954.29	179	0	1	0	gen
6	75902888	75903199	MACS_peak_17678	75.63	311	0	1	0	gen
6	75924396	75924859	MACS_peak_17679	1207.96	463	1	0	0	promoter
6	75934994	75935226	MACS_peak_17680	514.21	232	0	1	0	gen
6	76115558	76115991	MACS_peak_17681	100.2	433	0	0	0	intergen
6	76271943	76272283	MACS_peak_17682	276.21	340	0	0	0	intergen
6	76401882	76402106	MACS_peak_17683	693.9	224	0	0	0	intergen
6	76747559	76747941	MACS_peak_17684	83.26	382	0	0	0	intergen
6	76831135	76831431	MACS_peak_17685	566.68	296	0	0	0	intergen
6	76964645	76965011	MACS_peak_17687	82.09	366	0	0	0	intergen
6	77133053	77133195	MACS_peak_17688	1007.8	142	0	0	0	intergen
6	77170117	77170343	MACS_peak_17689	347.46	226	0	0	0	intergen
6	77240343	77240633	MACS_peak_17690	1083.14	290	0	0	0	intergen
6	77466014	77466285	MACS_peak_17691	722.05	271	1	0	0	promoter
6	77620157	77620583	MACS_peak_17692	785.65	426	0	0	0	intergen
6	77717956	77718396	MACS_peak_17693	686.79	440	0	1	0	gen
6	77724386	77724617	MACS_peak_17694	448.01	231	0	1	0	gen
6	77874658	77874951	MACS_peak_17695	142.14	293	0	1	0	gen
6	77973057	77973334	MACS_peak_17696	380.3	277	0	0	0	intergen
6	78127927	78128152	MACS_peak_17697	300.22	225	0	0	0	intergen
6	78227979	78228419	MACS_peak_17698	60.76	440	0	0	0	intergen
6	78371182	78371420	MACS_peak_17699	187.23	238	0	0	0	intergen
6	78611972	78612259	MACS_peak_17700	450.32	287	0	0	0	intergen
6	78649049	78649413	MACS_peak_17701	107.27	364	0	0	0	intergen
6	78698459	78698781	MACS_peak_17702	198.24	322	0	0	0	intergen
6	78798212	78798589	MACS_peak_17703	57.86	377	0	0	0	intergen
6	78870001	78870142	MACS_peak_17704	895.4	141	1	0	0	promoter
6	78922543	78922976	MACS_peak_17705	223.95	433	0	1	0	gen
6	79201424	79201678	MACS_peak_17706	487.24	254	1	0	0	promoter
6	79250359	79250500	MACS_peak_17707	770.61	141	0	0	0	intergen
6	79323404	79323836	MACS_peak_17708	163.44	432	0	0	0	intergen
6	79349567	79349878	MACS_peak_17709	89.02	311	0	0	0	intergen
6	79570658	79570998	MACS_peak_17710	660.56	340	0	0	0	intergen
6	79672745	79672999	MACS_peak_17711	596.79	254	0	1	0	gen
6	79778035	79778279	MACS_peak_17712	629.38	244	0	0	0	intergen
6	79787331	79787570	MACS_peak_17713	1098.16	239	0	0	0	intergen
6	79813976	79814263	MACS_peak_17714	1709.86	287	0	0	0	intergen
6	79868246	79868460	MACS_peak_17715	746.04	214	0	0	0	intergen
6	79956267	79956740	MACS_peak_17716	116.98	473	0	0	0	intergen
6	79956898	79957122	MACS_peak_17717	175.61	224	0	0	0	intergen
6	80138610	80138912	MACS_peak_17718	55.69	302	0	1	0	gen
6	80605424	80605793	MACS_peak_17719	640.87	369	0	0	0	intergen
6	80658078	80658379	MACS_peak_17720	380.3	301	0	0	0	intergen
6	80748136	80748402	MACS_peak_17721	75.07	266	0	0	0	intergen
6	80784559	80784871	MACS_peak_17722	114.74	312	0	0	0	intergen
6	80852437	80852768	MACS_peak_17724	56.38	331	0	0	0	intergen
6	81014133	81014561	MACS_peak_17725	64.08	428	0	0	0	intergen
6	81015943	81016306	MACS_peak_17726	53.51	363	0	0	0	intergen
6	81046842	81047176	MACS_peak_17727	63.13	334	0	0	0	intergen
6	81432979	81433247	MACS_peak_17729	87.28	268	0	0	0	intergen
6	81465970	81466224	MACS_peak_17730	322.82	254	0	0	0	intergen
6	81581699	81582052	MACS_peak_17731	96.22	353	0	1	0	gen
6	82178176	82178430	MACS_peak_17732	1171.45	254	0	1	0	gen
6	82301483	82301801	MACS_peak_17733	121	318	0	0	0	intergen
6	82499557	82500000	MACS_peak_17734	170.04	443	0	0	0	intergen
6	82635068	82635394	MACS_peak_17735	55.51	326	0	0	0	intergen
6	82637083	82637389	MACS_peak_17736	54.35	306	0	0	0	intergen
6	82719732	82720105	MACS_peak_17737	116.96	373	0	0	0	intergen
6	82807167	82807373	MACS_peak_17738	275.51	206	0	0	0	intergen
6	82815361	82815603	MACS_peak_17739	258.42	242	0	0	0	intergen
6	83055327	83055699	MACS_peak_17740	294.26	372	0	1	0	gen
6	83334214	83334662	MACS_peak_17741	62.17	448	0	1	0	gen
6	83533728	83534097	MACS_peak_17742	81.13	369	0	0	0	intergen
6	83801641	83801865	MACS_peak_17743	119.34	224	0	0	0	intergen
6	84179348	84179682	MACS_peak_17744	60.1	334	0	1	0	gen
6	84243757	84244124	MACS_peak_17745	139.36	367	0	0	0	intergen
6	84364724	84365021	MACS_peak_17746	61.64	297	0	0	0	intergen
6	84368759	84369091	MACS_peak_17747	56.38	332	0	0	0	intergen
6	84392671	84392927	MACS_peak_17748	470.06	256	0	0	0	intergen
6	84525453	84525723	MACS_peak_17749	585.73	270	0	0	1	other
6	84591493	84591835	MACS_peak_17750	476.92	342	0	0	0	intergen
6	84608834	84609132	MACS_peak_17751	120.45	298	0	0	0	intergen
6	84614376	84614574	MACS_peak_17752	175.66	198	0	0	0	intergen
6	84702477	84702923	MACS_peak_17753	75.42	446	0	1	1	gen
6	84829273	84829595	MACS_peak_17754	100.97	322	0	0	0	intergen
6	84967502	84967691	MACS_peak_17755	695.57	189	0	0	0	intergen
6	85323491	85323736	MACS_peak_17756	629.38	245	0	0	0	intergen
6	85331285	85331655	MACS_peak_17757	436.34	370	0	0	0	intergen
6	85354961	85355214	MACS_peak_17758	797.25	253	0	0	0	intergen
6	85366901	85367209	MACS_peak_17759	73.29	308	0	0	0	intergen
6	85483043	85483442	MACS_peak_17760	869.94	399	0	1	0	gen
6	85536014	85536238	MACS_peak_17761	413.13	224	0	1	0	gen
6	85537128	85537381	MACS_peak_17762	1025.76	253	0	1	0	gen
6	85894350	85894662	MACS_peak_17763	50.75	312	0	0	0	intergen
6	85894820	85895151	MACS_peak_17764	63.13	331	0	0	0	intergen
6	85933759	85934072	MACS_peak_17765	114.74	313	0	0	0	intergen
6	85986414	85986792	MACS_peak_17766	50.92	378	0	0	0	intergen
6	86175228	86175595	MACS_peak_17768	634.13	367	0	0	0	intergen
6	86211887	86212114	MACS_peak_17769	57.91	227	0	0	0	intergen
6	86623016	86623310	MACS_peak_17770	1248.96	294	0	0	0	intergen
6	86692886	86693245	MACS_peak_17772	76.67	359	0	0	0	intergen
6	86722996	86723353	MACS_peak_17773	488.85	357	0	0	0	intergen
6	86857066	86857378	MACS_peak_17774	555.79	312	0	0	0	intergen
6	86900485	86900865	MACS_peak_17775	76.63	380	0	0	0	intergen
6	87237865	87238255	MACS_peak_17777	443.81	390	0	1	0	gen
6	87305264	87305624	MACS_peak_17778	56.38	360	0	1	0	gen
6	87324190	87324500	MACS_peak_17779	84.82	310	1	1	0	promoter
6	87324848	87325104	MACS_peak_17780	64.69	256	1	1	0	promoter
6	87443077	87443335	MACS_peak_17781	595.17	258	0	2	0	gen
6	87673043	87673183	MACS_peak_17782	431.68	140	1	0	0	promoter
6	87708762	87709103	MACS_peak_17783	137.06	341	0	0	0	intergen
6	87855493	87855630	MACS_peak_17784	977.68	137	0	0	0	intergen
6	88232871	88233114	MACS_peak_17785	501.16	243	0	0	1	other
6	88238222	88238403	MACS_peak_17786	731.97	181	0	0	1	other
6	88283138	88283362	MACS_peak_17787	463.48	224	0	0	1	other
6	88409281	88409687	MACS_peak_17788	107.12	406	0	0	1	other
6	88410083	88410418	MACS_peak_17789	83.42	335	0	0	1	other
6	88422883	88423105	MACS_peak_17790	564.54	222	0	0	0	intergen
6	88899531	88899887	MACS_peak_17792	413.31	356	0	1	0	gen
6	88948921	88949193	MACS_peak_17793	166.08	272	0	1	0	gen
6	88968197	88968329	MACS_peak_17794	932.35	132	0	0	0	intergen
6	89086401	89086546	MACS_peak_17795	1245.57	145	0	0	0	intergen
6	89189353	89189677	MACS_peak_17796	74.57	324	0	1	0	gen
6	89368160	89368468	MACS_peak_17797	815.17	308	1	0	0	promoter
6	89729540	89729700	MACS_peak_17798	1098.16	160	0	1	0	gen
6	89796315	89796677	MACS_peak_17799	216.96	362	0	1	0	gen
6	90056011	90056357	MACS_peak_17800	148.5	346	0	1	0	gen
6	90286914	90287195	MACS_peak_17801	706.57	281	0	1	0	gen
6	90951577	90951828	MACS_peak_17802	746.04	251	0	0	0	intergen
6	91464354	91464579	MACS_peak_17803	621.12	225	0	0	0	intergen
6	91859398	91859540	MACS_peak_17805	927.02	142	0	0	0	intergen
6	92009778	92010157	MACS_peak_17806	76.3	379	0	0	1	other
6	92627295	92627636	MACS_peak_17807	62.38	341	0	0	0	intergen
6	92777249	92777525	MACS_peak_17808	710.92	276	0	0	0	intergen
6	93424373	93424633	MACS_peak_17809	662.65	260	0	0	0	intergen
6	93548134	93548469	MACS_peak_17810	55.86	335	0	0	0	intergen
6	93635800	93636125	MACS_peak_17812	54.3	325	0	0	0	intergen
6	94167752	94168078	MACS_peak_17813	546.72	326	0	0	1	other
6	94349189	94349381	MACS_peak_17814	1264.23	192	0	0	0	intergen
6	94711244	94711586	MACS_peak_17815	917.68	342	0	0	0	intergen
6	94856720	94856953	MACS_peak_17816	74.81	233	0	0	0	intergen
6	95398826	95399233	MACS_peak_17818	330.03	407	0	0	0	intergen
6	95620354	95620567	MACS_peak_17821	367.55	213	0	0	0	intergen
6	95666411	95666715	MACS_peak_17822	63.75	304	0	0	0	intergen
6	95708826	95709258	MACS_peak_17823	87.28	432	0	0	0	intergen
6	95773302	95773657	MACS_peak_17825	953.02	355	0	0	0	intergen
6	95866811	95867121	MACS_peak_17826	326.98	310	0	0	0	intergen
6	95898182	95898558	MACS_peak_17827	99.21	376	0	0	0	intergen
6	96094311	96094549	MACS_peak_17828	516.86	238	0	1	0	gen
6	96445832	96446022	MACS_peak_17829	485.67	190	0	0	1	other
6	96655214	96655366	MACS_peak_17830	201.93	152	0	0	0	intergen
6	97068192	97068533	MACS_peak_17831	521.55	341	0	1	0	gen
6	97705380	97705793	MACS_peak_17832	613.85	413	0	0	1	other
6	97979087	97979373	MACS_peak_17833	450.92	286	0	0	1	other
6	98054485	98054765	MACS_peak_17834	454.58	280	0	0	1	other
6	98416926	98417208	MACS_peak_17836	139.94	282	0	0	0	intergen
6	98622057	98622254	MACS_peak_17837	1025.76	197	0	0	0	intergen
6	98703817	98704215	MACS_peak_17838	78.28	398	0	0	0	intergen
6	98705566	98705846	MACS_peak_17839	58.47	280	0	0	0	intergen
6	98845810	98846049	MACS_peak_17840	645.81	239	0	0	0	intergen
6	98866667	98866986	MACS_peak_17841	73.94	319	1	0	0	promoter
6	99007934	99008248	MACS_peak_17843	262.07	314	0	0	0	intergen
6	99152116	99152351	MACS_peak_17844	516.86	235	0	0	0	intergen
6	99208008	99208361	MACS_peak_17845	52.98	353	0	0	0	intergen
6	99242032	99242293	MACS_peak_17846	466.72	261	0	0	0	intergen
6	99330140	99330385	MACS_peak_17847	612.68	245	0	1	0	gen
6	99434987	99435265	MACS_peak_17848	579.67	278	1	0	0	promoter
6	99451566	99451932	MACS_peak_17849	61.12	366	0	1	0	gen
6	99654513	99654848	MACS_peak_17850	70.79	335	0	0	0	intergen
6	99673849	99674178	MACS_peak_17851	95.02	329	0	0	0	intergen
6	99824386	99824636	MACS_peak_17852	63.75	250	0	0	0	intergen
6	99826903	99827276	MACS_peak_17854	50.46	373	0	0	0	intergen
6	99971688	99972094	MACS_peak_17855	68.5	406	0	1	0	gen
6	100072288	100072550	MACS_peak_17856	93.4	262	0	0	1	other
6	100099429	100099755	MACS_peak_17857	670.69	326	0	0	0	intergen
6	100198497	100198748	MACS_peak_17858	63.75	251	0	0	0	intergen
6	100457937	100458154	MACS_peak_17860	746.04	217	0	1	0	gen
6	100524005	100524231	MACS_peak_17861	695.57	226	0	1	0	gen
6	100585966	100586271	MACS_peak_17862	222.27	305	0	1	0	gen
6	100608556	100608796	MACS_peak_17863	516.86	240	0	1	0	gen
6	100657820	100658003	MACS_peak_17864	843.77	183	0	1	0	gen
6	100664267	100664593	MACS_peak_17865	546.72	326	0	1	0	gen
6	100678126	100678386	MACS_peak_17866	862.05	260	0	1	0	gen
6	101098053	101098393	MACS_peak_17867	641.98	340	0	0	0	intergen
6	101874438	101874912	MACS_peak_17869	61.62	474	0	1	0	gen
6	101969749	101970020	MACS_peak_17870	460.22	271	0	1	0	gen
6	102373005	102373236	MACS_peak_17871	678.9	231	0	0	0	intergen
6	102725979	102726313	MACS_peak_17873	56.17	334	0	0	0	intergen
6	102752875	102753176	MACS_peak_17874	95.1	301	0	0	0	intergen
6	103203488	103203888	MACS_peak_17875	63.13	400	0	0	0	intergen
6	103252366	103252744	MACS_peak_17876	53.46	378	0	0	0	intergen
6	103797865	103798060	MACS_peak_17879	662.31	195	0	0	0	intergen
6	104001887	104002182	MACS_peak_17881	105.6	295	0	0	0	intergen
6	104095433	104095581	MACS_peak_17882	584.34	148	0	0	0	intergen
6	104223401	104223576	MACS_peak_17883	780.06	175	0	0	0	intergen
6	104325665	104325951	MACS_peak_17884	702.3	286	0	0	0	intergen
6	104376029	104376404	MACS_peak_17885	89.02	375	0	0	0	intergen
6	104391329	104391612	MACS_peak_17886	452.74	283	0	0	0	intergen
6	104527740	104528028	MACS_peak_17888	572.35	288	0	0	0	intergen
6	104668295	104668500	MACS_peak_17889	1134.84	205	0	0	0	intergen
6	104771309	104771618	MACS_peak_17890	1230.02	309	0	1	0	gen
6	105246429	105246847	MACS_peak_17892	160.82	418	0	0	0	intergen
6	105403497	105403791	MACS_peak_17893	488.85	294	0	0	0	intergen
6	105683823	105684172	MACS_peak_17894	160.72	349	0	0	1	other
6	106360348	106360610	MACS_peak_17896	452.71	262	1	0	0	promoter
6	106423592	106423957	MACS_peak_17897	229.83	365	0	1	0	gen
6	106839667	106840048	MACS_peak_17898	380.3	381	0	0	0	intergen
6	106997664	106997965	MACS_peak_17899	821.52	301	0	0	0	intergen
6	107887092	107887484	MACS_peak_17900	67.84	392	0	1	0	gen
6	108388274	108388607	MACS_peak_17902	86.65	333	0	1	0	gen
6	108515764	108516085	MACS_peak_17903	116.18	321	0	1	0	gen
6	108526679	108526986	MACS_peak_17904	951.22	307	0	0	0	intergen
6	109194228	109194516	MACS_peak_17905	178.37	288	0	0	1	other
6	109538435	109538711	MACS_peak_17906	50.69	276	0	1	0	gen
6	109595878	109596147	MACS_peak_17907	183.15	269	0	1	0	gen
6	109598884	109599300	MACS_peak_17908	72.76	416	0	1	0	gen
6	109649949	109650342	MACS_peak_17909	94.57	393	0	1	0	gen
6	109705196	109705464	MACS_peak_17910	587.27	268	0	1	0	gen
6	110039503	110039688	MACS_peak_17911	712.32	185	0	0	0	intergen
6	110046685	110047023	MACS_peak_17912	97.8	338	0	0	0	intergen
6	110056385	110056536	MACS_peak_17913	1813.76	151	0	0	0	intergen
6	110145199	110145487	MACS_peak_17915	58.9	288	0	1	0	gen
6	110454519	110454942	MACS_peak_17916	722.05	423	0	1	0	gen
6	110473395	110473543	MACS_peak_17917	698.1	148	0	1	0	gen
6	110806226	110806392	MACS_peak_17918	869.22	166	0	1	0	gen
6	110949783	110950102	MACS_peak_17919	934.53	319	0	0	0	intergen
6	110991281	110991440	MACS_peak_17920	781.6	159	0	1	0	gen
6	111057362	111057676	MACS_peak_17921	1516.12	314	0	0	0	intergen
6	111300460	111300721	MACS_peak_17922	724.45	261	1	0	0	promoter
6	111635845	111636273	MACS_peak_17923	131.22	428	0	0	0	intergen
6	111913692	111914044	MACS_peak_17924	415.24	352	0	0	0	intergen
6	112095457	112095756	MACS_peak_17925	312.33	299	0	1	0	gen
6	112163376	112163658	MACS_peak_17926	453.35	282	0	1	1	gen
6	112295956	112296393	MACS_peak_17927	486.55	437	0	1	1	gen
6	112451331	112451588	MACS_peak_17928	469.39	257	0	0	0	intergen
6	112502697	112502899	MACS_peak_17929	645.81	202	0	0	0	intergen
6	112707821	112708275	MACS_peak_17930	56.25	454	0	0	0	intergen
6	113380291	113380559	MACS_peak_17931	462.14	268	0	0	0	intergen
6	113397382	113397645	MACS_peak_17932	455.54	263	0	0	0	intergen
6	113531560	113531934	MACS_peak_17933	121.73	374	0	0	1	other
6	113534646	113534850	MACS_peak_17934	146.2	204	0	0	1	other
6	113859046	113859271	MACS_peak_17935	548.55	225	1	0	0	promoter
6	113909364	113909587	MACS_peak_17936	712.32	223	0	0	1	other
6	113936185	113936404	MACS_peak_17937	1785.17	219	1	0	0	promoter
6	113994913	113995190	MACS_peak_17938	983.22	277	0	1	1	gen
6	114748029	114748242	MACS_peak_17939	466.91	213	0	0	0	intergen
6	114864690	114864912	MACS_peak_17940	483.1	222	0	0	0	intergen
6	114918150	114918497	MACS_peak_17941	125.71	347	0	0	0	intergen
6	115176525	115176885	MACS_peak_17942	65.21	360	0	0	0	intergen
6	115545470	115545712	MACS_peak_17943	780.06	242	0	0	0	intergen
6	115567578	115567838	MACS_peak_17944	1002.97	260	0	0	0	intergen
6	115593991	115594374	MACS_peak_17945	108.39	383	0	0	0	intergen
6	115848751	115848924	MACS_peak_17946	760.34	173	0	0	0	intergen
6	116268598	116268949	MACS_peak_17948	779.13	351	0	1	0	gen
6	116350037	116350272	MACS_peak_17949	447.22	235	0	1	0	gen
6	116444145	116444507	MACS_peak_17950	1169.89	362	0	2	0	gen
6	116561300	116561682	MACS_peak_17951	401.26	382	0	0	0	intergen
6	116816446	116816756	MACS_peak_17952	125.66	310	0	1	0	gen
6	116820371	116820763	MACS_peak_17954	115.36	392	0	1	0	gen
6	116821573	116821951	MACS_peak_17955	51.32	378	0	1	0	gen
6	117097753	117098087	MACS_peak_17956	81.37	334	0	0	0	intergen
6	117317374	117317643	MACS_peak_17958	461.5	269	1	1	0	promoter
6	117346219	117346442	MACS_peak_17959	712.32	223	0	2	0	gen
6	117821699	117821857	MACS_peak_17960	279.72	158	0	0	0	intergen
6	117860449	117860602	MACS_peak_17961	768.65	153	0	0	0	intergen
6	117976156	117976395	MACS_peak_17962	954.29	239	0	1	0	gen
6	118508985	118509454	MACS_peak_17963	1152.38	469	0	1	0	gen
6	118551216	118551387	MACS_peak_17964	797.18	171	1	1	0	promoter
6	118796900	118797277	MACS_peak_17965	141.38	377	0	0	0	intergen
6	118962977	118963256	MACS_peak_17966	455.19	279	1	0	1	promoter
6	119333815	119333985	MACS_peak_17967	797.18	170	0	1	0	gen
6	119663216	119663460	MACS_peak_17968	740.73	244	0	0	0	intergen
6	119978404	119978629	MACS_peak_17969	548.55	225	0	0	0	intergen
6	120056647	120056859	MACS_peak_17970	592.85	212	0	0	0	intergen
6	120085525	120085932	MACS_peak_17971	128.02	407	0	0	0	intergen
6	120478346	120478606	MACS_peak_17972	467.38	260	0	0	0	intergen
6	120485711	120485961	MACS_peak_17973	1162.47	250	0	0	0	intergen
6	120502797	120503008	MACS_peak_17974	580.75	211	0	0	0	intergen
6	120690025	120690328	MACS_peak_17975	58.86	303	0	0	0	intergen
6	120692341	120692709	MACS_peak_17977	51.66	368	0	0	0	intergen
6	120692987	120693315	MACS_peak_17978	56.42	328	0	0	0	intergen
6	120750384	120750684	MACS_peak_17979	59.91	300	0	0	0	intergen
6	120823140	120823583	MACS_peak_17980	52.63	443	0	0	0	intergen
6	120890261	120890524	MACS_peak_17981	488.85	263	0	0	0	intergen
6	121163910	121164148	MACS_peak_17982	66.8	238	0	1	0	gen
6	121430430	121430681	MACS_peak_17983	611.88	251	0	0	0	intergen
6	121458939	121459191	MACS_peak_17984	309.73	252	0	0	0	intergen
6	121569643	121569893	MACS_peak_17985	133.19	250	0	0	0	intergen
6	121860654	121860786	MACS_peak_17986	1090.31	132	0	0	0	intergen
6	121966144	121966530	MACS_peak_17987	406.81	386	0	0	0	intergen
6	122381566	122381914	MACS_peak_17988	177.74	348	0	0	0	intergen
6	122475982	122476423	MACS_peak_17990	695.38	441	1	0	1	promoter
6	122726612	122726858	MACS_peak_17991	763.02	246	0	0	0	intergen
6	122730830	122731073	MACS_peak_17992	501.16	243	0	0	0	intergen
6	122762308	122762589	MACS_peak_17993	102.57	281	0	0	0	intergen
6	122802088	122802220	MACS_peak_17994	1090.31	132	0	1	0	gen
6	122838177	122838387	MACS_peak_17995	963	210	0	0	0	intergen
6	122947445	122947784	MACS_peak_17996	436.08	339	0	0	0	intergen
6	122990094	122990255	MACS_peak_17997	683.4	161	0	0	1	other
6	123013585	123013866	MACS_peak_17998	158.81	281	0	1	0	gen
6	123380340	123380613	MACS_peak_18000	458.95	273	0	1	0	gen
6	123777629	123777857	MACS_peak_18001	548.55	228	0	0	0	intergen
6	124616360	124616495	MACS_peak_18003	574.63	135	0	1	0	gen
6	124709297	124709630	MACS_peak_18004	55.64	333	0	1	0	gen
6	124712068	124712393	MACS_peak_18005	98.48	325	0	1	0	gen
6	124806995	124807183	MACS_peak_18006	113.3	188	0	1	0	gen
6	124855518	124855930	MACS_peak_18007	122.09	412	0	0	0	intergen
6	125040828	125041133	MACS_peak_18008	620.33	305	0	1	0	gen
6	125114213	125114590	MACS_peak_18009	1433.99	377	1	0	0	promoter
6	125153560	125153789	MACS_peak_18010	695.57	229	0	1	0	gen
6	125314137	125314378	MACS_peak_18011	571.15	241	0	0	0	intergen
6	125400880	125401340	MACS_peak_18012	203.1	460	0	0	1	other
6	125753675	125753914	MACS_peak_18013	516.86	239	0	1	0	gen
6	125773433	125773582	MACS_peak_18014	1035.47	149	0	0	0	intergen
6	125974362	125974719	MACS_peak_18015	1458.45	357	0	1	0	gen
6	125996006	125996270	MACS_peak_18016	590.39	264	0	1	0	gen
6	126282765	126283116	MACS_peak_18018	234.07	351	0	0	0	intergen
6	126676058	126676378	MACS_peak_18019	75.99	320	0	0	0	intergen
6	127070021	127070241	MACS_peak_18020	541.39	220	0	0	0	intergen
6	127190581	127190910	MACS_peak_18021	426.82	329	0	1	0	gen
6	127339206	127339460	MACS_peak_18022	596.79	254	0	1	0	gen
6	127464879	127465150	MACS_peak_18023	990.05	271	0	1	0	gen
6	127516645	127516966	MACS_peak_18024	937.36	321	1	2	0	promoter
6	127594925	127595234	MACS_peak_18025	53.37	309	0	0	0	intergen
6	127642148	127642359	MACS_peak_18026	936.57	211	0	0	0	intergen
6	127690143	127690492	MACS_peak_18027	532.67	349	0	0	0	intergen
6	127746730	127747146	MACS_peak_18028	732.46	416	0	1	0	gen
6	128554395	128554631	MACS_peak_18029	516.86	236	0	0	0	intergen
6	128623816	128624120	MACS_peak_18030	440.4	304	0	0	0	intergen
6	128749722	128749854	MACS_peak_18031	977.06	132	0	0	0	intergen
6	128877576	128877865	MACS_peak_18032	449.12	289	0	0	0	intergen
6	128983200	128983414	MACS_peak_18033	167.84	214	0	1	0	gen
6	129286594	129286901	MACS_peak_18034	265.34	307	0	1	0	gen
6	129370494	129370754	MACS_peak_18035	862.05	260	0	1	0	gen
6	129668362	129668556	MACS_peak_18038	848.95	194	0	1	0	gen
6	129678441	129678666	MACS_peak_18039	548.55	225	0	1	0	gen
6	129730583	129730844	MACS_peak_18041	466.72	261	0	0	0	intergen
6	130282339	130282541	MACS_peak_18042	814.37	202	0	1	0	gen
6	130308145	130308508	MACS_peak_18043	644.81	363	0	1	0	gen
6	130322762	130322993	MACS_peak_18044	678.9	231	0	1	0	gen
6	130348727	130348924	MACS_peak_18045	122.27	197	0	1	0	gen
6	130543979	130544325	MACS_peak_18046	110.13	346	0	0	0	intergen
6	130698013	130698338	MACS_peak_18047	547.36	325	0	0	0	intergen
6	130872152	130872550	MACS_peak_18048	870.72	398	0	1	0	gen
6	130885312	130885643	MACS_peak_18049	667.02	331	0	1	0	gen
6	131090659	131090911	MACS_peak_18050	74.49	252	0	0	0	intergen
6	131207288	131207518	MACS_peak_18051	663.53	230	0	1	0	gen
6	131460067	131460368	MACS_peak_18052	442.11	301	0	0	0	intergen
6	131628212	131628496	MACS_peak_18053	575.25	284	1	0	0	promoter
6	131856244	131856716	MACS_peak_18054	51.32	472	0	1	0	gen
6	131915117	131915535	MACS_peak_18055	1828.14	418	0	0	1	other
6	132218139	132218389	MACS_peak_18056	485.56	250	0	0	0	intergen
6	132530481	132530789	MACS_peak_18057	558.46	308	0	0	0	intergen
6	132533887	132534123	MACS_peak_18058	438.57	236	1	0	0	promoter
6	132578558	132578759	MACS_peak_18059	645.81	201	0	0	0	intergen
6	132929001	132929295	MACS_peak_18060	265.34	294	0	0	0	intergen
6	132968648	132968867	MACS_peak_18061	580.62	219	0	0	0	intergen
6	133142641	133142905	MACS_peak_18062	52.99	264	0	0	0	intergen
6	133178738	133178963	MACS_peak_18064	712.32	225	0	0	0	intergen
6	133184915	133185159	MACS_peak_18065	506.68	244	0	0	0	intergen
6	133568869	133569190	MACS_peak_18066	1506.2	321	0	0	1	other
6	133837854	133838038	MACS_peak_18068	729.14	184	0	0	2	other
6	133921326	133921619	MACS_peak_18069	568.79	293	0	0	0	intergen
6	133924008	133924278	MACS_peak_18070	460.86	270	0	0	0	intergen
6	134132023	134132334	MACS_peak_18071	118	311	0	0	0	intergen
6	134136764	134137097	MACS_peak_18072	93.4	333	0	0	0	intergen
6	134823001	134823260	MACS_peak_18074	863.12	259	0	0	0	intergen
6	134907359	134907669	MACS_peak_18075	437.04	310	0	0	0	intergen
6	135012308	135012573	MACS_peak_18076	1141.07	265	0	1	0	gen
6	135084601	135084844	MACS_peak_18077	501.16	243	0	1	0	gen
6	135131830	135132064	MACS_peak_18078	520.43	234	0	0	0	intergen
6	135463058	135463226	MACS_peak_18079	814.37	168	0	1	0	gen
6	135506229	135506575	MACS_peak_18080	493.79	346	0	0	1	other
6	135535907	135536210	MACS_peak_18081	688.35	303	0	0	1	other
6	135909886	135910082	MACS_peak_18082	848.95	196	0	1	0	gen
6	135980178	135980560	MACS_peak_18083	50.4	382	0	1	0	gen
6	136032087	136032299	MACS_peak_18084	698.01	212	0	1	1	gen
6	136226230	136226544	MACS_peak_18085	1102.85	314	1	0	0	promoter
6	136317135	136317420	MACS_peak_18086	684.48	285	0	0	0	intergen
6	136391155	136391371	MACS_peak_18087	162.75	216	0	1	0	gen
6	136547411	136547696	MACS_peak_18088	836.63	285	0	1	0	gen
6	136583072	136583280	MACS_peak_18089	780.06	208	0	1	0	gen
6	136608201	136608473	MACS_peak_18090	488.85	272	0	1	0	gen
6	136846134	136846376	MACS_peak_18091	212.16	242	0	1	0	gen
6	136849087	136849561	MACS_peak_18092	51.32	474	0	1	0	gen
6	136933006	136933138	MACS_peak_18093	1116.4	132	0	0	0	intergen
6	136968259	136968471	MACS_peak_18094	763.02	212	0	0	0	intergen
6	137013858	137014177	MACS_peak_18095	551.21	319	0	1	0	gen
6	137136136	137136389	MACS_peak_18096	398.97	253	0	0	0	intergen
6	137199314	137199578	MACS_peak_18097	857.82	264	1	0	0	promoter
6	137202144	137202378	MACS_peak_18098	532.66	234	1	0	0	promoter
6	137314356	137314628	MACS_peak_18099	584.2	272	0	0	0	intergen
6	137448128	137448433	MACS_peak_18100	668.12	305	0	0	0	intergen
6	137615678	137615889	MACS_peak_18101	596.79	211	0	0	0	intergen
6	137939850	137940222	MACS_peak_18102	405.79	372	0	0	0	intergen
6	137985265	137985542	MACS_peak_18103	66.65	277	0	0	0	intergen
6	138109494	138109742	MACS_peak_18104	613.04	248	0	0	0	intergen
6	138692263	138692517	MACS_peak_18105	470.06	254	0	1	0	gen
6	138766041	138766288	MACS_peak_18106	485.56	247	0	1	0	gen
6	138816159	138816412	MACS_peak_18107	682.16	253	0	1	0	gen
6	139213292	139213602	MACS_peak_18108	56.49	310	0	0	2	other
6	139250690	139250960	MACS_peak_18109	460.86	270	0	1	1	gen
6	140603884	140604293	MACS_peak_18110	862.29	409	0	0	1	other
6	140605389	140605697	MACS_peak_18111	127.5	308	0	0	1	other
6	140681431	140681778	MACS_peak_18112	275.23	347	0	0	1	other
6	140749333	140749579	MACS_peak_18114	485.56	246	0	0	1	other
6	140777421	140777683	MACS_peak_18115	1069.92	262	0	0	1	other
6	140868490	140868774	MACS_peak_18116	158.81	284	0	0	1	other
6	140930941	140931198	MACS_peak_18117	469.39	257	0	0	0	intergen
6	141196285	141196421	MACS_peak_18118	1647.16	136	0	0	0	intergen
6	141234941	141235276	MACS_peak_18119	61.85	335	0	0	0	intergen
6	141416556	141416809	MACS_peak_18120	583.31	253	0	0	0	intergen
6	141562799	141563179	MACS_peak_18121	224.66	380	0	0	0	intergen
6	141571634	141571904	MACS_peak_18122	69.48	270	0	0	0	intergen
6	141677608	141677884	MACS_peak_18123	412.45	276	0	0	0	intergen
6	141678482	141678711	MACS_peak_18124	548.55	229	0	0	0	intergen
6	141815345	141815747	MACS_peak_18125	135.42	402	0	0	0	intergen
6	141917965	141918304	MACS_peak_18126	52.67	339	0	0	0	intergen
6	142003859	142004255	MACS_peak_18127	1002.36	396	0	0	0	intergen
6	142146938	142147234	MACS_peak_18128	445	296	1	0	0	promoter
6	142188450	142188622	MACS_peak_18129	690.17	172	0	1	0	gen
6	142445384	142445629	MACS_peak_18131	1061.85	245	0	1	0	gen
6	142474583	142475037	MACS_peak_18132	830.09	454	0	0	0	intergen
6	142566854	142567060	MACS_peak_18133	629.38	206	0	0	1	other
6	142692810	142693157	MACS_peak_18134	347.51	347	0	0	0	intergen
6	143427186	143427545	MACS_peak_18135	647.47	359	1	0	0	promoter
6	143941977	143942380	MACS_peak_18136	503.12	403	1	0	0	promoter
6	144013496	144013744	MACS_peak_18137	813.44	248	0	1	0	gen
6	144216168	144216552	MACS_peak_18138	513.02	384	0	0	0	intergen
6	144581843	144582177	MACS_peak_18139	541.72	334	0	1	0	gen
6	145299900	145300213	MACS_peak_18140	69	313	0	0	1	other
6	145503236	145503549	MACS_peak_18141	67.1	313	0	1	0	gen
6	145666286	145666685	MACS_peak_18142	68.17	399	0	1	0	gen
6	145679846	145680116	MACS_peak_18143	758.81	270	0	1	0	gen
6	145704255	145704490	MACS_peak_18144	1201.14	235	0	1	0	gen
6	146522885	146523189	MACS_peak_18146	92.72	304	0	0	0	intergen
6	146638309	146638650	MACS_peak_18147	301.88	341	0	1	0	gen
6	146700188	146700443	MACS_peak_18148	456.71	255	0	1	0	gen
6	146818572	146818710	MACS_peak_18149	911.62	138	0	0	0	intergen
6	146866583	146866893	MACS_peak_18150	557.12	310	0	0	1	other
6	146902482	146902691	MACS_peak_18151	771.58	209	0	0	1	other
6	147391039	147391256	MACS_peak_18152	580.62	217	0	0	0	intergen
6	148179896	148180291	MACS_peak_18153	507.23	395	0	0	0	intergen
6	148464930	148465093	MACS_peak_18154	848.95	163	0	1	0	gen
6	148738180	148738530	MACS_peak_18155	653.58	350	0	0	0	intergen
6	148738573	148738950	MACS_peak_18156	488.85	377	0	0	0	intergen
6	149354008	149354256	MACS_peak_18158	1511.13	248	0	1	0	gen
6	149680632	149680764	MACS_peak_18159	1116.4	132	0	1	0	gen
6	149723852	149724121	MACS_peak_18160	842.54	269	1	0	0	promoter
6	150387255	150387452	MACS_peak_18161	831.63	197	0	1	0	gen
6	150419126	150419346	MACS_peak_18162	883.81	220	0	0	0	intergen
6	150473213	150473387	MACS_peak_18163	457.43	174	0	0	0	intergen
6	150475837	150476261	MACS_peak_18164	137.47	424	0	0	0	intergen
6	150955482	150955623	MACS_peak_18165	1025.76	141	0	1	0	gen
6	151324222	151324550	MACS_peak_18166	1207.34	328	0	1	0	gen
6	151363978	151364257	MACS_peak_18167	312.33	279	1	0	0	promoter
6	151406047	151406400	MACS_peak_18168	651.52	353	1	0	0	promoter
6	151568650	151568910	MACS_peak_18169	406.81	260	0	1	0	gen
6	151847380	151847696	MACS_peak_18170	89.02	316	0	1	0	gen
6	152209139	152209469	MACS_peak_18172	459.5	330	0	1	0	gen
6	152268388	152268520	MACS_peak_18173	1116.4	132	0	1	0	gen
6	152273860	152274242	MACS_peak_18174	380.3	382	0	1	0	gen
6	152338366	152338822	MACS_peak_18175	590.18	456	0	1	0	gen
6	152552591	152552985	MACS_peak_18176	507.75	394	0	1	0	gen
6	152748887	152749061	MACS_peak_18177	780.06	174	1	0	0	promoter
6	152751127	152751383	MACS_peak_18178	603.02	256	1	0	0	promoter
6	152953210	152953431	MACS_peak_18179	729.14	221	0	0	0	intergen
6	153067270	153067524	MACS_peak_18180	470.06	254	0	1	0	gen
6	153084079	153084271	MACS_peak_18181	651.85	192	0	1	0	gen
6	153231049	153231347	MACS_peak_18182	1100.44	298	0	0	0	intergen
6	153401344	153401611	MACS_peak_18183	347.01	267	0	0	0	intergen
6	153692458	153692830	MACS_peak_18184	51.06	372	0	0	0	intergen
6	153947852	153948149	MACS_peak_18185	825.22	297	0	0	0	intergen
6	154154369	154154729	MACS_peak_18186	722.05	360	1	1	0	promoter
6	154273647	154273893	MACS_peak_18187	115.21	246	0	1	0	gen
6	154277256	154277615	MACS_peak_18188	1173.05	359	0	1	0	gen
6	154357581	154357860	MACS_peak_18189	380.3	279	0	0	0	intergen
6	154577331	154577470	MACS_peak_18190	1043.77	139	0	0	0	intergen
6	154675605	154675912	MACS_peak_18191	685.18	307	0	0	0	intergen
6	154805389	154805659	MACS_peak_18192	697.55	270	0	1	0	gen
6	155187474	155187823	MACS_peak_18193	312.33	349	0	1	0	gen
6	156034675	156035023	MACS_peak_18195	58.66	348	0	0	0	intergen
6	156039095	156039513	MACS_peak_18196	84.1	418	0	0	0	intergen
6	156129380	156129616	MACS_peak_18197	972.07	236	0	0	0	intergen
6	156170274	156170429	MACS_peak_18198	986.75	155	0	0	0	intergen
6	156330331	156330661	MACS_peak_18199	70.12	330	0	0	0	intergen
6	157045983	157046201	MACS_peak_18200	580.62	218	0	1	0	gen
6	157342006	157342233	MACS_peak_18201	186.93	227	0	0	0	intergen
6	157993706	157993935	MACS_peak_18202	712.57	229	0	1	0	gen
6	158444142	158444357	MACS_peak_18204	681.39	215	0	1	0	gen
6	158522308	158522446	MACS_peak_18205	630.2	138	0	0	0	intergen
6	158756526	158756757	MACS_peak_18206	313.77	231	0	1	0	gen
6	158972563	158972814	MACS_peak_18207	613.04	251	1	0	0	promoter
6	160100627	160100895	MACS_peak_18210	2187.09	268	0	1	0	gen
6	160653858	160654191	MACS_peak_18211	950.42	333	0	1	0	gen
6	160684156	160684463	MACS_peak_18212	57.5	307	0	0	0	intergen
6	160733044	160733489	MACS_peak_18213	482.85	445	0	1	0	gen
6	161874634	161875007	MACS_peak_18215	518.99	373	0	1	0	gen
6	161884977	161885125	MACS_peak_18216	831.12	148	0	1	0	gen
6	161982415	161982889	MACS_peak_18217	54.64	474	0	1	0	gen
6	162553793	162553942	MACS_peak_18219	722.16	149	0	1	0	gen
6	162992495	162992866	MACS_peak_18220	50.57	371	0	1	0	gen
6	164145822	164145966	MACS_peak_18221	973.38	144	0	0	0	intergen
6	164627883	164628361	MACS_peak_18222	1618.75	478	0	0	0	intergen
6	165032989	165033131	MACS_peak_18224	877.38	142	0	0	0	intergen
6	165123933	165124226	MACS_peak_18225	120.31	293	0	0	0	intergen
6	165369466	165369897	MACS_peak_18226	123.2	431	0	1	0	gen
6	166641616	166641967	MACS_peak_18229	229.83	351	0	1	0	gen
6	166793966	166794261	MACS_peak_18230	137.06	295	0	1	0	gen
6	166890243	166890439	MACS_peak_18231	247.08	196	0	2	0	gen
6	167045907	167046178	MACS_peak_18232	584.96	271	0	1	1	gen
6	167182881	167183161	MACS_peak_18233	454.58	280	0	1	0	gen
6	167264052	167264288	MACS_peak_18234	332.58	236	0	0	0	intergen
6	167371923	167372203	MACS_peak_18235	454.58	280	0	1	0	gen
6	168115738	168116017	MACS_peak_18236	578.93	279	0	0	0	intergen
6	168974997	168975265	MACS_peak_18237	137.17	268	0	0	0	intergen
6	168999380	168999512	MACS_peak_18238	1116.4	132	0	0	0	intergen
6	169032816	169033093	MACS_peak_18239	50.92	277	0	0	0	intergen
6	169358368	169358646	MACS_peak_18240	66.26	278	0	0	0	intergen
6	169644935	169645133	MACS_peak_18241	451.06	198	0	2	0	gen
6	169831535	169831917	MACS_peak_18242	388.11	382	0	0	0	intergen
6	170466036	170466462	MACS_peak_18243	260.52	426	0	0	0	intergen
6	170517072	170517321	MACS_peak_18244	485.56	249	0	0	0	intergen
6	170575144	170575523	MACS_peak_18245	634.44	379	1	0	0	promoter
6	170641355	170641751	MACS_peak_18246	839.74	396	0	0	0	intergen
6	170660554	170660865	MACS_peak_18248	92.81	311	0	0	0	intergen
6	170663988	170664251	MACS_peak_18249	328.79	263	0	0	0	intergen
6	170691641	170691926	MACS_peak_18250	1040.99	285	0	0	0	intergen
6	170736310	170736708	MACS_peak_18253	1088.93	398	0	0	1	other
6	101153	101441	MACS_peak_21987	449.72	288	0	0	0	intergen
6	104710	105106	MACS_peak_21988	1411.94	396	0	0	0	intergen
6	129892	130230	MACS_peak_21989	422.19	338	0	0	0	intergen
6	148356	148575	MACS_peak_21990	901.33	219	0	0	0	intergen
6	157194	157554	MACS_peak_21991	526.85	360	0	0	0	intergen
7	25120	25441	MACS_peak_18256	402.95	321	0	0	2	other
7	31251	31469	MACS_peak_18257	752.94	218	0	0	1	other
7	64078	64362	MACS_peak_18258	452.13	284	0	0	0	intergen
7	393337	393643	MACS_peak_18260	81.2	306	0	0	0	intergen
7	394258	394533	MACS_peak_18261	60.37	275	0	0	0	intergen
7	873315	873606	MACS_peak_18262	447.93	291	1	1	0	promoter
7	944080	944486	MACS_peak_18263	485.8	406	0	2	0	gen
7	1135857	1136239	MACS_peak_18264	401.26	382	0	1	0	gen
7	1169935	1170225	MACS_peak_18265	831.82	290	0	0	0	intergen
7	1176985	1177321	MACS_peak_18266	406.81	336	0	0	0	intergen
7	1193957	1194221	MACS_peak_18267	590.39	264	0	0	0	intergen
7	1203641	1203973	MACS_peak_18268	229.83	332	0	0	0	intergen
7	1213781	1214197	MACS_peak_18269	496.62	416	0	0	0	intergen
7	1412812	1413116	MACS_peak_18271	687.55	304	0	0	0	intergen
7	1432483	1432757	MACS_peak_18272	458.32	274	1	0	0	promoter
7	1519285	1519637	MACS_peak_18273	149.97	352	0	0	0	intergen
7	1996063	1996381	MACS_peak_18274	432.66	318	0	1	0	gen
7	2247250	2247478	MACS_peak_18275	848.95	228	1	1	0	promoter
7	2348053	2348350	MACS_peak_18276	316.38	297	0	1	0	gen
7	2364908	2365161	MACS_peak_18277	409.01	253	0	1	0	gen
7	2367720	2367866	MACS_peak_18278	1170.45	146	0	1	0	gen
7	2578880	2579059	MACS_peak_18279	898.14	179	0	1	0	gen
7	2691025	2691159	MACS_peak_18280	1377.21	134	0	1	0	gen
7	2748427	2748757	MACS_peak_18281	78.78	330	0	2	0	gen
7	2886992	2887253	MACS_peak_18282	592.77	261	0	0	0	intergen
7	3065382	3065539	MACS_peak_18283	1377.21	157	0	0	0	intergen
7	3124092	3124451	MACS_peak_18284	142.18	359	0	0	0	intergen
7	3132121	3132532	MACS_peak_18285	611.86	411	0	0	0	intergen
7	3154959	3155228	MACS_peak_18286	717.14	269	0	0	1	other
7	3208541	3208711	MACS_peak_18287	1245.57	170	0	0	0	intergen
7	3673534	3673834	MACS_peak_18288	563.9	300	0	1	0	gen
7	3678944	3679128	MACS_peak_18289	727.32	184	0	1	0	gen
7	3705194	3705579	MACS_peak_18290	500.74	385	0	1	0	gen
7	3852538	3852880	MACS_peak_18292	158.81	342	0	1	0	gen
7	3897514	3897748	MACS_peak_18293	814.37	234	0	1	0	gen
7	4254077	4254321	MACS_peak_18294	476.59	244	0	1	0	gen
7	4409742	4410114	MACS_peak_18296	488.85	372	0	0	0	intergen
7	4830232	4830415	MACS_peak_18299	666.39	183	0	1	0	gen
7	4845932	4846290	MACS_peak_18300	380.3	358	0	1	0	gen
7	4973704	4974088	MACS_peak_18301	509.87	384	0	0	0	intergen
7	5002417	5002600	MACS_peak_18302	729.14	183	0	1	1	gen
7	5085542	5085877	MACS_peak_18303	601.83	335	0	0	0	intergen
7	5486976	5487240	MACS_peak_18305	464.74	264	0	1	0	gen
7	5494654	5494906	MACS_peak_18306	746.04	252	0	1	0	gen
7	5611085	5611400	MACS_peak_18307	634.13	315	0	0	0	intergen
7	5665459	5665694	MACS_peak_18308	440.38	235	0	1	1	gen
7	5704499	5704730	MACS_peak_18309	678.9	231	0	1	0	gen
7	5747681	5747881	MACS_peak_18310	1075.85	200	0	1	0	gen
7	5827791	5828264	MACS_peak_18311	3100	473	0	0	1	other
7	5997256	5997542	MACS_peak_18312	357.56	286	0	1	0	gen
7	6007521	6007768	MACS_peak_18313	482.84	247	1	1	0	promoter
7	6149472	6149619	MACS_peak_18314	972.07	147	0	1	0	gen
7	6313607	6314051	MACS_peak_18315	348.12	444	0	0	0	intergen
7	6322940	6323271	MACS_peak_18316	1492.41	331	0	0	0	intergen
7	6348968	6349393	MACS_peak_18317	545.23	425	0	0	0	intergen
7	6435640	6435918	MACS_peak_18318	627.32	278	0	1	0	gen
7	6455211	6455352	MACS_peak_18319	816.83	141	0	2	0	gen
7	6516383	6516600	MACS_peak_18320	746.04	217	0	1	0	gen
7	6558941	6559145	MACS_peak_18321	629.38	204	0	0	0	intergen
7	6572116	6572273	MACS_peak_18322	794.19	157	0	0	0	intergen
7	6574580	6574882	MACS_peak_18323	441.54	302	1	0	0	promoter
7	6745453	6745589	MACS_peak_18324	977.68	136	0	0	1	other
7	6871920	6872187	MACS_peak_18325	462.79	267	0	0	0	intergen
7	6930798	6931146	MACS_peak_18326	1469.91	348	0	0	0	intergen
7	6932424	6932560	MACS_peak_18327	847.14	136	0	0	1	other
7	6938376	6938715	MACS_peak_18328	655.21	339	0	0	1	other
7	6953195	6953669	MACS_peak_18329	1420.71	474	0	0	0	intergen
7	7021589	7021833	MACS_peak_18330	426.48	244	0	0	0	intergen
7	7142061	7142429	MACS_peak_18331	91.07	368	0	0	0	intergen
7	7313658	7313940	MACS_peak_18332	137.51	282	0	0	0	intergen
7	7424409	7424640	MACS_peak_18333	989.9	231	0	1	0	gen
7	7595386	7595854	MACS_peak_18334	784.97	468	0	1	0	gen
7	7678394	7678854	MACS_peak_18335	978.69	460	0	2	1	gen
7	7680595	7680985	MACS_peak_18337	567.67	390	0	2	1	gen
7	8035854	8036292	MACS_peak_18338	486.08	438	0	1	0	gen
7	8090753	8091063	MACS_peak_18339	541.17	310	0	1	0	gen
7	8436968	8437151	MACS_peak_18341	1549.78	183	1	0	0	promoter
7	8923609	8923812	MACS_peak_18342	629.38	203	0	0	0	intergen
7	8957531	8957858	MACS_peak_18343	64.79	327	0	0	0	intergen
7	9203099	9203320	MACS_peak_18344	738.36	221	0	0	0	intergen
7	9761975	9762291	MACS_peak_18347	845.32	316	0	0	1	other
7	9844064	9844412	MACS_peak_18348	81.23	348	0	0	0	intergen
7	9988998	9989255	MACS_peak_18349	400.76	257	0	0	0	intergen
7	10275340	10275770	MACS_peak_18351	93.78	430	0	0	0	intergen
7	10412484	10412766	MACS_peak_18352	453.35	282	0	0	0	intergen
7	11053384	11053629	MACS_peak_18353	896.52	245	0	1	0	gen
7	11427721	11427980	MACS_peak_18355	468.05	259	0	1	1	gen
7	11457292	11457538	MACS_peak_18356	756.38	246	0	1	1	gen
7	11664062	11664393	MACS_peak_18357	667.02	331	0	1	0	gen
7	12102475	12102758	MACS_peak_18358	452.74	283	0	0	0	intergen
7	12182330	12182722	MACS_peak_18359	50.58	392	0	0	0	intergen
7	12322356	12322591	MACS_peak_18360	662.31	235	0	0	0	intergen
7	12348138	12348396	MACS_peak_18361	84.98	258	0	1	0	gen
7	12453203	12453484	MACS_peak_18362	66.96	281	0	0	0	intergen
7	12496865	12497246	MACS_peak_18363	195.32	381	0	1	0	gen
7	12500773	12501177	MACS_peak_18364	90.89	404	0	1	0	gen
7	12524841	12525198	MACS_peak_18365	648.81	357	0	1	0	gen
7	12526930	12527381	MACS_peak_18366	553.12	451	0	1	0	gen
7	12527544	12527934	MACS_peak_18367	541.64	390	0	1	0	gen
7	12623917	12624272	MACS_peak_18369	413.79	355	0	1	0	gen
7	12658967	12659278	MACS_peak_18370	380.3	311	0	1	0	gen
7	12676969	12677295	MACS_peak_18371	245.93	326	0	0	0	intergen
7	12685595	12685924	MACS_peak_18372	796.97	329	1	0	0	promoter
7	12686701	12686922	MACS_peak_18373	564.54	221	1	0	0	promoter
7	13085680	13086014	MACS_peak_18374	50.31	334	0	0	1	other
7	13087410	13087781	MACS_peak_18375	90.49	371	0	0	1	other
7	13263009	13263258	MACS_peak_18376	485.56	249	0	0	1	other
7	13282449	13282647	MACS_peak_18377	1025.76	198	0	0	1	other
7	13293652	13293924	MACS_peak_18378	584.2	272	0	0	1	other
7	13381084	13381328	MACS_peak_18379	457.21	244	0	0	1	other
7	13525142	13525364	MACS_peak_18380	482.68	222	0	0	1	other
7	13809164	13809581	MACS_peak_18381	198.81	417	0	0	0	intergen
7	13819293	13819714	MACS_peak_18382	386.65	421	0	0	0	intergen
7	14457845	14458133	MACS_peak_18383	536.7	288	0	1	0	gen
7	14648925	14649232	MACS_peak_18385	59.31	307	0	1	0	gen
7	14691704	14691965	MACS_peak_18386	996.98	261	0	1	0	gen
7	14705933	14706238	MACS_peak_18387	51.39	305	0	1	0	gen
7	15067856	15068066	MACS_peak_18388	388.76	210	0	0	1	other
7	15322361	15322759	MACS_peak_18389	3100	398	0	1	0	gen
7	15326102	15326332	MACS_peak_18390	966.16	230	0	1	0	gen
7	15711924	15712168	MACS_peak_18391	629.38	244	0	0	0	intergen
7	15720928	15721210	MACS_peak_18392	705.71	282	0	0	0	intergen
7	16078117	16078439	MACS_peak_18393	430.51	322	0	0	0	intergen
7	16098626	16098926	MACS_peak_18394	812.39	300	0	1	0	gen
7	16198429	16198736	MACS_peak_18395	188.8	307	0	1	0	gen
7	16219186	16219578	MACS_peak_18396	82.03	392	0	1	1	gen
7	16516318	16516545	MACS_peak_18397	695.57	227	0	1	0	gen
7	16801180	16801453	MACS_peak_18398	458.95	273	0	1	0	gen
7	16892834	16893067	MACS_peak_18399	647.86	233	0	0	0	intergen
7	16918323	16918668	MACS_peak_18400	405.47	345	1	0	0	promoter
7	16982673	16982896	MACS_peak_18401	3100.17	223	0	1	1	gen
7	17050491	17050923	MACS_peak_18402	180.8	432	0	1	1	gen
7	17063079	17063326	MACS_peak_18403	629.38	247	0	1	1	gen
7	17097196	17097328	MACS_peak_18404	1116.4	132	0	1	1	gen
7	17219470	17219794	MACS_peak_18405	91.93	324	0	1	1	gen
7	17498091	17498224	MACS_peak_18406	1098.16	133	0	0	1	other
7	17542837	17543069	MACS_peak_18407	559.6	232	0	0	1	other
7	17640752	17641044	MACS_peak_18408	697.28	292	0	0	0	intergen
7	17803878	17804097	MACS_peak_18409	580.62	219	0	1	0	gen
7	18352382	18352568	MACS_peak_18410	901.33	186	0	1	0	gen
7	18356119	18356553	MACS_peak_18411	487.96	434	0	1	0	gen
7	18989239	18989617	MACS_peak_18412	77.26	378	0	1	0	gen
7	19122076	19122268	MACS_peak_18414	678.9	192	0	0	0	intergen
7	19140137	19140373	MACS_peak_18415	516.86	236	1	0	0	promoter
7	19197799	19198214	MACS_peak_18416	110.72	415	0	0	0	intergen
7	19396816	19397041	MACS_peak_18417	712.32	225	0	0	1	other
7	20278445	20278842	MACS_peak_18418	453.27	397	0	0	0	intergen
7	20440688	20441053	MACS_peak_18420	306.6	365	0	0	0	intergen
7	20538426	20538746	MACS_peak_18422	55.02	320	0	0	0	intergen
7	20598624	20598998	MACS_peak_18423	404.88	374	0	0	0	intergen
7	20993460	20993688	MACS_peak_18424	548.55	228	0	0	2	other
7	21353414	21353679	MACS_peak_18425	380.3	265	0	0	0	intergen
7	21372544	21372860	MACS_peak_18426	722.05	316	0	0	0	intergen
7	21412656	21412972	MACS_peak_18427	406.81	316	0	0	0	intergen
7	21620972	21621366	MACS_peak_18428	56.55	394	0	1	0	gen
7	22001498	22001748	MACS_peak_18430	485.56	250	0	0	0	intergen
7	22082974	22083208	MACS_peak_18431	532.66	234	0	0	0	intergen
7	22311621	22311899	MACS_peak_18432	455.81	278	0	1	0	gen
7	22487702	22487846	MACS_peak_18433	1264.23	144	0	1	0	gen
7	22523993	22524211	MACS_peak_18434	521.39	218	0	1	0	gen
7	22533170	22533629	MACS_peak_18435	79.16	459	0	1	0	gen
7	22559910	22560300	MACS_peak_18436	1418.79	390	0	1	0	gen
7	22618162	22618583	MACS_peak_18437	1112.7	421	0	1	0	gen
7	22644765	22644917	MACS_peak_18438	1413.94	152	0	1	0	gen
7	22799192	22799447	MACS_peak_18439	284.58	255	0	0	0	intergen
7	23039340	23039787	MACS_peak_18441	67.97	447	0	0	0	intergen
7	23045365	23045570	MACS_peak_18442	277.98	205	0	0	0	intergen
7	23086115	23086454	MACS_peak_18443	349.84	339	0	0	0	intergen
7	23185023	23185363	MACS_peak_18444	660.56	340	1	0	0	promoter
7	23273200	23273558	MACS_peak_18445	399.16	358	0	1	0	gen
7	23283109	23283355	MACS_peak_18446	629.38	246	0	0	0	intergen
7	23547011	23547251	MACS_peak_18447	637.77	240	0	0	0	intergen
7	23679918	23680233	MACS_peak_18448	553.81	315	1	0	0	promoter
7	23825951	23826170	MACS_peak_18449	133.06	219	0	1	0	gen
7	23863179	23863475	MACS_peak_18450	693.99	296	0	0	0	intergen
7	23949874	23950253	MACS_peak_18451	63.13	379	0	0	0	intergen
7	24002481	24002694	MACS_peak_18452	68.28	213	0	0	0	intergen
7	24100846	24101110	MACS_peak_18453	72	264	0	0	0	intergen
7	24400809	24401168	MACS_peak_18454	190.34	359	0	0	0	intergen
7	24430569	24430876	MACS_peak_18455	368.13	307	0	0	0	intergen
7	24583849	24584237	MACS_peak_18456	85.8	388	0	1	0	gen
7	25070059	25070301	MACS_peak_18457	815.2	242	0	0	0	intergen
7	25094244	25094617	MACS_peak_18458	465.93	373	0	0	0	intergen
7	25098465	25098740	MACS_peak_18459	1244.99	275	0	0	0	intergen
7	25105603	25105893	MACS_peak_18460	445.88	290	0	0	0	intergen
7	25216830	25217110	MACS_peak_18461	707.43	280	0	0	0	intergen
7	25565930	25566335	MACS_peak_18462	739.81	405	0	0	0	intergen
7	25568967	25569146	MACS_peak_18463	644.42	179	0	0	0	intergen
7	25606772	25607223	MACS_peak_18464	68.97	451	0	0	1	other
7	25851678	25851960	MACS_peak_18466	453.35	282	0	0	0	intergen
7	25925710	25926179	MACS_peak_18467	100.89	469	0	0	0	intergen
7	26198187	26198551	MACS_peak_18468	409.51	364	1	1	0	promoter
7	26667560	26667892	MACS_peak_18469	425.26	332	1	0	0	promoter
7	26813968	26814269	MACS_peak_18470	803.95	301	0	1	0	gen
7	26853848	26854186	MACS_peak_18471	608.12	338	0	1	0	gen
7	26955369	26955728	MACS_peak_18472	201.59	359	0	1	0	gen
7	27143716	27144005	MACS_peak_18473	449.12	289	2	1	2	promoter
7	27150844	27151115	MACS_peak_18474	850.57	271	1	1	3	promoter
7	27179592	27179975	MACS_peak_18475	380.3	383	1	2	0	promoter
7	27743674	27743819	MACS_peak_18477	1265.84	145	1	0	0	promoter
7	27921328	27921506	MACS_peak_18478	954.29	178	0	1	0	gen
7	27986275	27986551	MACS_peak_18479	137.06	276	0	1	0	gen
7	28078309	28078633	MACS_peak_18480	547.99	324	0	1	0	gen
7	28134463	28134634	MACS_peak_18481	1226.97	171	0	1	0	gen
7	28389475	28389730	MACS_peak_18482	729.14	255	0	1	0	gen
7	28927090	28927347	MACS_peak_18483	469.39	257	0	0	0	intergen
7	29387830	29388085	MACS_peak_18484	470.06	255	0	2	0	gen
7	29589260	29589560	MACS_peak_18485	279.72	300	0	0	0	intergen
7	29878059	29878364	MACS_peak_18486	1234.98	305	0	1	0	gen
7	30509268	30509632	MACS_peak_18487	769.12	364	0	1	0	gen
7	30625403	30625685	MACS_peak_18488	576.71	282	0	1	0	gen
7	30641401	30641745	MACS_peak_18489	57.62	344	0	0	0	intergen
7	30800699	30801030	MACS_peak_18490	927.83	331	0	2	1	gen
7	30821178	30821476	MACS_peak_18491	611.86	298	0	2	0	gen
7	31091233	31091545	MACS_peak_18492	435.94	312	0	1	0	gen
7	31225491	31225720	MACS_peak_18493	1171.45	229	0	0	0	intergen
7	31471518	31471860	MACS_peak_18494	189.5	342	0	0	0	intergen
7	31503357	31503677	MACS_peak_18495	59.3	320	0	0	0	intergen
7	31504900	31505267	MACS_peak_18496	166.09	367	0	0	0	intergen
7	31621669	31621945	MACS_peak_18498	81.45	276	0	1	0	gen
7	31624108	31624537	MACS_peak_18499	117.4	429	0	1	0	gen
7	31633962	31634250	MACS_peak_18500	936.93	288	0	1	0	gen
7	31736454	31736709	MACS_peak_18501	844.95	255	0	0	0	intergen
7	31782420	31782686	MACS_peak_18502	476.19	266	0	1	0	gen
7	31968699	31969082	MACS_peak_18503	73.88	383	0	1	0	gen
7	32063675	32063978	MACS_peak_18504	1068	303	0	1	0	gen
7	32123592	32123797	MACS_peak_18505	740.41	205	0	1	0	gen
7	32210717	32210985	MACS_peak_18506	603.02	268	0	1	0	gen
7	32310095	32310323	MACS_peak_18507	128.31	228	0	0	0	intergen
7	32366312	32366591	MACS_peak_18508	1236.43	279	0	0	0	intergen
7	32468139	32468480	MACS_peak_18509	55.24	341	0	0	0	intergen
7	32479649	32479956	MACS_peak_18511	438.71	307	0	0	0	intergen
7	32490812	32491268	MACS_peak_18512	477.87	456	1	1	0	promoter
7	32579261	32579648	MACS_peak_18513	1198.74	387	0	1	0	gen
7	32634979	32635226	MACS_peak_18514	573.39	247	0	0	1	other
7	32684396	32684631	MACS_peak_18515	75.39	235	0	0	1	other
7	32691932	32692201	MACS_peak_18516	402.42	269	0	0	1	other
7	32700970	32701418	MACS_peak_18517	85.61	448	0	0	1	other
7	32765737	32766044	MACS_peak_18518	1069.92	307	0	0	0	intergen
7	32800471	32800793	MACS_peak_18519	468.12	322	0	0	0	intergen
7	32846654	32846949	MACS_peak_18520	374.88	295	0	0	0	intergen
7	32851485	32851742	MACS_peak_18521	1595.61	257	0	0	0	intergen
7	33170357	33170574	MACS_peak_18522	154.43	217	0	1	0	gen
7	33228110	33228386	MACS_peak_18523	429.01	276	0	1	0	gen
7	33243369	33243643	MACS_peak_18524	1275.79	274	0	1	0	gen
7	33379381	33379583	MACS_peak_18525	611.83	202	0	1	0	gen
7	33411006	33411142	MACS_peak_18526	1586.65	136	0	1	0	gen
7	33459590	33459941	MACS_peak_18527	415.73	351	0	1	0	gen
7	33519730	33520008	MACS_peak_18528	335.61	278	0	1	0	gen
7	33611610	33611926	MACS_peak_18529	553.16	316	0	0	0	intergen
7	33716467	33716873	MACS_peak_18530	614.26	406	0	0	0	intergen
7	33807806	33808094	MACS_peak_18531	569.29	288	0	0	0	intergen
7	33827329	33827593	MACS_peak_18532	53.69	264	0	0	0	intergen
7	33940866	33941227	MACS_peak_18533	646.13	361	0	1	0	gen
7	33982363	33982640	MACS_peak_18534	1102.85	277	0	1	0	gen
7	34058325	34058553	MACS_peak_18535	848.95	228	0	1	0	gen
7	34203044	34203329	MACS_peak_18536	63.56	285	0	0	0	intergen
7	34205599	34205927	MACS_peak_18537	91.04	328	0	0	0	intergen
7	34320988	34321217	MACS_peak_18538	548.55	229	0	0	0	intergen
7	34478361	34478625	MACS_peak_18539	1102.85	264	0	0	1	other
7	34629689	34630010	MACS_peak_18541	79.92	321	0	0	1	other
7	34790940	34791250	MACS_peak_18543	577.45	310	0	1	1	gen
7	34911567	34911832	MACS_peak_18546	86.87	265	0	0	0	intergen
7	34915484	34915847	MACS_peak_18547	64.34	363	0	0	0	intergen
7	35055775	35056051	MACS_peak_18548	380.3	276	0	0	0	intergen
7	35073436	35073682	MACS_peak_18549	577	246	0	0	0	intergen
7	35095296	35095707	MACS_peak_18550	121.96	411	0	0	1	other
7	35156691	35156989	MACS_peak_18551	81.85	298	0	0	1	other
7	35190319	35190559	MACS_peak_18552	892.09	240	0	0	0	intergen
7	35424923	35425234	MACS_peak_18554	812.5	311	0	0	0	intergen
7	35624651	35624877	MACS_peak_18555	548.55	226	0	0	0	intergen
7	35709554	35709813	MACS_peak_18557	468.05	259	0	0	0	intergen
7	36319151	36319452	MACS_peak_18558	371.47	301	0	0	0	intergen
7	36486839	36487089	MACS_peak_18559	652.22	250	0	0	1	other
7	37097358	37097568	MACS_peak_18560	607.01	210	0	1	0	gen
7	37158557	37158842	MACS_peak_18561	93.4	285	0	1	0	gen
7	37234884	37235172	MACS_peak_18562	449.72	288	0	1	0	gen
7	37495662	37495975	MACS_peak_18563	1369.92	313	0	0	0	intergen
7	37853593	37853802	MACS_peak_18564	780.06	209	0	1	0	gen
7	38222522	38222900	MACS_peak_18565	403.06	378	0	1	0	gen
7	38335732	38335893	MACS_peak_18566	1220.56	161	0	0	0	intergen
7	38345564	38345889	MACS_peak_18567	671.43	325	0	0	1	other
7	38359145	38359368	MACS_peak_18568	564.54	223	0	0	1	other
7	38363517	38363787	MACS_peak_18569	569.72	270	0	0	1	other
7	38368215	38368453	MACS_peak_18570	797.18	238	0	0	1	other
7	38398784	38399021	MACS_peak_18571	406.23	237	0	1	0	gen
7	38632784	38632924	MACS_peak_18573	1301.7	140	0	0	0	intergen
7	39015854	39016276	MACS_peak_18574	288.34	422	0	1	0	gen
7	39026264	39026553	MACS_peak_18575	137.11	289	0	1	0	gen
7	39746257	39746451	MACS_peak_18576	619.53	194	0	0	1	other
7	40364216	40364472	MACS_peak_18578	62.38	256	0	1	0	gen
7	40700537	40700895	MACS_peak_18579	412.35	358	0	1	0	gen
7	41024046	41024246	MACS_peak_18580	628.77	200	0	0	0	intergen
7	41321072	41321254	MACS_peak_18581	936.57	182	0	0	0	intergen
7	41696540	41696763	MACS_peak_18582	564.54	223	0	1	1	gen
7	41943075	41943364	MACS_peak_18583	449.12	289	0	0	0	intergen
7	41979862	41980055	MACS_peak_18584	678.9	193	0	1	0	gen
7	43261345	43261634	MACS_peak_18585	681.12	289	0	1	0	gen
7	43582770	43583029	MACS_peak_18586	468.05	259	1	0	0	promoter
7	43838859	43839222	MACS_peak_18588	317.72	363	0	0	0	intergen
7	43983770	43984033	MACS_peak_18589	708.18	263	0	0	2	other
7	43985954	43986200	MACS_peak_18590	1024.03	246	0	0	3	other
7	44019071	44019382	MACS_peak_18591	808.26	311	0	0	1	other
7	44020199	44020494	MACS_peak_18592	455.15	295	0	0	1	other
7	44469008	44469256	MACS_peak_18593	763.02	248	0	1	0	gen
7	44588156	44588407	MACS_peak_18594	479.11	251	0	0	0	intergen
7	45136178	45136659	MACS_peak_18595	1755.86	481	0	0	0	intergen
7	45217568	45217841	MACS_peak_18596	458.95	273	0	0	0	intergen
7	45378131	45378452	MACS_peak_18597	51.24	321	0	0	0	intergen
7	45667342	45667660	MACS_peak_18598	67.5	318	0	1	0	gen
7	45807865	45808278	MACS_peak_18600	475.73	413	0	0	1	other
7	45923245	45923554	MACS_peak_18601	683.61	309	0	0	0	intergen
7	45950491	45950764	MACS_peak_18602	69	273	0	0	0	intergen
7	46261996	46262341	MACS_peak_18603	418.68	345	0	0	1	other
7	47180302	47180472	MACS_peak_18604	797.18	170	0	0	0	intergen
7	47819290	47819669	MACS_peak_18605	1017.46	379	0	1	1	gen
7	47855316	47855573	MACS_peak_18606	225.51	257	0	1	0	gen
7	48477226	48477570	MACS_peak_18607	105.65	344	0	1	0	gen
7	48568863	48569107	MACS_peak_18608	421.34	244	0	1	0	gen
7	48673609	48673965	MACS_peak_18609	158.47	356	0	0	0	intergen
7	48791238	48791469	MACS_peak_18610	70.79	231	0	0	0	intergen
7	49076281	49076447	MACS_peak_18611	831.63	166	0	0	0	intergen
7	49541986	49542308	MACS_peak_18612	673.67	322	0	0	0	intergen
7	49852742	49853006	MACS_peak_18613	366.9	264	1	1	0	promoter
7	49886655	49886959	MACS_peak_18614	488.85	304	0	2	0	gen
7	49959262	49959478	MACS_peak_18615	580.62	216	0	1	0	gen
7	49979915	49980313	MACS_peak_18616	505.68	398	0	1	0	gen
7	49982107	49982425	MACS_peak_18618	551.85	318	0	1	0	gen
7	50092398	50092782	MACS_peak_18619	1147.52	384	1	1	0	promoter
7	50119921	50120069	MACS_peak_18620	636.44	148	0	2	0	gen
7	50142397	50142731	MACS_peak_18621	925.03	334	0	1	1	gen
7	50696660	50696986	MACS_peak_18622	932.56	326	0	1	0	gen
7	50845162	50845507	MACS_peak_18623	356.34	345	0	0	0	intergen
7	51367141	51367327	MACS_peak_18624	901.33	186	0	0	0	intergen
7	51393243	51393513	MACS_peak_18625	329.82	270	0	0	0	intergen
7	51430550	51430817	MACS_peak_18626	588.05	267	0	0	0	intergen
7	51682025	51682341	MACS_peak_18627	84.4	316	0	0	1	other
7	51787438	51787789	MACS_peak_18628	112	351	0	0	0	intergen
7	51890352	51890604	MACS_peak_18629	194.02	252	0	0	0	intergen
7	51893833	51894209	MACS_peak_18630	94.4	376	0	0	0	intergen
7	52004948	52005164	MACS_peak_18631	580.62	216	0	0	0	intergen
7	52007308	52007457	MACS_peak_18632	954.29	149	0	0	0	intergen
7	52104217	52104578	MACS_peak_18633	147.41	361	0	0	0	intergen
7	52153656	52153963	MACS_peak_18634	438.71	307	0	0	0	intergen
7	52267473	52267809	MACS_peak_18636	1912.44	336	0	0	0	intergen
7	52735191	52735557	MACS_peak_18637	93.4	366	0	0	0	intergen
7	52751932	52752242	MACS_peak_18638	603.02	310	0	0	0	intergen
7	52918069	52918308	MACS_peak_18639	516.86	239	0	0	0	intergen
7	53159524	53159740	MACS_peak_18640	314.15	216	0	0	0	intergen
7	53214147	53214568	MACS_peak_18641	478.4	421	0	0	0	intergen
7	53237758	53237921	MACS_peak_18642	827.89	163	0	0	0	intergen
7	53458603	53458820	MACS_peak_18643	580.62	217	0	0	0	intergen
7	54084966	54085254	MACS_peak_18644	572.35	288	0	0	0	intergen
7	54224608	54224922	MACS_peak_18645	93.4	314	0	0	0	intergen
7	54294455	54294765	MACS_peak_18646	96.55	310	0	0	0	intergen
7	54309262	54309645	MACS_peak_18647	125.36	383	0	0	0	intergen
7	54395277	54395616	MACS_peak_18648	538.66	339	0	0	0	intergen
7	54395643	54396060	MACS_peak_18649	611.86	417	0	0	0	intergen
7	54396203	54396589	MACS_peak_18650	511.95	386	0	0	0	intergen
7	54397265	54397596	MACS_peak_18651	425.78	331	0	0	0	intergen
7	54502213	54502488	MACS_peak_18652	58.71	275	0	0	0	intergen
7	54606682	54606925	MACS_peak_18653	891.21	243	0	0	0	intergen
7	54839660	54839892	MACS_peak_18654	989.9	232	0	0	0	intergen
7	54903423	54903671	MACS_peak_18655	525.79	248	0	0	0	intergen
7	54962683	54963044	MACS_peak_18656	67.31	361	0	0	0	intergen
7	55250228	55250461	MACS_peak_18657	532.66	233	0	0	1	other
7	55603256	55603501	MACS_peak_18659	501.16	245	0	0	0	intergen
7	55641242	55641440	MACS_peak_18660	604.07	198	0	0	0	intergen
7	55747273	55747703	MACS_peak_18661	740.82	430	0	0	0	intergen
7	55748437	55748792	MACS_peak_18662	641.34	355	0	0	0	intergen
7	56377747	56378177	MACS_peak_18664	618.73	430	0	0	0	intergen
7	56452273	56452656	MACS_peak_18666	54.22	383	0	0	0	intergen
7	56459759	56459899	MACS_peak_18667	1272.26	140	0	0	0	intergen
7	56599737	56599959	MACS_peak_18668	433.36	222	0	0	0	intergen
7	56840273	56840688	MACS_peak_18669	68.83	415	0	0	1	other
7	56842354	56842738	MACS_peak_18670	52.99	384	0	0	1	other
7	57090724	57091107	MACS_peak_18671	78.08	383	0	0	0	intergen
7	57489652	57489903	MACS_peak_18673	358.49	251	0	0	0	intergen
7	57491039	57491516	MACS_peak_18674	89.24	477	0	0	0	intergen
7	57495388	57495779	MACS_peak_18675	63.7	391	0	0	0	intergen
7	57856919	57857264	MACS_peak_18676	83.17	345	0	0	0	intergen
7	57880846	57881191	MACS_peak_18677	51.26	345	0	0	0	intergen
7	57882224	57882503	MACS_peak_18678	57.86	279	0	0	0	intergen
7	57890004	57890227	MACS_peak_18680	127.99	223	0	0	0	intergen
7	57905573	57906049	MACS_peak_18681	87.26	476	0	0	0	intergen
7	57907749	57908086	MACS_peak_18682	115.17	337	0	0	0	intergen
7	57908350	57908742	MACS_peak_18683	69.92	392	0	0	0	intergen
7	57911183	57911554	MACS_peak_18684	181.1	371	0	0	0	intergen
7	57912479	57912659	MACS_peak_18685	175.57	180	0	0	0	intergen
7	57916539	57916850	MACS_peak_18686	76.3	311	0	0	0	intergen
7	57918756	57918920	MACS_peak_18687	141.31	164	0	0	0	intergen
7	57935011	57935439	MACS_peak_18688	167.68	428	0	0	0	intergen
7	57937041	57937338	MACS_peak_18689	65.27	297	0	0	0	intergen
7	57946986	57947422	MACS_peak_18691	762.28	436	0	0	0	intergen
7	57948836	57949232	MACS_peak_18692	148.82	396	0	0	0	intergen
7	57950748	57951105	MACS_peak_18693	81.3	357	0	0	0	intergen
7	57952240	57952623	MACS_peak_18694	64.7	383	0	0	0	intergen
7	57962068	57962290	MACS_peak_18695	170.53	222	0	0	0	intergen
7	57993128	57993344	MACS_peak_18697	422.53	216	0	0	0	intergen
7	61072909	61073192	MACS_peak_18698	211.63	283	0	0	0	intergen
7	61093371	61093734	MACS_peak_18699	299.32	363	0	0	0	intergen
7	61094153	61094421	MACS_peak_18700	72.68	268	0	0	0	intergen
7	61114014	61114352	MACS_peak_18703	56.48	338	0	0	0	intergen
7	61132121	61132372	MACS_peak_18704	66.67	251	0	0	0	intergen
7	61167420	61167742	MACS_peak_18705	50.24	322	0	0	0	intergen
7	61195516	61195761	MACS_peak_18706	53.16	245	0	0	0	intergen
7	61239467	61239788	MACS_peak_18707	50.62	321	0	0	0	intergen
7	61264839	61265292	MACS_peak_18708	54.78	453	0	0	0	intergen
7	61266953	61267337	MACS_peak_18709	70.41	384	0	0	0	intergen
7	61269169	61269394	MACS_peak_18710	167.72	225	0	0	0	intergen
7	61270400	61270708	MACS_peak_18711	57.86	308	0	0	0	intergen
7	61275295	61275659	MACS_peak_18712	68.83	364	0	0	0	intergen
7	61288968	61289334	MACS_peak_18713	93.12	366	0	0	0	intergen
7	61292053	61292297	MACS_peak_18714	182.23	244	0	0	0	intergen
7	62044160	62044443	MACS_peak_18719	52.99	283	0	0	0	intergen
7	62050345	62050709	MACS_peak_18720	81.3	364	0	0	0	intergen
7	62052378	62052599	MACS_peak_18721	62.27	221	0	0	0	intergen
7	62066224	62066564	MACS_peak_18722	82.04	340	0	0	0	intergen
7	62066980	62067346	MACS_peak_18723	171.39	366	0	0	0	intergen
7	62078577	62078885	MACS_peak_18724	57.16	308	0	0	0	intergen
7	62086975	62087327	MACS_peak_18725	57.06	352	0	0	0	intergen
7	62124369	62124681	MACS_peak_18726	71.83	312	0	0	0	intergen
7	61741367	61741635	MACS_peak_18727	76.3	268	0	0	0	intergen
7	62088464	62088812	MACS_peak_18728	107.82	348	0	0	0	intergen
7	62064157	62064523	MACS_peak_18730	94.51	366	0	0	0	intergen
7	62040982	62041416	MACS_peak_18733	96.86	434	0	0	0	intergen
7	62035920	62036318	MACS_peak_18734	82.07	398	0	0	0	intergen
7	62035144	62035408	MACS_peak_18735	99.21	264	0	0	0	intergen
7	62031214	62031595	MACS_peak_18736	327.44	381	0	0	0	intergen
7	62027250	62027672	MACS_peak_18737	403.64	422	0	0	0	intergen
7	62287205	62287524	MACS_peak_18739	167.7	319	0	0	0	intergen
7	62295039	62295457	MACS_peak_18740	192.03	418	0	0	0	intergen
7	62295601	62295992	MACS_peak_18741	106.86	391	0	0	0	intergen
7	62300552	62300974	MACS_peak_18743	150.44	422	0	0	0	intergen
7	62304658	62305054	MACS_peak_18744	100.2	396	0	0	0	intergen
7	62309505	62309895	MACS_peak_18745	121	390	0	0	0	intergen
7	62333752	62334081	MACS_peak_18746	135.37	329	0	0	0	intergen
7	62336506	62336858	MACS_peak_18747	111.9	352	0	0	0	intergen
7	62338256	62338614	MACS_peak_18748	56.38	358	0	0	0	intergen
7	62343374	62343631	MACS_peak_18749	107.03	257	0	0	0	intergen
7	62352652	62353014	MACS_peak_18751	89.08	362	0	0	0	intergen
7	62356591	62356941	MACS_peak_18752	180.12	350	0	0	0	intergen
7	62365771	62366090	MACS_peak_18753	213.55	319	0	0	0	intergen
7	62372584	62373044	MACS_peak_18755	426.55	460	0	0	0	intergen
7	62375339	62375695	MACS_peak_18756	51.61	356	0	0	0	intergen
7	62527155	62527362	MACS_peak_18763	63.55	207	0	0	0	intergen
7	62533081	62533339	MACS_peak_18767	68.49	258	0	0	0	intergen
7	62542690	62543039	MACS_peak_18768	50.92	349	0	0	0	intergen
7	62543909	62544209	MACS_peak_18769	63.65	300	0	0	0	intergen
7	62544247	62544624	MACS_peak_18770	78.6	377	0	0	0	intergen
7	62548677	62548890	MACS_peak_18771	224.27	213	0	0	0	intergen
7	62561330	62561555	MACS_peak_18772	320.35	225	0	0	0	intergen
7	62564132	62564523	MACS_peak_18773	151.72	391	0	0	0	intergen
7	62579733	62580073	MACS_peak_18775	105.65	340	0	0	0	intergen
7	62903410	62903714	MACS_peak_18776	84.53	304	0	0	0	intergen
7	63015707	63016054	MACS_peak_18777	472.89	347	0	0	0	intergen
7	63322784	63323246	MACS_peak_18778	243.49	462	0	0	0	intergen
7	63425117	63425339	MACS_peak_18779	291.9	222	0	0	0	intergen
7	63745794	63746189	MACS_peak_18781	873.06	395	0	0	0	intergen
7	63791693	63792155	MACS_peak_18782	398.43	462	0	0	0	intergen
7	63818297	63818639	MACS_peak_18783	349.95	342	0	0	0	intergen
7	64163879	64164248	MACS_peak_18784	128.01	369	0	0	0	intergen
7	64334046	64334403	MACS_peak_18785	219.12	357	0	1	0	gen
7	64697061	64697414	MACS_peak_18786	63.13	353	0	1	0	gen
7	65133079	65133321	MACS_peak_18787	402.63	242	0	0	0	intergen
7	65157946	65158326	MACS_peak_18788	101.76	380	0	0	1	other
7	65226927	65227271	MACS_peak_18789	419.18	344	0	0	1	other
7	65227404	65227793	MACS_peak_18790	510.37	389	0	0	1	other
7	65227820	65228169	MACS_peak_18791	416.71	349	0	0	1	other
7	65340261	65340590	MACS_peak_18793	81.72	329	0	0	0	intergen
7	65488888	65489354	MACS_peak_18794	329.87	466	0	0	0	intergen
7	65562609	65562907	MACS_peak_18796	533.3	298	0	0	0	intergen
7	65588073	65588443	MACS_peak_18797	62.25	370	0	0	0	intergen
7	65639720	65640018	MACS_peak_18798	561.18	298	0	0	0	intergen
7	65722211	65722555	MACS_peak_18799	274.31	344	0	0	1	other
7	65990528	65990660	MACS_peak_18800	652.77	132	0	0	0	intergen
7	66232089	66232229	MACS_peak_18801	914.92	140	0	1	0	gen
7	66950211	66950343	MACS_peak_18802	1028.85	132	0	1	0	gen
7	67000765	67000996	MACS_peak_18803	532.66	231	0	1	0	gen
7	67040836	67041254	MACS_peak_18804	495.64	418	0	1	0	gen
7	67176765	67176941	MACS_peak_18805	763.02	176	0	1	0	gen
7	67277060	67277380	MACS_peak_18806	301.69	320	0	0	0	intergen
7	67303370	67303513	MACS_peak_18807	983.72	143	0	0	1	other
7	68028947	68029316	MACS_peak_18808	84.4	369	0	0	1	other
7	68409173	68409431	MACS_peak_18810	595.17	258	0	0	0	intergen
7	68440356	68440724	MACS_peak_18811	407.64	368	0	0	0	intergen
7	68786069	68786303	MACS_peak_18812	787.23	234	0	0	0	intergen
7	70121351	70121574	MACS_peak_18813	712.32	223	0	1	0	gen
7	70165082	70165385	MACS_peak_18814	506.92	303	0	1	0	gen
7	70197591	70197937	MACS_peak_18815	53.71	346	0	1	0	gen
7	71747079	71747446	MACS_peak_18816	110.32	367	0	0	0	intergen
7	71761060	71761432	MACS_peak_18817	638.92	372	0	0	0	intergen
7	72168341	72168586	MACS_peak_18818	487.14	245	0	1	0	gen
7	72458113	72458345	MACS_peak_18819	282.24	232	0	0	0	intergen
7	72824060	72824291	MACS_peak_18821	532.66	231	0	1	0	gen
7	72873653	72874032	MACS_peak_18822	322.31	379	0	0	0	intergen
7	72915100	72915338	MACS_peak_18823	481.5	238	0	1	0	gen
7	73124047	73124346	MACS_peak_18824	341.9	299	0	0	0	intergen
7	73463148	73463482	MACS_peak_18825	488.44	334	0	1	0	gen
7	73658992	73659236	MACS_peak_18826	210.91	244	0	0	0	intergen
7	73667738	73667942	MACS_peak_18827	629.38	204	1	0	0	promoter
7	73979178	73979492	MACS_peak_18828	809.85	314	0	0	0	intergen
7	74067748	74068114	MACS_peak_18829	296.93	366	0	1	0	gen
7	74566802	74567170	MACS_peak_18830	410.58	368	0	1	0	gen
7	74866258	74866460	MACS_peak_18831	745.98	202	0	0	0	intergen
7	74892032	74892297	MACS_peak_18832	364.21	265	0	0	0	intergen
7	75046489	75046811	MACS_peak_18834	380.3	322	0	1	0	gen
7	75077656	75077858	MACS_peak_18835	966.16	202	0	0	0	intergen
7	75268331	75268626	MACS_peak_18836	360.95	295	0	0	0	intergen
7	74932842	74933141	MACS_peak_18837	352.2	299	0	0	0	intergen
7	75301610	75301880	MACS_peak_18838	678.13	270	0	0	0	intergen
7	75452459	75452741	MACS_peak_18839	639.14	282	0	1	0	gen
7	75467505	75467669	MACS_peak_18840	785.52	164	0	1	0	gen
7	75492437	75492760	MACS_peak_18841	605.78	323	1	0	0	promoter
7	75499660	75499800	MACS_peak_18842	987.97	140	0	1	0	gen
7	75619649	75619867	MACS_peak_18843	580.62	218	0	1	0	gen
7	75642972	75643295	MACS_peak_18844	429.98	323	0	1	0	gen
7	75866439	75866770	MACS_peak_18845	543.58	331	0	1	0	gen
7	75931231	75931457	MACS_peak_18846	548.55	226	0	1	0	gen
7	76130598	76130914	MACS_peak_18847	433.75	316	0	0	1	other
7	76178154	76178421	MACS_peak_18848	588.05	267	0	0	0	intergen
7	76201741	76201950	MACS_peak_18849	613.04	209	1	0	0	promoter
7	76263031	76263302	MACS_peak_18850	584.96	271	0	1	0	gen
7	76314312	76314583	MACS_peak_18851	696.65	271	0	0	0	intergen
7	76435925	76436161	MACS_peak_18852	282.18	236	0	1	0	gen
7	76542769	76543177	MACS_peak_18853	431.5	408	0	0	0	intergen
7	76588436	76588714	MACS_peak_18854	901.45	278	0	0	1	other
7	76637065	76637382	MACS_peak_18855	722.44	317	0	0	0	intergen
7	76695378	76695612	MACS_peak_18856	145.78	234	0	0	0	intergen
7	77061823	77062146	MACS_peak_18857	436.81	323	0	0	1	other
7	77247261	77247615	MACS_peak_18858	414.27	354	0	1	1	gen
7	77369057	77369415	MACS_peak_18859	488.85	358	0	1	0	gen
7	77641124	77641262	MACS_peak_18860	652.22	138	0	0	0	intergen
7	77759316	77759664	MACS_peak_18861	533.26	348	0	1	0	gen
7	77815263	77815535	MACS_peak_18862	695.76	272	0	1	0	gen
7	78120681	78120934	MACS_peak_18863	227.98	253	0	1	0	gen
7	78240223	78240428	MACS_peak_18864	282.79	205	0	1	0	gen
7	78297173	78297476	MACS_peak_18865	62.38	303	0	1	0	gen
7	78464984	78465252	MACS_peak_18866	462.14	268	0	1	0	gen
7	78587457	78587718	MACS_peak_18867	453.37	261	0	1	0	gen
7	78833079	78833321	MACS_peak_18868	304.63	242	0	1	0	gen
7	78923973	78924242	MACS_peak_18869	105.65	269	0	1	0	gen
7	79028168	79028441	MACS_peak_18870	365.4	273	0	1	0	gen
7	79298184	79298555	MACS_peak_18871	488.85	371	0	1	0	gen
7	79498301	79498522	MACS_peak_18872	729.14	221	0	0	0	intergen
7	79502189	79502463	MACS_peak_18873	458.32	274	0	0	0	intergen
7	79625309	79625730	MACS_peak_18874	722.05	421	0	0	0	intergen
7	79681092	79681343	MACS_peak_18875	596.67	251	0	0	0	intergen
7	79750083	79750341	MACS_peak_18876	380.3	258	0	0	0	intergen
7	79898314	79898590	MACS_peak_18877	1126.98	276	0	1	0	gen
7	80453798	80454064	MACS_peak_18878	719.85	266	1	1	0	promoter
7	80576083	80576329	MACS_peak_18879	448.91	246	0	1	0	gen
7	80659559	80659776	MACS_peak_18880	746.04	217	0	1	0	gen
7	80667325	80667668	MACS_peak_18881	751.13	343	0	1	0	gen
7	80804617	80804840	MACS_peak_18882	434.23	223	0	1	0	gen
7	80920118	80920377	MACS_peak_18883	468.05	259	0	1	0	gen
7	81054550	81054790	MACS_peak_18884	51.05	240	0	0	0	intergen
7	81146900	81147256	MACS_peak_18885	96.97	356	0	0	0	intergen
7	81424193	81424587	MACS_peak_18886	58.76	394	0	0	0	intergen
7	81426652	81426791	MACS_peak_18887	1344.84	139	0	0	0	intergen
7	81499682	81499941	MACS_peak_18888	875.64	259	0	0	1	other
7	81980069	81980209	MACS_peak_18889	1395.4	140	0	1	0	gen
7	82247975	82248216	MACS_peak_18891	426.48	241	0	1	0	gen
7	82297079	82297211	MACS_peak_18892	1064.34	132	0	1	0	gen
7	82481615	82481811	MACS_peak_18893	644.94	196	0	0	0	intergen
7	82726940	82727403	MACS_peak_18894	790.81	463	0	0	0	intergen
7	82729427	82729871	MACS_peak_18895	710.42	444	0	0	0	intergen
7	82740224	82740564	MACS_peak_18896	421.18	340	0	0	0	intergen
7	82891417	82891790	MACS_peak_18897	89.02	373	0	1	0	gen
7	82902102	82902342	MACS_peak_18898	180.07	240	0	1	0	gen
7	83026928	83027241	MACS_peak_18900	51.09	313	0	1	0	gen
7	83073000	83073212	MACS_peak_18901	1253.83	212	0	1	0	gen
7	83096876	83097189	MACS_peak_18902	305.33	313	0	1	0	gen
7	83976308	83976669	MACS_peak_18903	525.71	361	0	1	0	gen
7	84066513	84066861	MACS_peak_18904	76.3	348	0	1	0	gen
7	84079165	84079516	MACS_peak_18905	69	351	0	1	0	gen
7	84086415	84086753	MACS_peak_18906	661.98	338	0	1	0	gen
7	84188830	84189201	MACS_peak_18908	393.08	371	0	1	0	gen
7	84576923	84577205	MACS_peak_18910	265.34	282	0	0	1	other
7	84868539	84868682	MACS_peak_18911	1007.8	143	0	0	0	intergen
7	84892649	84892824	MACS_peak_18912	780.06	175	0	0	0	intergen
7	84914633	84914967	MACS_peak_18913	664.84	334	0	0	0	intergen
7	85021024	85021481	MACS_peak_18915	1784.27	457	0	1	0	gen
7	85022256	85022474	MACS_peak_18916	666.39	218	0	1	0	gen
7	85023157	85023464	MACS_peak_18917	438.71	307	0	1	0	gen
7	85254053	85254435	MACS_peak_18918	60	382	0	0	0	intergen
7	85254939	85255309	MACS_peak_18919	56.31	370	0	0	0	intergen
7	85301270	85301576	MACS_peak_18920	380.3	306	0	0	0	intergen
7	85333653	85333989	MACS_peak_18921	58.64	336	0	0	0	intergen
7	85750396	85750669	MACS_peak_18922	458.95	273	0	0	0	intergen
7	85829858	85830220	MACS_peak_18923	563.67	362	0	0	0	intergen
7	85990998	85991381	MACS_peak_18925	50.64	383	0	0	0	intergen
7	86126407	86126687	MACS_peak_18926	474.13	280	0	0	0	intergen
7	86178124	86178460	MACS_peak_18927	117.34	336	0	0	0	intergen
7	86232384	86232764	MACS_peak_18928	68.83	380	0	0	0	intergen
7	86311826	86312187	MACS_peak_18929	488.85	361	0	0	0	intergen
7	86368406	86368764	MACS_peak_18930	56.38	358	0	0	0	intergen
7	86378559	86378926	MACS_peak_18931	175.68	367	0	0	0	intergen
7	86469684	86470047	MACS_peak_18932	524.58	363	0	0	0	intergen
7	86549781	86550015	MACS_peak_18933	122.54	234	0	0	0	intergen
7	86550991	86551351	MACS_peak_18934	150.78	360	0	0	0	intergen
7	86615849	86616071	MACS_peak_18935	513.05	222	0	0	0	intergen
7	86815044	86815405	MACS_peak_18937	410.92	361	0	1	0	gen
7	86905065	86905480	MACS_peak_18938	567.67	415	0	1	0	gen
7	86931390	86931629	MACS_peak_18939	954.29	239	0	1	0	gen
7	87042037	87042388	MACS_peak_18940	51.98	351	0	1	0	gen
7	87044966	87045398	MACS_peak_18941	65.87	432	0	1	0	gen
7	87178386	87178627	MACS_peak_18942	501.16	241	0	1	0	gen
7	87312318	87312767	MACS_peak_18943	611.86	449	0	0	0	intergen
7	87465369	87465574	MACS_peak_18944	354.7	205	0	1	0	gen
7	87703794	87704017	MACS_peak_18945	931.05	223	0	2	0	gen
7	87715167	87715415	MACS_peak_18946	868.07	248	0	1	0	gen
7	87736878	87737017	MACS_peak_18947	902.92	139	0	1	0	gen
7	87797779	87798120	MACS_peak_18948	659.85	341	0	1	0	gen
7	87854594	87855033	MACS_peak_18949	219.35	439	0	1	0	gen
7	87953249	87953564	MACS_peak_18950	82.92	315	0	1	0	gen
7	88030778	88031087	MACS_peak_18951	103.45	309	0	1	0	gen
7	88065358	88065657	MACS_peak_18952	587.13	299	0	1	0	gen
7	88081636	88081936	MACS_peak_18953	53.04	300	0	1	0	gen
7	88169825	88170054	MACS_peak_18954	548.55	229	0	1	0	gen
7	88239955	88240121	MACS_peak_18955	810.9	166	0	0	1	other
7	88358294	88358563	MACS_peak_18957	586.5	269	0	0	0	intergen
7	88364349	88364589	MACS_peak_18958	797.18	240	0	0	0	intergen
7	88401089	88401432	MACS_peak_18959	658.44	343	0	0	0	intergen
7	88703146	88703376	MACS_peak_18960	972.37	230	0	0	0	intergen
7	89279756	89280226	MACS_peak_18961	66.89	470	0	1	0	gen
7	89291879	89292129	MACS_peak_18962	1043.77	250	0	1	0	gen
7	89360843	89361210	MACS_peak_18963	54.41	367	0	0	0	intergen
7	89448871	89449174	MACS_peak_18964	62.48	303	0	0	1	other
7	89524365	89524769	MACS_peak_18965	71.22	404	0	0	0	intergen
7	90115065	90115491	MACS_peak_18967	892.96	426	0	0	1	other
7	90412988	90413261	MACS_peak_18968	583.44	273	0	1	1	gen
7	90427857	90428194	MACS_peak_18969	486.61	337	0	1	1	gen
7	90637478	90637764	MACS_peak_18970	86.73	286	0	1	0	gen
7	90650334	90650760	MACS_peak_18971	66.96	426	0	1	0	gen
7	90708811	90709071	MACS_peak_18972	862.05	260	0	1	0	gen
7	91056723	91057011	MACS_peak_18973	118.95	288	0	1	0	gen
7	91057970	91058365	MACS_peak_18974	56.23	395	0	1	0	gen
7	91075353	91075714	MACS_peak_18975	476.21	361	0	1	0	gen
7	91082927	91083260	MACS_peak_18976	424.75	333	0	1	0	gen
7	91142907	91143150	MACS_peak_18977	1725.79	243	0	1	0	gen
7	91366544	91366719	MACS_peak_18978	780.06	175	0	0	1	other
7	91489167	91489522	MACS_peak_18979	52.34	355	0	0	2	other
7	91586133	91586470	MACS_peak_18980	57.18	337	0	0	0	intergen
7	91593464	91593876	MACS_peak_18981	59.61	412	0	0	0	intergen
7	91756801	91757119	MACS_peak_18982	372.13	318	0	1	0	gen
7	91761925	91762250	MACS_peak_18983	62.38	325	0	1	0	gen
7	91792474	91792669	MACS_peak_18984	124.81	195	0	1	0	gen
7	91830141	91830398	MACS_peak_18985	709.49	257	0	1	0	gen
7	91876744	91877054	MACS_peak_18986	557.12	310	0	1	0	gen
7	91880741	91881048	MACS_peak_18987	685.18	307	0	0	0	intergen
7	91988061	91988338	MACS_peak_18988	312.33	277	0	1	0	gen
7	92128755	92128994	MACS_peak_18989	645.81	239	1	2	0	promoter
7	92217651	92217931	MACS_peak_18990	707.43	280	0	2	0	gen
7	92424684	92424983	MACS_peak_18991	452.42	299	0	0	1	other
7	92447186	92447500	MACS_peak_18992	603.02	314	1	0	1	promoter
7	92449875	92450080	MACS_peak_18993	972.07	205	1	0	0	promoter
7	92461614	92461872	MACS_peak_18994	821.51	258	0	0	1	other
7	92590434	92590633	MACS_peak_18995	477.68	199	0	0	0	intergen
7	92601201	92601335	MACS_peak_18996	1445.82	134	1	0	0	promoter
7	92832964	92833286	MACS_peak_18997	488.85	322	0	1	0	gen
7	93071076	93071315	MACS_peak_18999	150.71	239	0	0	0	intergen
7	93228334	93228538	MACS_peak_19000	972.07	204	1	0	0	promoter
7	93345857	93346207	MACS_peak_19002	68.3	350	0	1	0	gen
7	93347071	93347536	MACS_peak_19003	117.08	465	0	1	0	gen
7	93374283	93374632	MACS_peak_19004	759.7	349	0	0	0	intergen
7	93380772	93381136	MACS_peak_19005	51.29	364	0	0	0	intergen
7	93622072	93622378	MACS_peak_19006	816.97	306	0	1	0	gen
7	93755311	93755511	MACS_peak_19007	554.96	200	0	1	0	gen
7	93902901	93903139	MACS_peak_19009	662.31	238	0	1	0	gen
7	94020271	94020569	MACS_peak_19010	129.78	298	0	0	0	intergen
7	94199820	94200049	MACS_peak_19011	392.34	229	0	0	0	intergen
7	94289066	94289348	MACS_peak_19013	839.55	282	0	0	1	other
7	94395497	94395767	MACS_peak_19014	716.24	270	1	0	0	promoter
7	94436045	94436332	MACS_peak_19015	573.07	287	0	0	0	intergen
7	94449227	94449439	MACS_peak_19016	763.02	212	0	0	0	intergen
7	94998383	94998644	MACS_peak_19017	720.73	261	0	1	0	gen
7	95199858	95200163	MACS_peak_19018	426.57	305	0	1	1	gen
7	95246907	95247185	MACS_peak_19019	579.67	278	0	1	0	gen
7	95258155	95258493	MACS_peak_19020	102.02	338	0	1	0	gen
7	95382343	95382709	MACS_peak_19021	56.38	366	0	1	0	gen
7	95477105	95477336	MACS_peak_19022	661.2	231	1	0	0	promoter
7	95511678	95512081	MACS_peak_19023	419.14	403	0	1	0	gen
7	95527493	95527696	MACS_peak_19024	629.38	203	0	1	0	gen
7	95544925	95545207	MACS_peak_19025	488.85	282	0	0	0	intergen
7	95687847	95688036	MACS_peak_19026	1079.97	189	0	0	0	intergen
7	95718905	95719162	MACS_peak_19027	709.49	257	0	0	0	intergen
7	95835008	95835486	MACS_peak_19028	56.85	478	0	1	0	gen
7	95835603	95835946	MACS_peak_19029	52.99	343	0	1	0	gen
7	95916617	95916956	MACS_peak_19030	920.42	339	0	1	0	gen
7	95942535	95942924	MACS_peak_19031	69.59	389	0	1	0	gen
7	96075493	96075695	MACS_peak_19032	989.9	202	0	1	0	gen
7	96414898	96415233	MACS_peak_19033	1199.31	335	0	0	0	intergen
7	96631932	96632273	MACS_peak_19034	194.53	341	0	1	0	gen
7	96678366	96678642	MACS_peak_19035	557.06	276	0	1	0	gen
7	96704015	96704256	MACS_peak_19036	646.51	241	0	1	0	gen
7	96730350	96730606	MACS_peak_19037	470.06	256	0	0	0	intergen
7	97065033	97065279	MACS_peak_19038	554.92	246	0	0	0	intergen
7	97150454	97150690	MACS_peak_19039	394.53	236	0	1	0	gen
7	97212940	97213168	MACS_peak_19040	486.08	228	0	0	0	intergen
7	97319836	97320037	MACS_peak_19041	793.98	201	0	0	0	intergen
7	97417412	97417560	MACS_peak_19042	1234.15	148	0	0	0	intergen
7	97499273	97499525	MACS_peak_19043	470.06	252	0	0	0	intergen
7	97614547	97614990	MACS_peak_19044	51	443	0	0	0	intergen
7	97757800	97758054	MACS_peak_19046	348.31	254	0	0	0	intergen
7	97781050	97781415	MACS_peak_19047	100.41	365	0	0	0	intergen
7	97815314	97815626	MACS_peak_19048	65.37	312	0	0	0	intergen
7	97845721	97845984	MACS_peak_19049	404.4	263	0	0	0	intergen
7	97912281	97912646	MACS_peak_19050	2387.07	365	0	0	1	other
7	98013419	98013813	MACS_peak_19051	491.93	394	0	0	0	intergen
7	98021553	98021744	MACS_peak_19052	659.58	191	0	0	0	intergen
7	98106497	98106820	MACS_peak_19053	1356.87	323	1	0	0	promoter
7	98145696	98146014	MACS_peak_19054	551.85	318	0	1	0	gen
7	98241280	98241699	MACS_peak_19055	730.49	419	0	1	0	gen
7	98420978	98421381	MACS_peak_19056	619.72	403	0	0	0	intergen
7	98433364	98433687	MACS_peak_19057	514.32	323	0	0	0	intergen
7	98582414	98582558	MACS_peak_19059	754.9	144	0	0	0	intergen
7	98745900	98746208	MACS_peak_19060	542.51	308	0	0	0	intergen
7	98836883	98837177	MACS_peak_19061	568.08	294	0	0	0	intergen
7	99187697	99187938	MACS_peak_19062	589.76	241	0	1	0	gen
7	99213328	99213474	MACS_peak_19063	1343.35	146	0	0	0	intergen
7	99312988	99313232	MACS_peak_19064	1226.97	244	0	0	1	other
7	99365579	99365850	MACS_peak_19065	460.22	271	0	2	0	gen
7	99415594	99416012	MACS_peak_19066	731.14	418	2	1	0	promoter
7	99801815	99802079	MACS_peak_19067	84.46	264	0	0	0	intergen
7	99802895	99803162	MACS_peak_19068	267.3	267	0	0	0	intergen
7	99812956	99813174	MACS_peak_19069	73.48	218	0	0	0	intergen
7	99913154	99913422	MACS_peak_19070	718.04	268	0	1	0	gen
7	99949707	99950007	MACS_peak_19071	380.3	300	0	0	0	intergen
7	99990987	99991275	MACS_peak_19072	460.03	288	0	0	0	intergen
7	99994231	99994463	MACS_peak_19073	1472.64	232	0	0	0	intergen
7	100081830	100082142	MACS_peak_19074	790.3	312	0	1	0	gen
7	100131099	100131295	MACS_peak_19075	635.31	196	1	0	1	promoter
7	100217123	100217417	MACS_peak_19076	645.79	294	1	2	0	promoter
7	100217896	100218289	MACS_peak_19077	747.46	393	1	2	0	promoter
7	100344433	100344769	MACS_peak_19078	947.52	336	0	0	2	other
7	100345209	100345602	MACS_peak_19079	567.67	393	0	0	2	other
7	100469270	100469638	MACS_peak_19080	363.56	368	0	1	0	gen
7	100718523	100718761	MACS_peak_19081	540.48	238	1	0	0	promoter
7	101059333	101059602	MACS_peak_19082	501.18	269	0	0	0	intergen
7	101121166	101121302	MACS_peak_19084	691.33	136	0	0	0	intergen
7	101192546	101192995	MACS_peak_19085	506.92	449	1	0	0	promoter
7	101309870	101310071	MACS_peak_19086	777.44	201	1	0	1	promoter
7	101350089	101350230	MACS_peak_19087	1269.22	141	0	0	0	intergen
7	101411304	101411679	MACS_peak_19088	517.89	375	0	1	0	gen
7	101458088	101458457	MACS_peak_19089	346.98	369	0	1	0	gen
7	101507812	101508121	MACS_peak_19090	557.79	309	0	1	0	gen
7	101857033	101857364	MACS_peak_19091	515.69	331	0	1	0	gen
7	102073052	102073185	MACS_peak_19092	960.62	133	0	1	0	gen
7	102238283	102238559	MACS_peak_19093	380.3	276	0	1	0	gen
7	102279569	102279760	MACS_peak_19094	695.57	191	0	1	0	gen
7	102357313	102357636	MACS_peak_19095	798.35	323	0	0	0	intergen
7	102390833	102391126	MACS_peak_19096	673.02	293	0	1	0	gen
7	102479872	102480235	MACS_peak_19097	486.95	363	2	0	0	promoter
7	102511752	102511996	MACS_peak_19098	660.81	244	0	2	0	gen
7	102537191	102537452	MACS_peak_19099	507.36	261	3	1	0	promoter
7	102539368	102539591	MACS_peak_19100	1589.86	223	3	1	0	promoter
7	102544052	102544256	MACS_peak_19101	334.37	204	1	1	0	promoter
7	102551642	102551965	MACS_peak_19102	773.07	323	1	2	0	promoter
7	102572555	102572860	MACS_peak_19103	564.75	305	1	1	0	promoter
7	102573528	102573918	MACS_peak_19104	889.81	390	1	1	0	promoter
7	102610913	102611157	MACS_peak_19105	657.42	244	0	2	1	gen
7	102636296	102636558	MACS_peak_19106	521.79	262	2	1	1	promoter
7	102638356	102638699	MACS_peak_19107	1399.02	343	2	1	1	promoter
7	102650735	102651058	MACS_peak_19108	467.59	323	1	1	1	promoter
7	102657985	102658213	MACS_peak_19109	391.38	228	0	2	1	gen
7	102672600	102673049	MACS_peak_19110	839.55	449	0	0	1	other
7	102674004	102674315	MACS_peak_19111	352.09	311	0	0	1	other
7	102684722	102685073	MACS_peak_19112	114.74	351	0	0	1	other
7	102725563	102725889	MACS_peak_19113	84.4	326	0	0	0	intergen
7	102758203	102758517	MACS_peak_19114	473.97	314	0	1	0	gen
7	102782048	102782461	MACS_peak_19115	139.27	413	0	1	0	gen
7	102853560	102853812	MACS_peak_19116	61.43	252	0	1	0	gen
7	103061967	103062237	MACS_peak_19117	950.42	270	0	1	0	gen
7	103247461	103247698	MACS_peak_19118	158.88	237	0	0	1	other
7	103282734	103283201	MACS_peak_19119	997.64	467	0	0	0	intergen
7	103573506	103573879	MACS_peak_19120	1129.28	373	0	1	0	gen
7	103909625	103909973	MACS_peak_19121	82.14	348	0	1	0	gen
7	104156771	104157114	MACS_peak_19122	411.54	343	0	1	0	gen
7	104211672	104212010	MACS_peak_19123	116.97	338	0	0	0	intergen
7	104215391	104215766	MACS_peak_19124	105.65	375	0	0	0	intergen
7	104474672	104474931	MACS_peak_19125	468.05	259	0	1	0	gen
7	104520557	104521030	MACS_peak_19126	93.37	473	0	1	0	gen
7	104643612	104644036	MACS_peak_19127	700.7	424	0	1	0	gen
7	104751769	104752033	MACS_peak_19128	425.95	264	0	1	1	gen
7	104824168	104824623	MACS_peak_19129	1215.15	455	0	1	0	gen
7	104848287	104848650	MACS_peak_19130	769.88	363	0	1	0	gen
7	104918581	104918996	MACS_peak_19131	342.65	415	0	0	1	other
7	104922925	104923178	MACS_peak_19132	1144.35	253	0	0	1	other
7	104965689	104965913	MACS_peak_19133	1563.2	224	0	0	1	other
7	104981254	104981546	MACS_peak_19134	434.05	292	0	0	1	other
7	105066961	105067101	MACS_peak_19135	876.68	140	0	1	0	gen
7	105260227	105260591	MACS_peak_19136	82.74	364	0	1	0	gen
7	105362053	105362323	MACS_peak_19137	127.5	270	0	1	0	gen
7	105401608	105401834	MACS_peak_19138	1472.42	226	0	0	0	intergen
7	105652341	105652603	MACS_peak_19139	591.97	262	0	1	0	gen
7	105760124	105760507	MACS_peak_19140	1013.85	383	0	1	0	gen
7	106042889	106043124	MACS_peak_19141	662.31	235	0	0	0	intergen
7	106153917	106154174	MACS_peak_19142	355.73	257	0	0	0	intergen
7	106166748	106166994	MACS_peak_19143	799.34	246	0	0	0	intergen
7	106244655	106244872	MACS_peak_19144	111.47	217	1	0	0	promoter
7	106246798	106246991	MACS_peak_19145	144.06	193	1	0	0	promoter
7	106294405	106294642	MACS_peak_19146	563.78	237	0	0	0	intergen
7	106458236	106458454	MACS_peak_19147	1255.75	218	0	0	1	other
7	106712499	106712811	MACS_peak_19148	81.45	312	0	0	1	other
7	106742813	106743196	MACS_peak_19149	611.86	383	0	0	1	other
7	106771942	106772288	MACS_peak_19150	534.92	346	0	0	0	intergen
7	106793042	106793371	MACS_peak_19151	929.71	329	0	0	1	other
7	106959779	106960073	MACS_peak_19152	695.63	294	0	0	0	intergen
7	107320074	107320316	MACS_peak_19153	780.06	242	0	1	0	gen
7	107351080	107351426	MACS_peak_19154	114.74	346	0	1	0	gen
7	107479527	107479832	MACS_peak_19155	1236.43	305	0	1	0	gen
7	107501706	107501919	MACS_peak_19156	763.02	213	0	1	0	gen
7	107509872	107510197	MACS_peak_19157	149.64	325	0	1	0	gen
7	107510863	107511207	MACS_peak_19158	84.4	344	0	1	0	gen
7	107545778	107545910	MACS_peak_19159	1090.31	132	0	1	0	gen
7	107598909	107599358	MACS_peak_19160	506.92	449	0	1	0	gen
7	107648290	107648626	MACS_peak_19161	71.88	336	0	0	0	intergen
7	107679969	107680428	MACS_peak_19162	951.68	459	0	1	0	gen
7	107682094	107682334	MACS_peak_19163	345.62	240	0	1	0	gen
7	107725202	107725489	MACS_peak_19164	701.46	287	0	0	0	intergen
7	107751362	107751562	MACS_peak_19165	1212.73	200	0	1	0	gen
7	107770082	107770320	MACS_peak_19166	2063.72	238	1	0	0	promoter
7	107841405	107841583	MACS_peak_19167	270.73	178	0	0	0	intergen
7	107848696	107848975	MACS_peak_19168	103.45	279	0	0	0	intergen
7	108131722	108131962	MACS_peak_19169	903.02	240	0	0	0	intergen
7	108181091	108181335	MACS_peak_19170	629.38	244	0	1	0	gen
7	108298489	108298693	MACS_peak_19171	573.39	204	0	1	0	gen
7	108613172	108613521	MACS_peak_19172	719	349	0	0	1	other
7	108615590	108616031	MACS_peak_19173	86.45	441	0	0	0	intergen
7	108660371	108660709	MACS_peak_19174	661.98	338	0	0	0	intergen
7	108791099	108791322	MACS_peak_19175	705.91	223	0	0	0	intergen
7	108941479	108941702	MACS_peak_19176	86.59	223	0	0	1	other
7	109419021	109419453	MACS_peak_19177	63.73	432	0	0	0	intergen
7	109687376	109687619	MACS_peak_19179	140.36	243	0	0	0	intergen
7	109688844	109689187	MACS_peak_19180	98.58	343	0	0	0	intergen
7	109775466	109775774	MACS_peak_19181	815.17	308	0	0	0	intergen
7	109844424	109844790	MACS_peak_19182	872.75	366	0	0	0	intergen
7	110130769	110131081	MACS_peak_19183	336.79	312	0	0	0	intergen
7	110226881	110227134	MACS_peak_19184	1220.56	253	0	0	0	intergen
7	110316612	110316816	MACS_peak_19185	501.94	204	0	0	0	intergen
7	110458088	110458244	MACS_peak_19187	872.93	156	0	0	1	other
7	110562874	110563118	MACS_peak_19188	122.91	244	0	0	0	intergen
7	110657785	110658144	MACS_peak_19189	63.18	359	0	0	0	intergen
7	110766483	110766718	MACS_peak_19190	584.1	235	0	1	0	gen
7	110817976	110818288	MACS_peak_19191	68.83	312	0	1	0	gen
7	110925021	110925234	MACS_peak_19192	659.6	213	0	1	0	gen
7	111016556	111017024	MACS_peak_19193	700.24	468	0	1	0	gen
7	111089701	111090104	MACS_peak_19194	866.86	403	1	1	0	promoter
7	111174922	111175141	MACS_peak_19195	879.27	219	0	1	0	gen
7	111223390	111223623	MACS_peak_19196	532.66	233	0	1	0	gen
7	111456179	111456562	MACS_peak_19197	1982.78	383	0	1	0	gen
7	111578252	111578506	MACS_peak_19198	83.46	254	0	0	0	intergen
7	111630656	111630867	MACS_peak_19199	596.79	211	0	0	0	intergen
7	111675330	111675525	MACS_peak_19200	639.26	195	0	0	0	intergen
7	111763274	111763661	MACS_peak_19201	938.66	387	0	1	0	gen
7	111770109	111770242	MACS_peak_19202	1396.21	133	0	1	0	gen
7	111853717	111853951	MACS_peak_19203	454.39	234	0	1	0	gen
7	111855183	111855600	MACS_peak_19204	574.74	417	0	1	0	gen
7	111891448	111891704	MACS_peak_19205	844.95	256	0	1	0	gen
7	111965081	111965429	MACS_peak_19206	67.58	348	0	1	0	gen
7	112296814	112296953	MACS_peak_19207	737.33	139	0	1	0	gen
7	112411260	112411526	MACS_peak_19208	535.15	266	0	0	0	intergen
7	112495867	112496151	MACS_peak_19209	452.13	284	0	0	0	intergen
7	112543493	112543756	MACS_peak_19210	758.16	263	0	0	0	intergen
7	112550514	112550740	MACS_peak_19211	869.63	226	0	0	0	intergen
7	112947284	112947560	MACS_peak_19214	380.3	276	0	0	0	intergen
7	113516057	113516425	MACS_peak_19215	91.07	368	0	0	0	intergen
7	113522928	113523216	MACS_peak_19216	52.4	288	0	0	0	intergen
7	113534487	113534774	MACS_peak_19217	69.12	287	0	0	0	intergen
7	113574605	113574903	MACS_peak_19218	270.5	298	0	0	0	intergen
7	113698657	113699063	MACS_peak_19219	1069.92	406	0	0	0	intergen
7	113710346	113710634	MACS_peak_19220	1842.95	288	0	0	0	intergen
7	114050034	114050248	MACS_peak_19222	916.14	214	0	1	0	gen
7	114271588	114272010	MACS_peak_19223	406.81	422	0	1	0	gen
7	114493126	114493400	MACS_peak_19224	201.59	274	0	1	0	gen
7	114667893	114668144	MACS_peak_19225	485.56	251	0	1	0	gen
7	115463165	115463410	MACS_peak_19226	454.18	245	0	0	0	intergen
7	116010988	116011160	MACS_peak_19227	936.8	172	0	1	0	gen
7	116108949	116109333	MACS_peak_19228	54.32	384	0	1	0	gen
7	116168284	116168519	MACS_peak_19229	662.31	235	0	0	0	intergen
7	116376478	116376803	MACS_peak_19230	76.15	325	0	1	1	gen
7	116409358	116409554	MACS_peak_19231	217.56	196	0	1	1	gen
7	116526150	116526331	MACS_peak_19232	746.04	181	1	0	0	promoter
7	116604868	116605008	MACS_peak_19233	727.81	140	0	0	1	other
7	116711304	116711543	MACS_peak_19234	1264.23	239	0	1	0	gen
7	116900576	116900842	MACS_peak_19235	719.85	266	0	1	0	gen
7	117119422	117119760	MACS_peak_19236	422.19	338	0	1	1	gen
7	117265397	117265659	MACS_peak_19237	466.05	262	0	0	0	intergen
7	117456874	117457120	MACS_peak_19238	386.6	246	0	0	0	intergen
7	117609932	117610354	MACS_peak_19239	63.13	422	0	1	1	gen
7	117868460	117868626	MACS_peak_19240	831.63	166	0	1	0	gen
7	117966882	117967287	MACS_peak_19241	105.65	405	0	0	0	intergen
7	118020095	118020296	MACS_peak_19242	645.81	201	0	0	0	intergen
7	118127040	118127246	MACS_peak_19243	181.54	206	0	0	0	intergen
7	118195901	118196135	MACS_peak_19244	532.66	234	0	0	0	intergen
7	118703684	118703962	MACS_peak_19245	476	278	0	0	0	intergen
7	119176151	119176376	MACS_peak_19246	548.55	225	0	0	0	intergen
7	119197953	119198222	MACS_peak_19247	461.5	269	0	0	0	intergen
7	119270021	119270229	MACS_peak_19248	780.06	208	0	0	0	intergen
7	119335816	119336035	MACS_peak_19249	549.31	219	0	0	0	intergen
7	119362680	119363121	MACS_peak_19250	264.75	441	0	0	0	intergen
7	119463623	119463962	MACS_peak_19251	139.69	339	0	0	0	intergen
7	119588655	119588957	MACS_peak_19252	81.54	302	0	0	0	intergen
7	119649666	119650001	MACS_peak_19253	102.81	335	0	0	0	intergen
7	119859881	119860268	MACS_peak_19254	53.02	387	0	0	1	other
7	119978028	119978431	MACS_peak_19255	983.83	403	0	0	0	intergen
7	120337341	120337561	MACS_peak_19256	729.14	220	0	1	0	gen
7	120338170	120338464	MACS_peak_19257	552.11	294	0	1	0	gen
7	120555072	120555282	MACS_peak_19258	674.85	210	0	1	0	gen
7	120710803	120711036	MACS_peak_19259	924.44	233	0	1	0	gen
7	120792022	120792347	MACS_peak_19260	428.92	325	0	0	0	intergen
7	120799525	120799898	MACS_peak_19261	619.75	373	0	1	0	gen
7	121081705	121081916	MACS_peak_19262	596.79	211	0	1	0	gen
7	121088665	121088893	MACS_peak_19263	342.86	228	0	1	0	gen
7	121126830	121127261	MACS_peak_19264	846.12	431	0	1	0	gen
7	121250230	121250632	MACS_peak_19265	60	402	0	1	0	gen
7	121320117	121320478	MACS_peak_19266	126.04	361	0	0	0	intergen
7	121335883	121336033	MACS_peak_19267	1189.9	150	0	1	0	gen
7	121846355	121846791	MACS_peak_19268	567.67	436	0	0	0	intergen
7	121969832	121970245	MACS_peak_19269	94.14	413	0	1	0	gen
7	122092991	122093248	MACS_peak_19270	469.39	257	0	1	0	gen
7	122219194	122219539	MACS_peak_19271	783.88	345	0	0	0	intergen
7	122437098	122437424	MACS_peak_19272	428.39	326	0	1	1	gen
7	122705367	122705763	MACS_peak_19273	439.99	396	1	1	0	promoter
7	122839164	122839526	MACS_peak_19275	67.01	362	0	1	0	gen
7	122934262	122934536	MACS_peak_19276	380.3	274	0	0	0	intergen
7	123166736	123167067	MACS_peak_19277	159.56	331	0	1	0	gen
7	123184910	123185170	MACS_peak_19278	2765.84	260	0	1	0	gen
7	123208912	123209179	MACS_peak_19279	588.05	267	0	0	0	intergen
7	123212937	123213263	MACS_peak_19280	546.72	326	0	0	0	intergen
7	123241647	123241872	MACS_peak_19281	693.94	225	0	0	0	intergen
7	123427398	123427681	MACS_peak_19282	94.4	283	0	0	0	intergen
7	123494200	123494638	MACS_peak_19283	841.15	438	0	1	0	gen
7	123526438	123526864	MACS_peak_19284	160.72	426	0	1	0	gen
7	123537099	123537380	MACS_peak_19285	577.45	281	1	0	0	promoter
7	123540999	123541234	MACS_peak_19286	516.86	235	1	0	0	promoter
7	123701583	123701882	MACS_peak_19287	564.59	299	0	1	0	gen
7	123732517	123732822	MACS_peak_19288	309.6	305	0	1	0	gen
7	123797857	123798085	MACS_peak_19289	548.55	228	0	0	0	intergen
7	123899941	123900275	MACS_peak_19290	50.72	334	0	0	0	intergen
7	124047464	124047625	MACS_peak_19291	402.93	161	0	0	1	other
7	124056924	124057115	MACS_peak_19292	695.57	191	0	0	1	other
7	124095714	124095940	MACS_peak_19293	60.7	226	0	0	1	other
7	124101141	124101498	MACS_peak_19294	316.54	357	0	0	1	other
7	124155407	124155682	MACS_peak_19295	457.69	275	0	0	1	other
7	124165694	124166021	MACS_peak_19296	315.51	327	0	0	1	other
7	124638291	124638505	MACS_peak_19298	916.14	214	0	0	0	intergen
7	124785246	124785482	MACS_peak_19299	514.01	236	0	1	0	gen
7	124856338	124856659	MACS_peak_19300	431.05	321	0	1	0	gen
7	124946209	124946432	MACS_peak_19301	564.54	223	0	0	1	other
7	125221122	125221429	MACS_peak_19302	110.53	307	0	0	1	other
7	125670866	125671304	MACS_peak_19303	599.79	438	0	0	0	intergen
7	126235445	126235661	MACS_peak_19304	286.13	216	0	0	0	intergen
7	126345427	126345670	MACS_peak_19305	56.94	243	0	0	0	intergen
7	126442177	126442492	MACS_peak_19306	349.84	315	1	0	0	promoter
7	126856780	126856976	MACS_peak_19307	848.95	196	0	1	0	gen
7	126900140	126900336	MACS_peak_19308	1025.76	196	0	1	0	gen
7	127107615	127107931	MACS_peak_19309	678.2	316	0	1	0	gen
7	127453863	127454101	MACS_peak_19310	241.08	238	0	0	0	intergen
7	127519768	127520071	MACS_peak_19311	201.59	303	0	0	0	intergen
7	127650702	127650849	MACS_peak_19312	1491.86	147	1	0	1	promoter
7	127854589	127854767	MACS_peak_19313	763.02	178	0	1	0	gen
7	128035844	128036044	MACS_peak_19314	645.81	200	0	1	0	gen
7	128208537	128208738	MACS_peak_19315	814.37	201	0	0	0	intergen
7	128209869	128210058	MACS_peak_19316	695.57	189	0	0	0	intergen
7	128293696	128293971	MACS_peak_19317	73.29	275	1	0	0	promoter
7	128398586	128398842	MACS_peak_19318	470.06	256	0	1	0	gen
7	128461379	128461674	MACS_peak_19319	2296.97	295	0	0	2	other
7	128469666	128469975	MACS_peak_19320	264.65	309	0	0	1	other
7	128474295	128474608	MACS_peak_19321	1102.85	313	1	0	1	promoter
7	128537471	128537764	MACS_peak_19322	1098.77	293	0	0	1	other
7	128608967	128609371	MACS_peak_19323	1069.92	404	0	0	2	other
7	128650253	128650694	MACS_peak_19324	730.17	441	0	0	0	intergen
7	128651577	128651923	MACS_peak_19325	443.19	346	0	0	1	other
7	128666274	128666493	MACS_peak_19326	528	219	0	0	0	intergen
7	128672997	128673380	MACS_peak_19327	489.71	383	1	0	0	promoter
7	129163975	129164421	MACS_peak_19328	482.39	446	0	1	0	gen
7	129210578	129210760	MACS_peak_19329	729.14	182	0	1	1	gen
7	129343150	129343373	MACS_peak_19330	1208.41	223	0	1	0	gen
7	129582802	129582994	MACS_peak_19331	678.9	192	0	0	0	intergen
7	129587781	129587927	MACS_peak_19332	929.86	146	0	0	0	intergen
7	129664487	129664704	MACS_peak_19333	746.04	217	0	1	0	gen
7	129934499	129934769	MACS_peak_19334	439.97	270	0	1	0	gen
7	130010937	130011133	MACS_peak_19335	1094.87	196	0	0	1	other
7	130037814	130038042	MACS_peak_19336	577.34	228	0	1	0	gen
7	130581280	130581468	MACS_peak_19338	50.92	188	0	1	0	gen
7	130721893	130722179	MACS_peak_19339	450.92	286	0	0	0	intergen
7	130875382	130875618	MACS_peak_19340	814.37	236	0	0	2	other
7	130897031	130897246	MACS_peak_19341	1264.23	215	0	0	3	other
7	130982129	130982519	MACS_peak_19342	509.84	390	0	0	2	other
7	131063958	131064370	MACS_peak_19343	899.87	412	0	0	2	other
7	131192227	131192508	MACS_peak_19344	1414.71	281	0	1	0	gen
7	131513552	131513839	MACS_peak_19345	573.07	287	0	1	0	gen
7	131654807	131655124	MACS_peak_19346	941.25	317	0	0	0	intergen
7	131859226	131859466	MACS_peak_19347	502.51	240	0	0	0	intergen
7	132029126	132029450	MACS_peak_19348	114.74	324	0	0	0	intergen
7	132318756	132319019	MACS_peak_19350	465.4	263	0	1	0	gen
7	132986067	132986323	MACS_peak_19351	242.71	256	0	1	0	gen
7	133230656	133230879	MACS_peak_19352	564.54	223	0	0	0	intergen
7	133854715	133855146	MACS_peak_19353	1103.83	431	0	1	0	gen
7	133990976	133991212	MACS_peak_19354	814.37	236	0	1	0	gen
7	134240921	134241277	MACS_peak_19356	175.85	356	0	1	0	gen
7	134244305	134244634	MACS_peak_19358	98.26	329	0	1	0	gen
7	134251547	134251704	MACS_peak_19359	1116.4	157	0	1	0	gen
7	134606433	134606721	MACS_peak_19360	572.35	288	0	0	0	intergen
7	134750204	134750380	MACS_peak_19361	972.07	176	0	1	0	gen
7	134755454	134755771	MACS_peak_19362	303.24	317	0	1	0	gen
7	134954170	134954475	MACS_peak_19363	380.3	305	0	1	0	gen
7	135128285	135128420	MACS_peak_19365	875.17	135	0	2	0	gen
7	135170799	135170977	MACS_peak_19366	763.02	178	0	0	0	intergen
7	135645401	135645865	MACS_peak_19368	823.38	464	0	1	0	gen
7	136009382	136009758	MACS_peak_19369	403.97	376	0	0	0	intergen
7	136097890	136098358	MACS_peak_19370	58.28	468	0	0	1	other
7	136825767	136826111	MACS_peak_19371	951.32	344	0	0	1	other
7	137172757	137173058	MACS_peak_19373	69	301	0	0	1	other
7	137210153	137210453	MACS_peak_19375	69.69	300	0	0	0	intergen
7	137339563	137339697	MACS_peak_19376	1603.94	134	0	1	0	gen
7	137540655	137540803	MACS_peak_19377	3100	148	0	1	0	gen
7	137656262	137656558	MACS_peak_19378	693.99	296	0	1	0	gen
7	137704823	137705059	MACS_peak_19379	516.86	236	0	1	0	gen
7	138008910	138009126	MACS_peak_19380	746.04	216	0	1	0	gen
7	138041627	138041957	MACS_peak_19381	114.74	330	0	1	0	gen
7	138056034	138056197	MACS_peak_19382	197.29	163	0	1	0	gen
7	138077699	138077959	MACS_peak_19383	467.38	260	0	1	0	gen
7	138169057	138169190	MACS_peak_19384	1396.21	133	0	0	0	intergen
7	138532311	138532658	MACS_peak_19385	54.18	347	0	1	0	gen
7	138534874	138535246	MACS_peak_19386	127.5	372	0	1	0	gen
7	138612340	138612561	MACS_peak_19387	468.24	221	0	1	0	gen
7	138707182	138707476	MACS_peak_19388	568.08	294	1	0	0	promoter
7	138811937	138812213	MACS_peak_19389	56.38	276	0	1	0	gen
7	138886386	138886762	MACS_peak_19390	603.02	376	0	1	0	gen
7	139151259	139151547	MACS_peak_19391	416.97	288	0	1	0	gen
7	139184845	139185068	MACS_peak_19392	513.05	223	0	1	0	gen
7	139216425	139216630	MACS_peak_19393	79.93	205	0	0	0	intergen
7	139321050	139321268	MACS_peak_19394	564.92	218	0	0	0	intergen
7	139399337	139399485	MACS_peak_19395	686.78	148	0	2	0	gen
7	139620903	139621164	MACS_peak_19396	466.72	261	0	1	0	gen
7	140304530	140304861	MACS_peak_19397	425.78	331	0	1	0	gen
7	140326390	140326593	MACS_peak_19398	629.38	203	0	1	0	gen
7	140387669	140387902	MACS_peak_19399	831.63	233	0	1	0	gen
7	140712111	140712390	MACS_peak_19400	52.99	279	0	1	0	gen
7	141067590	141067989	MACS_peak_19401	103.92	399	0	0	0	intergen
7	141174617	141174901	MACS_peak_19402	117.26	284	0	1	0	gen
7	141220312	141220673	MACS_peak_19403	410.92	361	0	1	0	gen
7	141533433	141533644	MACS_peak_19404	526.96	211	0	0	1	other
7	141650031	141650272	MACS_peak_19405	797.18	241	0	1	0	gen
7	141816255	141816563	MACS_peak_19406	424.89	308	0	0	0	intergen
7	141974871	141975134	MACS_peak_19408	465.4	263	1	1	0	promoter
7	141980465	141980817	MACS_peak_19409	83.88	352	0	1	0	gen
7	142783423	142783637	MACS_peak_19419	682.16	214	0	0	0	intergen
7	143007891	143008194	MACS_peak_19420	440.97	303	0	0	0	intergen
7	143215012	143215438	MACS_peak_19421	1108.24	426	0	0	0	intergen
7	143345382	143345721	MACS_peak_19422	661.26	339	0	1	0	gen
7	143413947	143414179	MACS_peak_19423	521.25	232	0	0	1	other
7	143639405	143639676	MACS_peak_19425	813.1	271	1	1	1	promoter
7	143727660	143727931	MACS_peak_19426	850.57	271	0	1	0	gen
7	143775507	143775730	MACS_peak_19427	533.91	223	0	0	1	other
7	143817966	143818237	MACS_peak_19428	823.72	271	0	0	1	other
7	143837336	143837600	MACS_peak_19429	464.74	264	0	0	0	intergen
7	143841746	143841984	MACS_peak_19430	729.92	238	0	0	0	intergen
7	143859847	143860227	MACS_peak_19431	312.33	380	0	1	0	gen
7	144027189	144027406	MACS_peak_19432	580.62	217	0	0	0	intergen
7	144057707	144058012	MACS_peak_19433	721.05	305	0	1	0	gen
7	144219162	144219504	MACS_peak_19434	1052.86	342	0	0	1	other
7	144331470	144331812	MACS_peak_19435	1191.46	342	0	0	2	other
7	144454523	144454768	MACS_peak_19436	501.16	245	1	0	0	promoter
7	144664280	144664512	MACS_peak_19437	217.52	232	0	1	0	gen
7	144726788	144727050	MACS_peak_19438	414.85	262	0	1	0	gen
7	144738781	144739039	MACS_peak_19439	595.17	258	0	1	0	gen
7	144757329	144757650	MACS_peak_19440	56.38	321	0	1	0	gen
7	145020079	145020215	MACS_peak_19443	847.14	136	0	0	0	intergen
7	145036654	145037020	MACS_peak_19444	642.83	366	0	0	0	intergen
7	145192823	145193170	MACS_peak_19445	417.69	347	0	0	0	intergen
7	145235014	145235261	MACS_peak_19446	50.7	247	0	0	0	intergen
7	145307176	145307535	MACS_peak_19447	327.44	359	0	0	0	intergen
7	145341962	145342236	MACS_peak_19448	52.87	274	0	0	0	intergen
7	145415738	145416130	MACS_peak_19449	75.01	392	0	0	0	intergen
7	145606384	145606582	MACS_peak_19450	488.65	198	0	0	0	intergen
7	145878146	145878345	MACS_peak_19451	627.67	199	0	0	0	intergen
7	145919368	145919644	MACS_peak_19452	457.06	276	0	0	0	intergen
7	145977665	145978047	MACS_peak_19453	149.97	382	0	0	0	intergen
7	146090044	146090383	MACS_peak_19454	538.66	339	0	0	0	intergen
7	146233887	146234262	MACS_peak_19455	82.76	375	0	1	0	gen
7	146535149	146535506	MACS_peak_19456	528	357	0	1	0	gen
7	146736836	146737129	MACS_peak_19457	568.79	293	0	1	0	gen
7	147015755	147016099	MACS_peak_19458	419.18	344	0	1	0	gen
7	147176598	147177024	MACS_peak_19459	977.27	426	0	1	0	gen
7	147603948	147604335	MACS_peak_19460	79.31	387	0	1	0	gen
7	147775144	147775385	MACS_peak_19461	554.96	241	0	1	0	gen
7	147864444	147864807	MACS_peak_19462	117.4	363	0	1	0	gen
7	148503947	148504238	MACS_peak_19463	830.86	291	0	0	0	intergen
7	148505178	148505410	MACS_peak_19464	831.63	232	0	0	0	intergen
7	148966749	148967076	MACS_peak_19465	570.85	327	0	0	0	intergen
7	149149166	149149421	MACS_peak_19466	580.75	255	0	1	0	gen
7	149275020	149275296	MACS_peak_19467	349.84	276	0	1	0	gen
7	149669270	149669465	MACS_peak_19468	604.07	195	0	0	0	intergen
7	149963937	149964258	MACS_peak_19469	431.05	321	0	0	0	intergen
7	150224800	150225033	MACS_peak_19470	678.9	233	0	0	0	intergen
7	150276117	150276468	MACS_peak_19471	909.63	351	0	1	0	gen
7	150286204	150286438	MACS_peak_19472	532.66	234	0	1	0	gen
7	150299363	150299503	MACS_peak_19473	1313.07	140	0	1	0	gen
7	150756909	150757180	MACS_peak_19474	263.82	271	0	0	0	intergen
7	150810380	150810577	MACS_peak_19475	241.08	197	0	0	0	intergen
7	151172497	151172900	MACS_peak_19476	1129.23	403	1	1	0	promoter
7	151244412	151244664	MACS_peak_19477	613.04	252	0	1	0	gen
7	151302976	151303113	MACS_peak_19478	896.34	137	0	0	0	intergen
7	151315179	151315394	MACS_peak_19479	596.79	215	0	0	0	intergen
7	151316524	151316754	MACS_peak_19480	73.24	230	0	0	0	intergen
7	151546066	151546303	MACS_peak_19481	440.38	237	0	0	0	intergen
7	151754173	151754375	MACS_peak_19482	814.37	202	0	1	0	gen
7	151844530	151844712	MACS_peak_19483	729.14	182	0	1	0	gen
7	151933368	151933531	MACS_peak_19484	848.95	163	0	0	0	intergen
7	152071417	152071775	MACS_peak_19485	148.59	358	0	1	0	gen
7	152208255	152208452	MACS_peak_19486	1065.23	197	0	1	0	gen
7	152336821	152337059	MACS_peak_19487	516.86	238	0	1	0	gen
7	152448434	152448566	MACS_peak_19488	1116.4	132	0	0	0	intergen
7	152821466	152821684	MACS_peak_19489	580.62	218	0	1	0	gen
7	152833509	152833755	MACS_peak_19490	763.02	246	0	1	0	gen
7	152870869	152871192	MACS_peak_19491	416.74	323	0	0	0	intergen
7	153193136	153193409	MACS_peak_19492	713.56	273	0	0	0	intergen
7	153282477	153282718	MACS_peak_19493	1124.11	241	0	0	0	intergen
7	153381498	153381947	MACS_peak_19494	833.5	449	0	0	1	other
7	153466590	153466934	MACS_peak_19495	229.83	344	0	0	0	intergen
7	153744232	153744382	MACS_peak_19497	1189.9	150	0	0	0	intergen
7	153813911	153814237	MACS_peak_19498	65.83	326	0	0	0	intergen
7	153867419	153867841	MACS_peak_19499	57.86	422	0	0	0	intergen
7	154132606	154132940	MACS_peak_19500	424.23	334	0	1	0	gen
7	154504009	154504274	MACS_peak_19501	464.09	265	0	1	0	gen
7	154952904	154953274	MACS_peak_19502	488.85	370	0	1	0	gen
7	155096280	155096657	MACS_peak_19503	142.05	377	0	0	0	intergen
7	155412729	155412991	MACS_peak_19504	591.97	262	0	0	0	intergen
7	155768371	155768643	MACS_peak_19505	735.52	272	0	1	0	gen
7	156719910	156720217	MACS_peak_19506	96.97	307	0	1	0	gen
7	156778251	156778573	MACS_peak_19507	673.67	322	0	1	0	gen
7	156827581	156827962	MACS_peak_19508	514.63	381	0	1	0	gen
7	156909663	156909990	MACS_peak_19509	51.1	327	0	0	0	intergen
7	156949573	156949762	MACS_peak_19510	695.57	189	1	0	0	promoter
7	157250664	157251046	MACS_peak_19511	755.85	382	0	1	0	gen
7	157298369	157298599	MACS_peak_19512	123.06	230	0	0	0	intergen
7	158055134	158055400	MACS_peak_19513	463.44	266	0	1	0	gen
7	158206728	158207050	MACS_peak_19514	136.91	322	0	1	0	gen
7	158620092	158620373	MACS_peak_19515	1414.71	281	0	0	0	intergen
7	158660394	158660534	MACS_peak_19516	551.66	140	0	1	0	gen
7	158696125	158696368	MACS_peak_19517	554.96	243	0	1	0	gen
7	158885737	158886009	MACS_peak_19518	423.73	272	0	1	0	gen
7	159132763	159133113	MACS_peak_19519	910.51	350	0	1	0	gen
8	70960	71348	MACS_peak_19527	622.99	388	0	0	0	intergen
8	116274	116540	MACS_peak_19530	709.89	266	0	0	0	intergen
8	143865	144128	MACS_peak_19531	272.99	263	0	0	0	intergen
8	150968	151151	MACS_peak_19532	321.05	183	0	0	0	intergen
8	164877	165273	MACS_peak_19533	794.78	396	1	0	0	promoter
8	190071	190409	MACS_peak_19534	141.67	338	0	0	0	intergen
8	299267	299600	MACS_peak_19535	925.96	333	0	0	0	intergen
8	359466	359699	MACS_peak_19536	416.25	233	0	0	0	intergen
8	1169958	1170437	MACS_peak_19537	64.38	479	0	1	0	gen
8	1275783	1276062	MACS_peak_19538	1268.9	279	0	1	0	gen
8	1678765	1678981	MACS_peak_19539	580.62	216	0	1	0	gen
8	1969415	1969678	MACS_peak_19540	722.6	263	1	0	0	promoter
8	2295307	2295683	MACS_peak_19541	403.97	376	0	0	0	intergen
8	2317915	2318349	MACS_peak_19542	64.79	434	0	0	0	intergen
8	2320576	2320874	MACS_peak_19543	102.17	298	0	0	0	intergen
8	3150941	3151217	MACS_peak_19545	1273.02	276	0	1	0	gen
8	3452444	3452859	MACS_peak_19546	52.67	415	0	1	0	gen
8	3660384	3660641	MACS_peak_19547	592.79	257	0	1	0	gen
8	3795415	3795747	MACS_peak_19548	926.89	332	0	1	0	gen
8	3796037	3796502	MACS_peak_19549	947.23	465	0	1	0	gen
8	4059337	4059730	MACS_peak_19550	75.42	393	0	1	0	gen
8	4707782	4708021	MACS_peak_19551	277.9	239	0	1	0	gen
8	4875400	4875649	MACS_peak_19552	485.56	249	0	1	0	gen
8	5652203	5652584	MACS_peak_19553	514.63	381	0	0	0	intergen
8	5883956	5884334	MACS_peak_19554	114.74	378	0	0	0	intergen
8	6845715	6846094	MACS_peak_19556	70.48	379	0	0	1	other
8	6849522	6849899	MACS_peak_19557	159.66	377	0	0	1	other
8	7035830	7036055	MACS_peak_19558	686.79	225	0	0	0	intergen
8	7108636	7109042	MACS_peak_19559	1400.77	406	0	0	1	other
8	7448196	7448493	MACS_peak_19560	1101.6	297	0	1	0	gen
8	7469688	7469977	MACS_peak_19561	571.63	289	1	0	0	promoter
8	7499047	7499334	MACS_peak_19562	303.57	287	1	0	0	promoter
8	7505357	7505667	MACS_peak_19563	163.41	310	0	1	0	gen
8	7611129	7611356	MACS_peak_19564	687.06	227	0	0	0	intergen
8	7841572	7841861	MACS_peak_19565	571.63	289	0	0	0	intergen
8	7863052	7863248	MACS_peak_19566	1226.97	196	0	1	0	gen
8	8059159	8059343	MACS_peak_19567	720.32	184	0	0	0	intergen
8	8165621	8166004	MACS_peak_19568	257	383	0	0	2	other
8	8177377	8177769	MACS_peak_19569	1993.08	392	0	0	3	other
8	8198905	8199340	MACS_peak_19570	564.7	435	0	0	3	other
8	8201117	8201484	MACS_peak_19571	1078.73	367	0	0	2	other
8	8736980	8737264	MACS_peak_19572	837.6	284	0	0	1	other
8	8976421	8976796	MACS_peak_19573	391.26	375	0	0	1	other
8	9736458	9736716	MACS_peak_19575	76.3	258	0	1	0	gen
8	9760566	9760897	MACS_peak_19576	381.49	331	0	1	0	gen
8	9830945	9831325	MACS_peak_19577	885.03	380	0	0	0	intergen
8	11246963	11247177	MACS_peak_19578	596.79	214	0	0	0	intergen
8	11314593	11314800	MACS_peak_19579	596.67	207	0	1	0	gen
8	11765529	11765736	MACS_peak_19580	603.96	207	1	0	0	promoter
8	11839579	11839813	MACS_peak_19581	706.21	234	1	0	0	promoter
8	12221675	12222042	MACS_peak_19583	958.48	367	0	0	0	intergen
8	12223821	12224259	MACS_peak_19584	1097.74	438	0	0	0	intergen
8	12464197	12464564	MACS_peak_19586	841.34	367	0	0	1	other
8	12466331	12466769	MACS_peak_19587	967.74	438	0	0	1	other
8	12487893	12488285	MACS_peak_19588	2130.91	392	0	0	2	other
8	12499552	12499910	MACS_peak_19589	265.34	358	0	0	2	other
8	12607576	12607851	MACS_peak_19590	653.2	275	0	0	1	other
8	12642620	12642859	MACS_peak_19591	954.29	239	0	0	1	other
8	12840723	12840986	MACS_peak_19592	591.18	263	0	0	0	intergen
8	13182427	13182809	MACS_peak_19593	75.01	382	0	1	0	gen
8	13727755	13727975	MACS_peak_19594	564.54	220	0	0	0	intergen
8	13953613	13953915	MACS_peak_19595	488.85	302	0	0	0	intergen
8	14264438	14264730	MACS_peak_19596	295.21	292	0	1	0	gen
8	14402712	14403132	MACS_peak_19597	66.38	420	0	1	0	gen
8	14457176	14457333	MACS_peak_19598	1028.85	157	0	1	0	gen
8	14551389	14551640	MACS_peak_19599	360.54	251	0	1	0	gen
8	14808202	14808464	MACS_peak_19601	118.49	262	0	1	0	gen
8	14826464	14826814	MACS_peak_19602	137.06	350	0	1	0	gen
8	15378331	15378769	MACS_peak_19604	841.15	438	0	0	0	intergen
8	15581665	15581940	MACS_peak_19605	145.37	275	0	1	0	gen
8	15857571	15857779	MACS_peak_19606	474.71	208	0	0	0	intergen
8	16189421	16189784	MACS_peak_19607	406.81	363	0	1	0	gen
8	16674191	16674384	MACS_peak_19608	77.18	193	0	0	1	other
8	16908685	16908910	MACS_peak_19609	866.35	225	0	0	1	other
8	16946357	16946758	MACS_peak_19610	54.34	401	0	0	0	intergen
8	17495283	17495540	MACS_peak_19611	469.39	257	1	0	0	promoter
8	17871498	17871764	MACS_peak_19612	560.75	266	0	1	0	gen
8	18002371	18002681	MACS_peak_19614	100.2	310	0	1	0	gen
8	18002731	18003017	MACS_peak_19615	124.29	286	0	1	0	gen
8	18191417	18191842	MACS_peak_19616	65.91	425	0	1	0	gen
8	18208902	18209099	MACS_peak_19617	831.63	197	0	1	0	gen
8	18538558	18538846	MACS_peak_19618	449.72	288	0	1	0	gen
8	18569609	18569999	MACS_peak_19619	102.26	390	0	1	0	gen
8	18594124	18594564	MACS_peak_19620	739.23	440	0	1	0	gen
8	18597715	18598007	MACS_peak_19621	55.51	292	0	1	0	gen
8	18752422	18752706	MACS_peak_19622	488.85	284	0	1	0	gen
8	19346439	19346761	MACS_peak_19623	673.67	322	0	1	0	gen
8	19372120	19372354	MACS_peak_19624	662.31	234	0	1	0	gen
8	19440408	19440727	MACS_peak_19625	55.34	319	0	1	0	gen
8	19870381	19870644	MACS_peak_19626	858.87	263	0	0	0	intergen
8	19933786	19934240	MACS_peak_19627	70.13	454	0	1	0	gen
8	20503665	20503986	MACS_peak_19628	778.98	321	0	0	0	intergen
8	20680665	20680814	MACS_peak_19630	1665.64	149	0	0	1	other
8	20747570	20747946	MACS_peak_19632	105.65	376	0	0	0	intergen
8	21024149	21024291	MACS_peak_19634	879.24	142	0	0	1	other
8	21338822	21339174	MACS_peak_19635	69	352	0	0	0	intergen
8	21623928	21624211	MACS_peak_19636	452.74	283	0	0	0	intergen
8	21830100	21830492	MACS_peak_19637	86.78	392	0	0	0	intergen
8	22422594	22422929	MACS_peak_19638	565.1	335	0	1	0	gen
8	22489475	22489820	MACS_peak_19639	783.88	345	0	1	0	gen
8	22561894	22562090	MACS_peak_19640	662.31	196	0	1	0	gen
8	22574497	22574756	MACS_peak_19641	726.32	259	1	1	0	promoter
8	22756173	22756491	MACS_peak_19642	432.66	318	0	1	1	gen
8	22898287	22898517	MACS_peak_19643	1582.7	230	0	1	0	gen
8	23589630	23589832	MACS_peak_19644	645.81	202	0	0	0	intergen
8	23692603	23692998	MACS_peak_19645	507.23	395	0	0	0	intergen
8	23876168	23876312	MACS_peak_19646	2107.44	144	0	0	0	intergen
8	23893761	23894109	MACS_peak_19647	417.2	348	0	0	0	intergen
8	24045190	24045322	MACS_peak_19648	572.98	132	0	0	0	intergen
8	24511516	24511877	MACS_peak_19649	410.92	361	0	1	2	gen
8	24781479	24781958	MACS_peak_19650	109.56	479	0	0	1	other
8	25000007	25000258	MACS_peak_19651	485.56	251	0	0	1	other
8	25008686	25008819	MACS_peak_19652	1125.13	133	0	0	1	other
8	25170130	25170569	MACS_peak_19653	599.25	439	0	0	0	intergen
8	25172537	25172850	MACS_peak_19654	555.13	313	0	0	0	intergen
8	25281631	25281911	MACS_peak_19655	578.19	280	0	1	0	gen
8	25605598	25605889	MACS_peak_19656	265.34	291	0	0	0	intergen
8	25731441	25731723	MACS_peak_19657	55.84	282	0	0	0	intergen
8	25731893	25732165	MACS_peak_19658	50.79	272	0	0	0	intergen
8	26005221	26005553	MACS_peak_19659	723.14	332	0	1	0	gen
8	26221788	26222138	MACS_peak_19660	845.32	350	0	0	0	intergen
8	26243070	26243388	MACS_peak_19661	488.85	318	0	0	0	intergen
8	26499288	26499562	MACS_peak_19663	458.32	274	0	1	0	gen
8	26571298	26571497	MACS_peak_19664	831.63	199	0	1	0	gen
8	26803603	26803802	MACS_peak_19665	762.11	199	0	1	0	gen
8	27114060	27114481	MACS_peak_19666	141.15	421	0	0	0	intergen
8	27426232	27426506	MACS_peak_19670	458.32	274	0	1	0	gen
8	27597216	27597497	MACS_peak_19672	577.45	281	1	0	0	promoter
8	28260131	28260280	MACS_peak_19673	954.29	149	0	0	1	other
8	28619017	28619398	MACS_peak_19674	199.17	381	0	1	0	gen
8	28839699	28840042	MACS_peak_19675	51.97	343	0	1	0	gen
8	29004383	29004649	MACS_peak_19676	463.44	266	0	1	0	gen
8	29666636	29667105	MACS_peak_19677	699.65	469	0	0	0	intergen
8	30447572	30447817	MACS_peak_19678	918.92	245	0	1	0	gen
8	31498810	31499197	MACS_peak_19679	64.95	387	0	0	0	intergen
8	31567894	31568277	MACS_peak_19680	98.2	383	0	0	0	intergen
8	31596156	31596314	MACS_peak_19681	883.81	158	0	0	0	intergen
8	31856052	31856412	MACS_peak_19682	87.36	360	0	1	0	gen
8	32173458	32173792	MACS_peak_19683	60.1	334	0	1	0	gen
8	32463788	32464017	MACS_peak_19684	1718.92	229	0	1	0	gen
8	32736397	32736719	MACS_peak_19685	430.51	322	0	1	0	gen
8	33319524	33319791	MACS_peak_19687	462.79	267	0	0	0	intergen
8	33495597	33495737	MACS_peak_19688	1111.4	140	0	2	0	gen
8	33588639	33588985	MACS_peak_19689	69	346	1	0	0	promoter
8	34059943	34060302	MACS_peak_19690	117.53	359	0	0	0	intergen
8	34216611	34216947	MACS_peak_19691	83.45	336	0	0	0	intergen
8	34456064	34456221	MACS_peak_19692	662.82	157	0	0	0	intergen
8	34544477	34544827	MACS_peak_19693	96.97	350	0	0	0	intergen
8	34545595	34546015	MACS_peak_19694	76.7	420	0	0	0	intergen
8	34780528	34780838	MACS_peak_19695	212.74	310	0	0	0	intergen
8	35467468	35467602	MACS_peak_19699	1098.16	134	0	1	0	gen
8	35603300	35603725	MACS_peak_19700	223.46	425	0	1	0	gen
8	35987427	35987791	MACS_peak_19701	140.51	364	0	0	0	intergen
8	36831297	36831762	MACS_peak_19702	63.79	465	0	1	0	gen
8	37193320	37193613	MACS_peak_19703	145.37	293	0	0	0	intergen
8	37533989	37534282	MACS_peak_19704	446.75	293	0	0	1	other
8	38073592	38073921	MACS_peak_19705	649.88	329	0	0	0	intergen
8	38074340	38074755	MACS_peak_19706	497.11	415	0	0	0	intergen
8	38074927	38075339	MACS_peak_19707	595.96	412	0	0	0	intergen
8	38508968	38509281	MACS_peak_19708	422.13	313	1	0	0	promoter
8	38856199	38856431	MACS_peak_19709	532.66	232	0	0	0	intergen
8	39327423	39327826	MACS_peak_19710	503.12	403	0	0	1	other
8	39907767	39908008	MACS_peak_19712	253.02	241	0	1	1	gen
8	39995738	39996031	MACS_peak_19713	568.79	293	0	1	0	gen
8	40095187	40095513	MACS_peak_19714	737.12	326	0	0	0	intergen
8	40432612	40432908	MACS_peak_19715	73.35	296	0	0	0	intergen
8	41581568	41581918	MACS_peak_19716	171.16	350	1	0	0	promoter
8	42172251	42172494	MACS_peak_19717	651.03	243	1	0	0	promoter
8	42385480	42385729	MACS_peak_19718	748.7	249	0	0	0	intergen
8	42727870	42728093	MACS_peak_19719	549.18	223	0	1	0	gen
8	43323321	43323710	MACS_peak_19722	57.86	389	0	0	1	other
8	43393836	43394263	MACS_peak_19723	50.05	427	0	0	0	intergen
8	43425425	43425656	MACS_peak_19724	345.6	231	0	0	0	intergen
8	43428084	43428454	MACS_peak_19725	93.4	370	0	0	0	intergen
8	43536906	43537069	MACS_peak_19726	1049.46	163	0	0	0	intergen
8	43707147	43707501	MACS_peak_19727	76.3	354	0	0	0	intergen
8	43855324	43855560	MACS_peak_19728	516.86	236	0	0	0	intergen
8	43898301	43898572	MACS_peak_19729	265.34	271	0	0	0	intergen
8	43913059	43913396	MACS_peak_19732	91.92	337	0	0	0	intergen
8	43914265	43914606	MACS_peak_19733	147.82	341	0	0	0	intergen
8	43915155	43915566	MACS_peak_19734	60	411	0	0	0	intergen
8	43925781	43926229	MACS_peak_19737	124.89	448	0	0	0	intergen
8	43946810	43947095	MACS_peak_19742	118.3	285	0	0	0	intergen
8	43948542	43948830	MACS_peak_19743	267.08	288	0	0	0	intergen
8	43953432	43953679	MACS_peak_19744	138.25	247	0	0	0	intergen
8	43956504	43956715	MACS_peak_19746	280.56	211	0	0	0	intergen
8	45953013	45953298	MACS_peak_19747	70.3	285	0	0	0	intergen
8	45953783	45954158	MACS_peak_19748	61.04	375	0	0	0	intergen
8	45954747	45955033	MACS_peak_19749	75.42	286	0	0	0	intergen
8	45960453	45960865	MACS_peak_19751	87.66	412	0	0	0	intergen
8	45962191	45962402	MACS_peak_19752	83.93	211	0	0	0	intergen
8	45963732	45963943	MACS_peak_19754	280.05	211	0	0	0	intergen
8	45991445	45991655	MACS_peak_19756	170.73	210	0	0	0	intergen
8	45991971	45992317	MACS_peak_19757	106.37	346	0	0	0	intergen
8	45993975	45994298	MACS_peak_19758	114.74	323	0	0	0	intergen
8	46630263	46630475	MACS_peak_19759	71.98	212	0	0	1	other
8	46668298	46668535	MACS_peak_19760	1608.09	237	0	0	0	intergen
8	46706994	46707269	MACS_peak_19761	571.52	275	0	0	0	intergen
8	46708276	46708431	MACS_peak_19762	879.27	155	0	0	0	intergen
8	46831945	46832239	MACS_peak_19763	219.32	294	0	0	1	other
8	46957010	46957346	MACS_peak_19764	923.17	336	0	0	0	intergen
8	46983936	46984338	MACS_peak_19765	93.39	402	0	0	0	intergen
8	47021189	47021550	MACS_peak_19766	60.35	361	0	0	0	intergen
8	47099251	47099448	MACS_peak_19767	88.2	197	0	0	1	other
8	47234960	47235309	MACS_peak_19768	75.01	349	0	0	0	intergen
8	47305035	47305279	MACS_peak_19769	498.41	244	0	1	0	gen
8	47354121	47354412	MACS_peak_19770	603.02	291	0	1	0	gen
8	47395594	47395935	MACS_peak_19771	1102.85	341	0	1	0	gen
8	47446580	47446744	MACS_peak_19772	1036.76	164	0	1	0	gen
8	47488153	47488502	MACS_peak_19773	114.74	349	0	1	0	gen
8	47685373	47685514	MACS_peak_19774	1025.76	141	0	1	0	gen
8	47754420	47754725	MACS_peak_19775	178.37	305	0	0	0	intergen
8	47917376	47917620	MACS_peak_19776	635.03	244	0	1	0	gen
8	48172131	48172430	MACS_peak_19777	691.56	299	0	0	0	intergen
8	48798775	48799148	MACS_peak_19778	66.69	373	0	0	0	intergen
8	48925518	48925890	MACS_peak_19779	763.14	372	0	0	0	intergen
8	48957537	48957898	MACS_peak_19780	56.38	361	0	0	0	intergen
8	49001204	49001601	MACS_peak_19781	57.73	397	0	0	0	intergen
8	49002743	49002969	MACS_peak_19782	88.09	226	0	0	0	intergen
8	49451712	49452163	MACS_peak_19783	63.13	451	0	0	0	intergen
8	49536449	49536914	MACS_peak_19784	3100	465	0	0	1	other
8	49560813	49561074	MACS_peak_19785	466.72	261	0	0	0	intergen
8	50087942	50088354	MACS_peak_19786	141.7	412	0	1	0	gen
8	50089173	50089484	MACS_peak_19787	104.1	311	0	1	0	gen
8	50213575	50214035	MACS_peak_19788	93.78	460	0	1	0	gen
8	50908233	50908370	MACS_peak_19789	693.63	137	0	0	0	intergen
8	51526148	51526540	MACS_peak_19790	1236.43	392	0	1	0	gen
8	51599789	51600176	MACS_peak_19791	690.52	387	0	1	0	gen
8	51735420	51735560	MACS_peak_19792	1154.94	140	0	1	0	gen
8	51810893	51811204	MACS_peak_19793	791.19	311	0	0	0	intergen
8	51817058	51817220	MACS_peak_19794	736.56	162	1	0	0	promoter
8	52014308	52014612	MACS_peak_19795	561.16	304	0	0	1	other
8	52042952	52043317	MACS_peak_19796	119.84	365	0	0	0	intergen
8	52044114	52044427	MACS_peak_19797	69.25	313	0	0	0	intergen
8	52112398	52112665	MACS_peak_19798	994.68	267	1	0	0	promoter
8	52407676	52407960	MACS_peak_19799	575.25	284	0	1	0	gen
8	52510064	52510493	MACS_peak_19800	88.88	429	0	0	0	intergen
8	52622275	52622584	MACS_peak_19801	437.6	309	1	0	0	promoter
8	52698585	52698725	MACS_peak_19802	791.44	140	0	1	0	gen
8	52737149	52737411	MACS_peak_19803	466.05	262	0	1	0	gen
8	52927864	52928196	MACS_peak_19804	425.26	332	0	0	0	intergen
8	53000673	53001084	MACS_peak_19805	2141.17	411	0	0	0	intergen
8	53043423	53043760	MACS_peak_19806	52.99	337	0	0	0	intergen
8	53286787	53286950	MACS_peak_19807	743.8	163	0	0	0	intergen
8	53588142	53588415	MACS_peak_19808	458.95	273	0	0	0	intergen
8	53681185	53681661	MACS_peak_19809	55.51	476	0	0	0	intergen
8	53696273	53696588	MACS_peak_19810	54.85	315	0	0	0	intergen
8	53698882	53699125	MACS_peak_19811	119.29	243	0	0	0	intergen
8	53808837	53809086	MACS_peak_19812	901.33	249	0	1	0	gen
8	54010450	54010732	MACS_peak_19813	576.71	282	0	1	0	gen
8	54024036	54024237	MACS_peak_19814	554.96	201	0	0	0	intergen
8	54234535	54234833	MACS_peak_19815	297.73	298	0	0	0	intergen
8	54280624	54280849	MACS_peak_19816	1075.91	225	0	0	0	intergen
8	54668496	54668852	MACS_peak_19817	103.45	356	0	1	0	gen
8	54693451	54693764	MACS_peak_19818	92.02	313	0	1	0	gen
8	54694842	54695187	MACS_peak_19819	62.38	345	0	1	0	gen
8	54727812	54728004	MACS_peak_19820	1061.85	192	0	1	0	gen
8	54831819	54832163	MACS_peak_19821	374.96	344	0	1	0	gen
8	55302315	55302652	MACS_peak_19822	51.35	337	0	1	0	gen
8	55653092	55653458	MACS_peak_19823	89.02	366	0	0	0	intergen
8	55842070	55842419	MACS_peak_19824	257.95	349	0	0	0	intergen
8	56010529	56010898	MACS_peak_19825	722.05	369	0	1	0	gen
8	56093780	56094019	MACS_peak_19826	645.81	239	0	0	0	intergen
8	56241998	56242245	MACS_peak_19827	629.38	247	0	0	0	intergen
8	56262433	56262759	MACS_peak_19828	62.68	326	0	0	0	intergen
8	56327520	56327881	MACS_peak_19829	343.36	361	0	0	0	intergen
8	56335483	56335940	MACS_peak_19830	58.63	457	0	0	0	intergen
8	56344174	56344432	MACS_peak_19831	84.98	258	0	0	0	intergen
8	56787568	56787873	MACS_peak_19832	686.76	305	0	0	0	intergen
8	56819697	56820005	MACS_peak_19833	752	308	0	0	0	intergen
8	56852852	56853231	MACS_peak_19834	68.83	379	0	0	0	intergen
8	56929206	56929422	MACS_peak_19835	746.04	216	0	0	0	intergen
8	56970738	56971065	MACS_peak_19836	427.87	327	0	1	0	gen
8	57343406	57343627	MACS_peak_19838	1043.77	221	0	0	0	intergen
8	57420570	57420849	MACS_peak_19839	162.25	279	0	0	0	intergen
8	57492603	57492853	MACS_peak_19840	613.04	250	0	0	0	intergen
8	57960980	57961409	MACS_peak_19842	60	429	0	0	1	other
8	57997042	57997210	MACS_peak_19843	1001.34	168	1	0	0	promoter
8	58375072	58375291	MACS_peak_19844	97.43	219	0	0	0	intergen
8	58513308	58513583	MACS_peak_19845	711.8	275	0	0	0	intergen
8	58608634	58608923	MACS_peak_19846	571.63	289	0	1	0	gen
8	58807872	58808196	MACS_peak_19847	672.17	324	1	0	0	promoter
8	59465000	59465342	MACS_peak_19848	59.66	342	0	0	0	intergen
8	59535153	59535590	MACS_peak_19849	93.2	437	0	0	0	intergen
8	59871765	59872081	MACS_peak_19850	58.14	316	0	0	0	intergen
8	60136210	60136385	MACS_peak_19851	780.06	175	0	0	0	intergen
8	60165185	60165432	MACS_peak_19852	88.83	247	0	0	0	intergen
8	60233256	60233460	MACS_peak_19853	629.38	204	0	1	0	gen
8	60546788	60547146	MACS_peak_19854	172.39	358	0	1	0	gen
8	60617215	60617394	MACS_peak_19855	954.29	179	0	1	0	gen
8	61027220	61027526	MACS_peak_19856	439.28	306	0	0	0	intergen
8	61244042	61244277	MACS_peak_19857	516.86	235	0	1	0	gen
8	61468862	61469068	MACS_peak_19858	629.38	206	0	1	0	gen
8	61482809	61483145	MACS_peak_19859	62.38	336	0	1	0	gen
8	61563343	61563558	MACS_peak_19860	596.79	215	0	1	0	gen
8	61613890	61614243	MACS_peak_19861	406.81	353	0	1	0	gen
8	61652826	61653086	MACS_peak_19862	862.05	260	0	1	0	gen
8	61711104	61711471	MACS_peak_19863	522.32	367	0	1	0	gen
8	61751887	61752316	MACS_peak_19864	101.68	429	0	0	0	intergen
8	61998487	61998710	MACS_peak_19865	105.62	223	0	0	0	intergen
8	62079431	62079788	MACS_peak_19866	98.33	357	0	0	0	intergen
8	62131191	62131383	MACS_peak_19867	587.73	192	0	0	0	intergen
8	62239757	62239968	MACS_peak_19868	550.04	211	0	0	1	other
8	62773016	62773301	MACS_peak_19869	574.52	285	0	1	0	gen
8	62800601	62800984	MACS_peak_19870	118.1	383	0	1	0	gen
8	62814645	62815085	MACS_peak_19871	100.78	440	0	1	0	gen
8	63111142	63111539	MACS_peak_19872	506.19	397	0	0	0	intergen
8	63261958	63262236	MACS_peak_19873	455.81	278	0	0	0	intergen
8	63405574	63405890	MACS_peak_19874	93.4	316	0	0	1	other
8	63500966	63501143	MACS_peak_19875	571.49	177	0	0	0	intergen
8	63566674	63566927	MACS_peak_19876	596.79	253	0	0	0	intergen
8	63865113	63865462	MACS_peak_19877	534.92	349	0	0	1	other
8	64107002	64107435	MACS_peak_19879	62.68	433	0	0	1	other
8	64457838	64458193	MACS_peak_19880	529.16	355	0	0	0	intergen
8	64497519	64497879	MACS_peak_19881	618.85	360	0	0	0	intergen
8	64549599	64549754	MACS_peak_19882	653.77	155	0	0	0	intergen
8	64665458	64665597	MACS_peak_19883	1605.8	139	0	1	0	gen
8	64695595	64696021	MACS_peak_19884	634.13	426	0	1	0	gen
8	64960438	64960800	MACS_peak_19885	67.01	362	0	0	0	intergen
8	65123534	65123806	MACS_peak_19886	106.32	272	0	0	0	intergen
8	65436259	65436606	MACS_peak_19887	86	347	0	0	0	intergen
8	65437213	65437582	MACS_peak_19888	78.17	369	0	0	0	intergen
8	65706141	65706390	MACS_peak_19889	613.04	249	0	1	0	gen
8	65761945	65762201	MACS_peak_19890	434.14	256	0	2	0	gen
8	65995694	65996072	MACS_peak_19891	114.31	378	0	0	0	intergen
8	66036622	66036989	MACS_peak_19892	408.1	367	0	1	0	gen
8	66421734	66422084	MACS_peak_19893	416.22	350	0	0	1	other
8	66577124	66577414	MACS_peak_19894	64.51	290	0	1	0	gen
8	66579017	66579362	MACS_peak_19895	118.46	345	0	1	0	gen
8	66703565	66703934	MACS_peak_19896	142.05	369	0	1	0	gen
8	66843985	66844122	MACS_peak_19897	567.81	137	0	1	0	gen
8	67462820	67463087	MACS_peak_19900	3100	267	0	1	0	gen
8	67490293	67490573	MACS_peak_19901	764.24	280	0	1	0	gen
8	67654323	67654667	MACS_peak_19902	69	344	0	1	0	gen
8	67732954	67733323	MACS_peak_19903	258.94	369	0	1	1	gen
8	67754953	67755306	MACS_peak_19904	50.6	353	0	0	0	intergen
8	68338550	68338752	MACS_peak_19905	645.81	202	0	1	0	gen
8	68506699	68506995	MACS_peak_19906	566.68	296	0	1	0	gen
8	68622558	68622814	MACS_peak_19908	1153.04	256	0	1	0	gen
8	68966956	68967178	MACS_peak_19909	564.54	222	0	0	1	other
8	69024299	69024607	MACS_peak_19910	71.02	308	0	0	1	other
8	69127726	69128170	MACS_peak_19911	69.92	444	0	0	0	intergen
8	69556324	69556620	MACS_peak_19913	693.99	296	0	1	0	gen
8	69946136	69946445	MACS_peak_19914	683.61	309	0	0	0	intergen
8	70113676	70113890	MACS_peak_19915	596.79	214	1	0	0	promoter
8	70114778	70115020	MACS_peak_19916	402.63	242	0	1	0	gen
8	70608260	70608613	MACS_peak_19917	1179.44	353	0	0	0	intergen
8	70740132	70740521	MACS_peak_19919	57.86	389	0	1	1	gen
8	70835017	70835190	MACS_peak_19920	780.06	173	0	0	1	other
8	71254140	71254272	MACS_peak_19921	1090.31	132	0	1	0	gen
8	71408116	71408477	MACS_peak_19922	75.93	361	0	1	0	gen
8	71744597	71744991	MACS_peak_19924	62.78	394	0	0	0	intergen
8	71823916	71824299	MACS_peak_19925	63.32	383	0	0	0	intergen
8	71824998	71825282	MACS_peak_19926	50.77	284	0	0	0	intergen
8	71827915	71828277	MACS_peak_19927	718.95	362	0	0	0	intergen
8	71882429	71882718	MACS_peak_19928	535.99	289	0	0	1	other
8	72092545	72092913	MACS_peak_19929	312.33	368	0	0	1	other
8	72152456	72152799	MACS_peak_19930	67.46	343	0	0	0	intergen
8	72319831	72320082	MACS_peak_19931	396.05	251	0	0	0	intergen
8	72481831	72482065	MACS_peak_19932	91.87	234	0	0	0	intergen
8	72513009	72513379	MACS_peak_19933	406.71	370	0	0	0	intergen
8	72918625	72918856	MACS_peak_19934	532.66	231	0	1	0	gen
8	73037588	73037868	MACS_peak_19935	1267.54	280	0	1	0	gen
8	73058249	73058578	MACS_peak_19936	88.87	329	0	0	1	other
8	73174267	73174594	MACS_peak_19937	931.6	327	0	0	0	intergen
8	73255526	73255768	MACS_peak_19938	74.77	242	0	1	0	gen
8	73305587	73305830	MACS_peak_19939	645.81	243	0	1	1	gen
8	73350279	73350502	MACS_peak_19940	161.29	223	0	0	1	other
8	73467901	73468265	MACS_peak_19941	82.74	364	0	1	0	gen
8	73687130	73687452	MACS_peak_19942	386.17	322	1	1	1	promoter
8	74251956	74252206	MACS_peak_19943	105.81	250	0	1	0	gen
8	74344868	74345000	MACS_peak_19944	1116.4	132	0	1	0	gen
8	74366080	74366390	MACS_peak_19945	366.49	310	0	1	0	gen
8	74596296	74596654	MACS_peak_19946	95.51	358	0	0	0	intergen
8	74853387	74853799	MACS_peak_19947	482.81	412	0	1	1	gen
8	74931957	74932319	MACS_peak_19948	521.98	362	0	0	0	intergen
8	75280419	75280711	MACS_peak_19949	77.14	292	0	0	1	other
8	75280719	75281118	MACS_peak_19950	76.92	399	0	0	1	other
8	75329203	75329501	MACS_peak_19951	75.01	298	0	0	0	intergen
8	75353419	75353639	MACS_peak_19952	84.3	220	0	0	0	intergen
8	75354969	75355306	MACS_peak_19953	65.54	337	0	0	0	intergen
8	75372526	75372812	MACS_peak_19954	973.26	286	0	0	0	intergen
8	75483409	75483754	MACS_peak_19955	783.88	345	0	1	0	gen
8	75648221	75648635	MACS_peak_19956	348.12	414	0	0	0	intergen
8	76190030	76190300	MACS_peak_19957	460.86	270	0	0	0	intergen
8	76309041	76309334	MACS_peak_19958	66.22	293	0	0	0	intergen
8	76324829	76325174	MACS_peak_19959	312.33	345	0	0	0	intergen
8	76565270	76565585	MACS_peak_19960	363.79	315	0	0	1	other
8	77006907	77007129	MACS_peak_19961	513.05	222	0	0	0	intergen
8	77045973	77046351	MACS_peak_19963	125.78	378	0	0	0	intergen
8	77069567	77069778	MACS_peak_19964	596.79	211	0	0	0	intergen
8	77201374	77201506	MACS_peak_19965	596.32	132	0	0	0	intergen
8	77276086	77276393	MACS_peak_19966	81.63	307	0	0	0	intergen
8	77477123	77477387	MACS_peak_19967	380.3	264	0	0	1	other
8	77606226	77606462	MACS_peak_19968	564.74	236	0	0	0	intergen
8	77759913	77760172	MACS_peak_19969	863.12	259	0	0	0	intergen
8	77919495	77919924	MACS_peak_19970	469.55	429	0	0	0	intergen
8	78017494	78017718	MACS_peak_19971	712.32	224	0	0	0	intergen
8	78040148	78040410	MACS_peak_19972	723.53	262	0	0	0	intergen
8	78126913	78127187	MACS_peak_19973	458.32	274	0	0	0	intergen
8	78231552	78231935	MACS_peak_19974	684.11	383	0	0	0	intergen
8	78250734	78250968	MACS_peak_19975	532.66	234	0	0	0	intergen
8	78387977	78388207	MACS_peak_19976	989.9	230	0	0	0	intergen
8	78393468	78393737	MACS_peak_19977	717.14	269	0	0	0	intergen
8	78428402	78428678	MACS_peak_19978	259.8	276	0	0	1	other
8	78507631	78507842	MACS_peak_19979	1123.36	211	0	0	1	other
8	78615245	78615518	MACS_peak_19980	1130.76	273	0	0	0	intergen
8	78633996	78634179	MACS_peak_19981	1339.36	183	0	0	0	intergen
8	78692955	78693235	MACS_peak_19982	50.92	280	0	2	0	gen
8	78720319	78720622	MACS_peak_19983	440.97	303	0	1	0	gen
8	78776289	78776537	MACS_peak_19984	613.04	248	0	1	0	gen
8	78790662	78790936	MACS_peak_19985	650.03	274	0	1	0	gen
8	78921388	78921647	MACS_peak_19986	668.4	259	0	0	1	other
8	78962785	78963060	MACS_peak_19987	844.16	275	0	0	0	intergen
8	79171968	79172215	MACS_peak_19988	79.93	247	0	0	0	intergen
8	79645542	79645798	MACS_peak_19989	456.71	256	0	1	0	gen
8	79823791	79823979	MACS_peak_19991	635.07	188	0	0	1	other
8	79986663	79986924	MACS_peak_19992	66.48	261	0	2	0	gen
8	80006593	80006839	MACS_peak_19993	84.34	246	0	2	0	gen
8	80008070	80008484	MACS_peak_19994	94.8	414	0	2	0	gen
8	80023542	80023957	MACS_peak_19995	959.75	415	0	2	0	gen
8	80067229	80067446	MACS_peak_19996	1805.04	217	0	2	0	gen
8	80085092	80085334	MACS_peak_19997	501.16	242	0	1	0	gen
8	80118458	80118650	MACS_peak_19998	884.92	192	0	1	0	gen
8	80580008	80580204	MACS_peak_19999	1025.76	196	0	0	0	intergen
8	80600229	80600367	MACS_peak_20000	2209.95	138	0	0	0	intergen
8	80683055	80683235	MACS_peak_20001	746.04	180	0	1	0	gen
8	80795714	80795850	MACS_peak_20002	1061.85	136	0	1	0	gen
8	80870408	80870702	MACS_peak_20003	432.87	294	0	1	0	gen
8	80992023	80992222	MACS_peak_20004	645.81	199	0	1	0	gen
8	80998376	80998726	MACS_peak_20005	287	350	0	1	0	gen
8	81025659	81025886	MACS_peak_20006	548.55	227	0	1	0	gen
8	81200211	81200687	MACS_peak_20007	58.28	476	0	0	0	intergen
8	81277743	81278033	MACS_peak_20009	448.52	290	1	0	0	promoter
8	81651427	81651693	MACS_peak_20010	418.76	266	0	0	0	intergen
8	81708630	81708962	MACS_peak_20011	1513.86	332	0	1	0	gen
8	81780475	81780926	MACS_peak_20012	1353.73	451	0	0	0	intergen
8	81890510	81890756	MACS_peak_20013	763.02	246	0	0	1	other
8	81929751	81930016	MACS_peak_20014	722.05	265	0	0	0	intergen
8	82234567	82234845	MACS_peak_20015	709.17	278	0	0	0	intergen
8	82391683	82391887	MACS_peak_20016	127.39	204	0	0	0	intergen
8	82416777	82417087	MACS_peak_20017	423.78	310	0	0	0	intergen
8	82443549	82443838	MACS_peak_20018	395.24	289	0	0	0	intergen
8	82551690	82552083	MACS_peak_20019	508.27	393	0	0	1	other
8	82658150	82658308	MACS_peak_20020	980.21	158	0	0	1	other
8	82931059	82931402	MACS_peak_20021	419.68	343	0	0	2	other
8	83017792	83017978	MACS_peak_20022	879.27	186	0	0	0	intergen
8	83516491	83516684	MACS_peak_20024	678.9	193	0	0	0	intergen
8	83756348	83756572	MACS_peak_20025	549.18	224	0	0	0	intergen
8	83854063	83854266	MACS_peak_20026	970.74	203	0	0	0	intergen
8	83900387	83900712	MACS_peak_20027	114.74	325	0	0	0	intergen
8	83930681	83930928	MACS_peak_20028	471.88	247	0	0	1	other
8	84367236	84367370	MACS_peak_20029	671.02	134	0	1	0	gen
8	84626149	84626535	MACS_peak_20030	722.05	386	0	1	0	gen
8	84649151	84649486	MACS_peak_20031	61.85	335	0	1	0	gen
8	84753869	84754161	MACS_peak_20032	96.97	292	0	1	0	gen
8	84998653	84998933	MACS_peak_20033	109.15	280	0	0	0	intergen
8	85012151	85012602	MACS_peak_20034	76.53	451	0	0	0	intergen
8	85054310	85054773	MACS_peak_20035	701.95	463	0	0	0	intergen
8	85086403	85086636	MACS_peak_20036	225.7	233	0	0	0	intergen
8	85147438	85147663	MACS_peak_20037	488.77	225	0	0	0	intergen
8	85187427	85187660	MACS_peak_20038	532.66	233	0	1	0	gen
8	85211127	85211425	MACS_peak_20039	297.73	298	1	1	0	promoter
8	85344024	85344288	MACS_peak_20040	312.33	264	0	1	0	gen
8	85451522	85451854	MACS_peak_20041	1028.6	332	0	0	1	other
8	85568876	85569069	MACS_peak_20042	574.96	193	0	0	0	intergen
8	85643240	85643511	MACS_peak_20043	69.6	271	0	0	1	other
8	85661985	85662256	MACS_peak_20046	70.9	271	0	0	1	other
8	85715100	85715371	MACS_peak_20047	62.23	271	0	0	1	other
8	85827414	85827659	MACS_peak_20057	55.03	245	0	0	1	other
8	85836247	85836386	MACS_peak_20058	632.31	139	0	0	1	other
8	85973310	85973681	MACS_peak_20059	435.8	371	0	0	0	intergen
8	86033216	86033622	MACS_peak_20060	1417.03	406	0	1	0	gen
8	86044144	86044376	MACS_peak_20061	537.4	232	1	1	0	promoter
8	86088535	86089006	MACS_peak_20062	865.62	471	0	1	0	gen
8	86266509	86266880	MACS_peak_20064	362.19	371	0	1	0	gen
8	86514197	86514392	MACS_peak_20065	640.49	195	1	0	0	promoter
8	86558158	86558534	MACS_peak_20066	349.84	376	1	1	0	promoter
8	86609239	86609500	MACS_peak_20067	715.63	261	0	1	0	gen
8	86619093	86619335	MACS_peak_20068	531.82	242	0	1	0	gen
8	86703299	86703641	MACS_peak_20069	1035.04	342	0	1	0	gen
8	86785199	86785660	MACS_peak_20070	1854.74	461	0	0	1	other
8	86819167	86819635	MACS_peak_20071	857.42	468	0	0	0	intergen
8	86871070	86871479	MACS_peak_20072	1106.95	409	0	0	0	intergen
8	86892826	86893297	MACS_peak_20073	1950.2	471	0	1	0	gen
8	87000946	87001152	MACS_peak_20074	655.89	206	0	1	0	gen
8	87270304	87270533	MACS_peak_20076	717.77	229	0	1	0	gen
8	87348640	87348828	MACS_peak_20077	983.94	188	0	1	0	gen
8	87463151	87463513	MACS_peak_20078	259.36	362	0	1	0	gen
8	87476042	87476392	MACS_peak_20079	666.68	350	0	1	0	gen
8	87581702	87582181	MACS_peak_20080	2606.38	479	0	1	1	gen
8	87651956	87652191	MACS_peak_20081	93.73	235	0	0	1	other
8	87695247	87695555	MACS_peak_20082	722.05	308	0	0	1	other
8	87818650	87819087	MACS_peak_20083	105.65	437	0	0	0	intergen
8	87925811	87926050	MACS_peak_20084	454	239	0	0	0	intergen
8	87932618	87932957	MACS_peak_20085	506.92	339	0	0	0	intergen
8	88155418	88155575	MACS_peak_20086	235.7	157	0	1	0	gen
8	88176993	88177278	MACS_peak_20087	1280.99	285	0	1	0	gen
8	88199611	88199853	MACS_peak_20088	480.03	242	0	1	0	gen
8	88203434	88203733	MACS_peak_20089	428.63	299	0	1	0	gen
8	88212740	88212959	MACS_peak_20090	470.21	219	0	1	0	gen
8	88289841	88290092	MACS_peak_20091	525.79	251	0	1	0	gen
8	88320664	88320922	MACS_peak_20092	727.26	258	0	1	0	gen
8	88346062	88346482	MACS_peak_20093	192.4	420	0	0	1	other
8	88520065	88520347	MACS_peak_20094	722.05	282	0	0	1	other
8	88580181	88580472	MACS_peak_20095	301.56	291	0	0	1	other
8	88647134	88647441	MACS_peak_20096	183.34	307	0	0	1	other
8	88691095	88691472	MACS_peak_20097	50.68	377	0	0	1	other
8	88712903	88713341	MACS_peak_20098	737.12	438	0	0	1	other
8	88805472	88805841	MACS_peak_20099	627.18	369	0	0	1	other
8	88827379	88827771	MACS_peak_20100	75.01	392	0	0	1	other
8	88898754	88899042	MACS_peak_20101	496.17	288	0	0	0	intergen
8	88919135	88919349	MACS_peak_20102	761	214	0	0	0	intergen
8	89047096	89047429	MACS_peak_20103	388.99	333	0	0	0	intergen
8	89176872	89177192	MACS_peak_20104	1955.71	320	0	0	0	intergen
8	89191137	89191487	MACS_peak_20105	76.3	350	0	0	0	intergen
8	89222756	89223232	MACS_peak_20106	61.84	476	0	0	0	intergen
8	89253301	89253539	MACS_peak_20107	516.86	238	0	0	0	intergen
8	89375352	89375733	MACS_peak_20108	149.97	381	0	0	0	intergen
8	89423853	89424081	MACS_peak_20109	544.06	228	0	0	0	intergen
8	89509830	89510238	MACS_peak_20110	78.6	408	0	0	0	intergen
8	89532210	89532671	MACS_peak_20111	104.56	461	0	0	0	intergen
8	89536414	89536717	MACS_peak_20112	56.21	303	0	0	0	intergen
8	89537744	89537993	MACS_peak_20113	50.7	249	0	0	0	intergen
8	89539170	89539525	MACS_peak_20114	64.39	355	0	0	0	intergen
8	89556498	89556711	MACS_peak_20115	67.37	213	0	0	0	intergen
8	89617160	89617394	MACS_peak_20116	1108.27	234	0	0	1	other
8	89654232	89654526	MACS_peak_20117	1671.3	294	0	0	1	other
8	89675852	89676223	MACS_peak_20118	68.83	371	0	0	1	other
8	89677356	89677677	MACS_peak_20119	111.96	321	0	0	1	other
8	89689216	89689522	MACS_peak_20120	1282.62	306	0	0	1	other
8	89702828	89703034	MACS_peak_20121	669.04	206	0	0	1	other
8	89713094	89713470	MACS_peak_20122	66.31	376	0	0	1	other
8	89718282	89718602	MACS_peak_20123	491.79	320	0	0	1	other
8	89848226	89848529	MACS_peak_20124	1097.2	303	0	0	0	intergen
8	89954528	89954666	MACS_peak_20125	989.14	138	0	1	0	gen
8	89984027	89984395	MACS_peak_20126	766.12	368	0	1	0	gen
8	89984641	89984993	MACS_peak_20127	415.24	352	0	1	0	gen
8	89994275	89994632	MACS_peak_20128	774.47	357	0	1	0	gen
8	89994702	89994936	MACS_peak_20129	532.66	234	0	1	0	gen
8	90000587	90001027	MACS_peak_20130	646.41	440	1	1	0	promoter
8	90028127	90028427	MACS_peak_20131	201.59	300	0	1	0	gen
8	90046841	90047231	MACS_peak_20132	116.98	390	0	1	0	gen
8	90208033	90208299	MACS_peak_20133	618.6	266	0	0	0	intergen
8	90233157	90233352	MACS_peak_20134	540.03	195	0	0	1	other
8	90432553	90432796	MACS_peak_20135	402.63	243	0	0	1	other
8	90472694	90473073	MACS_peak_20136	603.02	379	0	0	1	other
8	90501432	90501661	MACS_peak_20137	420.45	229	0	0	1	other
8	90533577	90533874	MACS_peak_20138	488.85	297	0	0	1	other
8	90570938	90571416	MACS_peak_20139	682.75	478	0	0	1	other
8	90758351	90758737	MACS_peak_20140	2180.46	386	0	1	0	gen
8	90816936	90817223	MACS_peak_20141	1804.99	287	0	1	1	gen
8	90948292	90948743	MACS_peak_20142	710.35	451	0	1	0	gen
8	90990956	90991406	MACS_peak_20143	932.02	450	1	0	0	promoter
8	91031203	91031485	MACS_peak_20144	1119.53	282	0	1	0	gen
8	91076657	91076958	MACS_peak_20145	380.3	301	0	1	0	gen
8	91081660	91081967	MACS_peak_20146	685.18	307	0	1	0	gen
8	91132428	91132847	MACS_peak_20147	506.92	419	0	1	0	gen
8	91236452	91236806	MACS_peak_20148	679.6	354	0	1	0	gen
8	91253384	91253708	MACS_peak_20149	722.05	324	0	1	0	gen
8	91343615	91343886	MACS_peak_20150	648.7	271	0	1	0	gen
8	91393586	91393847	MACS_peak_20151	603.02	261	0	1	0	gen
8	91455490	91455711	MACS_peak_20152	696.33	221	0	0	0	intergen
8	91527396	91527862	MACS_peak_20153	141.43	466	0	0	0	intergen
8	91665674	91665923	MACS_peak_20154	625.49	249	0	0	1	other
8	91728052	91728304	MACS_peak_20155	73.59	252	0	0	1	other
8	91728865	91729217	MACS_peak_20156	72.38	352	0	0	1	other
8	91854892	91855107	MACS_peak_20157	596.79	215	0	0	1	other
8	91874124	91874385	MACS_peak_20158	88.13	261	0	0	1	other
8	92073430	92073742	MACS_peak_20159	435.94	312	0	1	0	gen
8	92365179	92365468	MACS_peak_20160	63.9	289	0	0	0	intergen
8	92367670	92367978	MACS_peak_20161	76.89	308	0	0	0	intergen
8	92369509	92369709	MACS_peak_20162	372.57	200	0	0	0	intergen
8	92676702	92676953	MACS_peak_20163	471.88	251	0	0	1	other
8	92716246	92716460	MACS_peak_20164	1098.16	214	0	0	1	other
8	92763973	92764213	MACS_peak_20165	335.56	240	0	0	1	other
8	92912042	92912389	MACS_peak_20166	398.78	347	0	1	1	gen
8	92919104	92919476	MACS_peak_20167	692.06	372	0	1	1	gen
8	93488103	93488442	MACS_peak_20169	69.46	339	0	0	1	other
8	93565447	93565748	MACS_peak_20170	442.11	301	0	0	1	other
8	93635897	93636138	MACS_peak_20171	466.63	241	0	0	1	other
8	93644689	93644883	MACS_peak_20172	1043.77	194	0	0	1	other
8	93667946	93668132	MACS_peak_20173	122.85	186	0	0	1	other
8	93694145	93694503	MACS_peak_20174	997.01	358	1	0	1	promoter
8	93695807	93695941	MACS_peak_20175	1212.73	134	1	0	1	promoter
8	93799894	93800034	MACS_peak_20176	1395.4	140	0	1	0	gen
8	93975116	93975425	MACS_peak_20177	382.21	309	0	0	0	intergen
8	93983276	93983643	MACS_peak_20178	408.1	367	0	0	0	intergen
8	93991315	93991611	MACS_peak_20179	534.84	296	0	0	0	intergen
8	93994693	93994931	MACS_peak_20180	415.95	238	0	0	0	intergen
8	94180244	94180530	MACS_peak_20181	304.49	286	0	1	0	gen
8	94206008	94206342	MACS_peak_20182	379.96	334	0	1	0	gen
8	94349966	94350206	MACS_peak_20183	733.5	240	0	0	0	intergen
8	94357242	94357457	MACS_peak_20184	511.33	215	0	0	0	intergen
8	94520078	94520212	MACS_peak_20185	915.63	134	0	1	0	gen
8	94567635	94568038	MACS_peak_20186	538.87	403	0	0	1	other
8	94574179	94574573	MACS_peak_20187	638.66	394	0	0	0	intergen
8	94612982	94613229	MACS_peak_20189	1036.76	247	0	0	0	intergen
8	94813454	94813850	MACS_peak_20190	870.72	396	1	0	0	promoter
8	95137190	95137403	MACS_peak_20191	596.79	213	1	0	0	promoter
8	95305373	95305795	MACS_peak_20192	1090.25	422	0	0	1	other
8	95374942	95375275	MACS_peak_20193	81.85	333	0	0	1	other
8	95627908	95628292	MACS_peak_20194	388.99	384	0	0	1	other
8	95717303	95717669	MACS_peak_20195	57.57	366	0	0	1	other
8	95747133	95747595	MACS_peak_20196	93.31	462	0	0	1	other
8	95757235	95757637	MACS_peak_20197	81.3	402	0	0	1	other
8	95881576	95881805	MACS_peak_20198	456.29	229	0	0	0	intergen
8	95882980	95883229	MACS_peak_20199	166.83	249	0	0	0	intergen
8	95890567	95890802	MACS_peak_20200	516.86	235	0	0	0	intergen
8	96085936	96086279	MACS_peak_20201	170.04	343	0	0	0	intergen
8	96333029	96333499	MACS_peak_20202	699.07	470	0	1	0	gen
8	96695153	96695493	MACS_peak_20203	78.43	340	0	1	0	gen
8	96695891	96696208	MACS_peak_20204	54.21	317	0	1	0	gen
8	96777892	96778246	MACS_peak_20205	492.82	354	0	1	0	gen
8	96856647	96856867	MACS_peak_20206	564.54	220	0	1	0	gen
8	96964088	96964464	MACS_peak_20207	505.64	376	0	1	0	gen
8	96988100	96988368	MACS_peak_20208	506.92	268	0	1	0	gen
8	97142239	97142506	MACS_peak_20210	534.37	267	0	1	0	gen
8	97145333	97145587	MACS_peak_20211	453.3	254	0	1	0	gen
8	97258975	97259264	MACS_peak_20212	435.82	289	0	0	0	intergen
8	97295847	97296186	MACS_peak_20213	60.17	339	0	0	0	intergen
8	97298134	97298352	MACS_peak_20214	77.25	218	0	0	0	intergen
8	97547529	97547745	MACS_peak_20215	644.42	216	0	0	0	intergen
8	97582615	97582972	MACS_peak_20216	593.41	357	0	0	0	intergen
8	97633865	97634179	MACS_peak_20218	488.85	314	0	0	0	intergen
8	97788230	97788588	MACS_peak_20219	373.94	358	0	1	0	gen
8	97839870	97840306	MACS_peak_20220	757.78	436	0	1	0	gen
8	97914347	97914493	MACS_peak_20221	1453.16	146	0	1	0	gen
8	98085453	98085835	MACS_peak_20222	914.48	382	0	1	0	gen
8	98163783	98164060	MACS_peak_20223	580.42	277	0	0	0	intergen
8	98345462	98345698	MACS_peak_20224	596.74	236	0	0	0	intergen
8	98358126	98358389	MACS_peak_20225	465.4	263	0	0	0	intergen
8	98383101	98383389	MACS_peak_20226	420.06	288	0	1	0	gen
8	98471176	98471411	MACS_peak_20227	1627.6	235	0	1	0	gen
8	98488357	98488644	MACS_peak_20228	1113.45	287	0	1	0	gen
8	98558066	98558423	MACS_peak_20229	736.03	357	0	1	0	gen
8	98569301	98569550	MACS_peak_20230	489.64	249	0	1	0	gen
8	98587558	98587837	MACS_peak_20231	147.93	279	0	1	0	gen
8	98652375	98652795	MACS_peak_20232	60	420	0	1	0	gen
8	98655469	98655870	MACS_peak_20233	101.68	401	0	1	0	gen
8	98700815	98701133	MACS_peak_20234	143.56	318	0	1	0	gen
8	98705609	98705895	MACS_peak_20235	520.23	286	0	1	0	gen
8	98741903	98742263	MACS_peak_20236	50.92	360	0	1	0	gen
8	98872979	98873295	MACS_peak_20238	82	316	0	1	0	gen
8	98926804	98927034	MACS_peak_20239	532.66	230	0	1	0	gen
8	98997905	98998145	MACS_peak_20240	462.71	240	0	0	1	other
8	99128143	99128525	MACS_peak_20241	285.42	382	0	1	0	gen
8	99165740	99165930	MACS_peak_20242	557.32	190	0	1	0	gen
8	99168138	99168457	MACS_peak_20243	1192.27	319	0	1	0	gen
8	99308657	99308993	MACS_peak_20245	53.69	336	0	1	0	gen
8	99335347	99335688	MACS_peak_20246	52.21	341	0	1	0	gen
8	99358599	99358926	MACS_peak_20247	511.42	327	0	1	0	gen
8	99378434	99378714	MACS_peak_20248	243.49	280	0	1	0	gen
8	99406274	99406605	MACS_peak_20249	406.81	331	0	1	0	gen
8	99441336	99441613	MACS_peak_20250	953.02	277	0	1	0	gen
8	99519073	99519307	MACS_peak_20251	232.04	234	0	1	0	gen
8	99559364	99559676	MACS_peak_20252	83.7	312	0	1	0	gen
8	99691616	99692032	MACS_peak_20253	109.53	416	0	1	0	gen
8	99787589	99787973	MACS_peak_20254	532.77	384	0	1	0	gen
8	99794312	99794552	MACS_peak_20255	903.02	240	0	1	0	gen
8	99859836	99860124	MACS_peak_20256	700.62	288	0	1	0	gen
8	99865859	99866180	MACS_peak_20257	549.92	321	0	1	0	gen
8	99959303	99959511	MACS_peak_20258	376.89	208	1	0	0	promoter
8	100125950	100126286	MACS_peak_20260	406.81	336	0	1	0	gen
8	100144051	100144292	MACS_peak_20261	487.14	241	0	1	0	gen
8	100204278	100204624	MACS_peak_20262	204.63	346	0	1	0	gen
8	100573911	100574308	MACS_peak_20264	493.55	397	1	0	0	promoter
8	100680924	100681203	MACS_peak_20265	578.93	279	1	0	0	promoter
8	100707884	100708141	MACS_peak_20266	567.67	257	0	1	0	gen
8	100827058	100827305	MACS_peak_20267	282.33	247	0	0	0	intergen
8	100847149	100847375	MACS_peak_20268	548.55	226	0	0	0	intergen
8	100877997	100878230	MACS_peak_20269	387.94	233	0	0	0	intergen
8	101123235	101123530	MACS_peak_20271	488.85	295	0	0	1	other
8	101137305	101137498	MACS_peak_20272	675.38	193	0	0	0	intergen
8	101225655	101225901	MACS_peak_20273	847.14	246	0	0	0	intergen
8	101326968	101327254	MACS_peak_20274	1236.02	286	0	0	0	intergen
8	101429444	101429755	MACS_peak_20275	71.7	311	0	0	1	other
8	101456849	101457065	MACS_peak_20276	2057.96	216	0	0	0	intergen
8	101521812	101522000	MACS_peak_20277	825.28	188	0	1	0	gen
8	101618446	101618928	MACS_peak_20278	839.91	482	0	1	0	gen
8	101632584	101632906	MACS_peak_20279	549.27	322	0	1	0	gen
8	101646315	101646658	MACS_peak_20280	419.68	343	0	1	0	gen
8	101804365	101804718	MACS_peak_20281	777.57	353	0	1	0	gen
8	102081438	102081685	MACS_peak_20282	717.46	247	0	1	0	gen
8	102134408	102134790	MACS_peak_20283	85.66	382	0	0	0	intergen
8	102140650	102140880	MACS_peak_20284	573.12	230	0	0	0	intergen
8	102184963	102185245	MACS_peak_20285	408.77	282	0	0	0	intergen
8	102197502	102197748	MACS_peak_20286	508.42	246	0	0	0	intergen
8	102407757	102407999	MACS_peak_20287	518.84	242	0	1	0	gen
8	102434656	102434920	MACS_peak_20288	441.36	264	0	0	0	intergen
8	102449136	102449508	MACS_peak_20289	178.37	372	0	0	0	intergen
8	102631694	102631932	MACS_peak_20290	729.92	238	0	0	0	intergen
8	102765966	102766098	MACS_peak_20291	1116.4	132	0	0	0	intergen
8	102807516	102807842	MACS_peak_20292	546.72	326	0	0	1	other
8	102810808	102811286	MACS_peak_20293	1317.25	478	0	0	0	intergen
8	102814688	102814916	MACS_peak_20294	541.47	228	0	0	0	intergen
8	103046814	103047047	MACS_peak_20295	1094.86	233	0	1	0	gen
8	103073868	103074075	MACS_peak_20296	1134.69	207	0	0	0	intergen
8	103104278	103104585	MACS_peak_20297	972.38	307	0	0	0	intergen
8	103279080	103279449	MACS_peak_20298	521.2	369	0	0	1	other
8	103373176	103373521	MACS_peak_20299	1603.33	345	1	0	0	promoter
8	103707306	103707631	MACS_peak_20300	722.05	325	0	1	0	gen
8	103756754	103756968	MACS_peak_20301	413.43	214	0	1	0	gen
8	103764332	103764600	MACS_peak_20302	1059.13	268	0	1	0	gen
8	103776484	103776833	MACS_peak_20303	986.79	349	0	1	0	gen
8	103786928	103787166	MACS_peak_20304	66.8	238	0	1	0	gen
8	103795558	103795847	MACS_peak_20305	415.46	289	0	1	0	gen
8	103796659	103796980	MACS_peak_20306	414.88	321	0	1	0	gen
8	103871224	103871664	MACS_peak_20307	396.36	440	0	1	0	gen
8	104148040	104148322	MACS_peak_20308	988.32	282	0	1	0	gen
8	104185107	104185398	MACS_peak_20309	889.09	291	0	1	0	gen
8	104253353	104253719	MACS_peak_20310	379.2	366	0	1	0	gen
8	104325447	104325847	MACS_peak_20311	789.23	400	1	0	0	promoter
8	104326040	104326359	MACS_peak_20312	972.38	319	1	0	0	promoter
8	104332192	104332512	MACS_peak_20313	312.33	320	1	0	0	promoter
8	104418140	104418486	MACS_peak_20314	1236.43	346	0	1	0	gen
8	104442380	104442627	MACS_peak_20315	759.16	247	0	1	0	gen
8	104548519	104548779	MACS_peak_20318	1004.78	260	0	1	0	gen
8	104759755	104760077	MACS_peak_20319	2089.92	322	0	1	0	gen
8	104787907	104788074	MACS_peak_20320	911.62	167	0	1	0	gen
8	104961751	104962137	MACS_peak_20321	60	386	0	1	0	gen
8	105084135	105084351	MACS_peak_20322	704.63	216	0	1	0	gen
8	105132129	105132498	MACS_peak_20323	265.34	369	0	1	0	gen
8	105286601	105286817	MACS_peak_20324	852.08	216	0	1	0	gen
8	105380527	105380870	MACS_peak_20325	265.34	343	0	1	0	gen
8	105540104	105540373	MACS_peak_20326	947.26	269	0	1	0	gen
8	105573954	105574323	MACS_peak_20327	1192.27	369	0	1	1	gen
8	105648402	105648720	MACS_peak_20328	52.17	318	0	1	1	gen
8	105657529	105657740	MACS_peak_20329	497.19	211	0	1	1	gen
8	105710461	105710670	MACS_peak_20330	840.92	209	0	1	1	gen
8	105718127	105718318	MACS_peak_20331	977.68	191	0	1	1	gen
8	105746549	105746746	MACS_peak_20332	596.74	197	0	1	1	gen
8	105772986	105773269	MACS_peak_20333	477.91	283	0	1	1	gen
8	105781821	105782047	MACS_peak_20334	568.54	226	0	1	1	gen
8	105866947	105867224	MACS_peak_20335	721.05	277	0	0	1	other
8	105905872	105906146	MACS_peak_20337	1102.77	274	0	0	1	other
8	105906310	105906720	MACS_peak_20338	1151.2	410	0	0	1	other
8	105933100	105933389	MACS_peak_20339	353.72	289	0	0	1	other
8	105950278	105950551	MACS_peak_20340	833.69	273	0	0	1	other
8	106004509	106004748	MACS_peak_20341	516.86	239	0	0	1	other
8	106067128	106067413	MACS_peak_20342	69	285	0	0	0	intergen
8	106081022	106081359	MACS_peak_20343	763.63	337	0	0	0	intergen
8	106208340	106208626	MACS_peak_20344	603.02	286	0	0	0	intergen
8	106257535	106257762	MACS_peak_20345	318.17	227	0	0	0	intergen
8	106286735	106287060	MACS_peak_20346	1460.78	325	0	0	0	intergen
8	106344644	106344913	MACS_peak_20347	489.76	269	0	0	0	intergen
8	106427203	106427656	MACS_peak_20348	1192.27	453	0	1	0	gen
8	106521850	106522111	MACS_peak_20349	873.26	261	0	1	1	gen
8	106617883	106618076	MACS_peak_20351	661.2	193	0	1	1	gen
8	106705019	106705441	MACS_peak_20353	2283.76	422	0	1	0	gen
8	106765272	106765731	MACS_peak_20354	831.62	459	0	1	0	gen
8	106774052	106774379	MACS_peak_20355	831.34	327	0	0	0	intergen
8	106845994	106846244	MACS_peak_20356	485.56	250	0	0	0	intergen
8	106856522	106856917	MACS_peak_20357	529.5	395	0	0	0	intergen
8	106953799	106954180	MACS_peak_20358	514.63	381	0	0	0	intergen
8	106958040	106958200	MACS_peak_20359	549.15	160	0	0	0	intergen
8	107086720	107086940	MACS_peak_20360	666.39	220	0	0	0	intergen
8	107217536	107217914	MACS_peak_20361	453.03	378	0	0	0	intergen
8	107242459	107242709	MACS_peak_20362	146.28	250	0	0	0	intergen
8	107278950	107279188	MACS_peak_20363	245.57	238	0	1	0	gen
8	107495867	107496107	MACS_peak_20364	502.51	240	0	1	0	gen
8	107532338	107532626	MACS_peak_20365	567.67	288	0	0	0	intergen
8	107651007	107651401	MACS_peak_20366	137.17	394	0	0	0	intergen
8	107779844	107780126	MACS_peak_20367	1057.39	282	0	0	0	intergen
8	107781594	107781868	MACS_peak_20368	780.91	274	0	0	0	intergen
8	107813477	107813693	MACS_peak_20369	518.16	216	0	0	0	intergen
8	107863185	107863395	MACS_peak_20370	451.61	210	0	0	0	intergen
8	108058380	108058770	MACS_peak_20373	73.23	390	0	1	0	gen
8	108063764	108064088	MACS_peak_20374	57.42	324	0	1	0	gen
8	108080497	108080715	MACS_peak_20375	564.92	218	0	1	0	gen
8	108169273	108169743	MACS_peak_20376	86.81	470	0	0	0	intergen
8	108180358	108180594	MACS_peak_20377	282.2	236	0	0	0	intergen
8	108245784	108246080	MACS_peak_20378	1018.99	296	0	1	0	gen
8	108266495	108266802	MACS_peak_20379	806.02	307	0	1	0	gen
8	108287201	108287371	MACS_peak_20380	797.18	170	0	1	0	gen
8	108496626	108496871	MACS_peak_20381	883.94	245	0	0	0	intergen
8	108571227	108571455	MACS_peak_20382	627.46	228	0	0	0	intergen
8	108678944	108679149	MACS_peak_20383	162.05	205	0	1	0	gen
8	108681140	108681427	MACS_peak_20384	76.3	287	0	1	0	gen
8	108703857	108704112	MACS_peak_20385	1785.17	255	0	1	0	gen
8	108723003	108723207	MACS_peak_20386	577	204	0	1	0	gen
8	108890450	108890709	MACS_peak_20387	594.37	259	0	0	0	intergen
8	108918486	108918736	MACS_peak_20388	389.4	250	0	0	1	other
8	108932786	108933086	MACS_peak_20389	61.75	300	0	0	1	other
8	108955783	108956031	MACS_peak_20390	398.32	248	0	0	1	other
8	109213557	109213905	MACS_peak_20391	707.97	348	0	0	0	intergen
8	109261577	109261818	MACS_peak_20392	729.92	241	0	1	0	gen
8	109282190	109282567	MACS_peak_20393	759.47	377	0	1	0	gen
8	109325957	109326173	MACS_peak_20395	712.64	216	0	1	0	gen
8	109346875	109347213	MACS_peak_20396	921.33	338	0	0	0	intergen
8	109373036	109373380	MACS_peak_20397	64.79	344	0	1	0	gen
8	109383065	109383452	MACS_peak_20398	823.36	387	0	1	0	gen
8	109552035	109552310	MACS_peak_20399	717.3	275	0	1	0	gen
8	109561684	109561974	MACS_peak_20400	1704.82	290	0	1	0	gen
8	109629521	109629902	MACS_peak_20401	50.66	381	0	1	0	gen
8	109720311	109720629	MACS_peak_20402	545.79	318	0	0	0	intergen
8	109805822	109806032	MACS_peak_20403	613.04	210	0	0	0	intergen
8	109861371	109861679	MACS_peak_20404	97	308	0	0	0	intergen
8	109863862	109864187	MACS_peak_20405	85.11	325	0	0	0	intergen
8	109943210	109943458	MACS_peak_20406	439.71	248	0	0	0	intergen
8	110026460	110026803	MACS_peak_20407	520.82	343	0	0	0	intergen
8	110060429	110060674	MACS_peak_20408	501.16	245	0	0	0	intergen
8	110152325	110152630	MACS_peak_20409	60	305	0	0	0	intergen
8	110257082	110257456	MACS_peak_20410	361.61	374	0	0	0	intergen
8	110336672	110336887	MACS_peak_20411	988.9	215	0	0	1	other
8	110392627	110393056	MACS_peak_20413	299.44	429	0	0	0	intergen
8	110559531	110559829	MACS_peak_20414	477.36	298	0	0	0	intergen
8	110657869	110658109	MACS_peak_20415	645.44	240	0	0	0	intergen
8	110674787	110674920	MACS_peak_20416	1390.02	133	0	0	0	intergen
8	110768141	110768470	MACS_peak_20418	668.48	329	0	0	1	other
8	110830396	110830775	MACS_peak_20419	310.58	379	0	0	0	intergen
8	110952387	110952725	MACS_peak_20420	53.09	338	0	0	1	other
8	111132836	111133032	MACS_peak_20421	604.07	196	0	0	1	other
8	111155914	111156239	MACS_peak_20422	359.15	325	0	0	1	other
8	111253259	111253627	MACS_peak_20423	1236.43	368	0	0	0	intergen
8	111444201	111444631	MACS_peak_20424	723.39	430	0	0	1	other
8	111543571	111543745	MACS_peak_20425	780.06	174	0	0	1	other
8	111847931	111848253	MACS_peak_20426	673.67	322	0	0	0	intergen
8	111965090	111965437	MACS_peak_20427	655.65	347	0	0	0	intergen
8	112213533	112213806	MACS_peak_20428	440.5	273	0	0	0	intergen
8	112219648	112219881	MACS_peak_20429	173.25	233	1	0	0	promoter
8	112405165	112405310	MACS_peak_20430	847.8	145	0	1	0	gen
8	112465085	112465377	MACS_peak_20431	1398.75	292	0	1	0	gen
8	112532142	112532353	MACS_peak_20432	292.77	211	0	1	0	gen
8	112662320	112662774	MACS_peak_20434	139.27	454	0	1	0	gen
8	112761989	112762248	MACS_peak_20435	1004.17	259	0	1	0	gen
8	113068999	113069273	MACS_peak_20436	847.52	274	0	1	0	gen
8	113167231	113167498	MACS_peak_20437	534.37	267	0	1	0	gen
8	113171802	113172028	MACS_peak_20438	822.5	226	0	1	0	gen
8	113193040	113193264	MACS_peak_20439	794.58	224	0	1	0	gen
8	113372391	113372608	MACS_peak_20440	322.87	217	0	1	0	gen
8	113378645	113378831	MACS_peak_20441	901.33	186	0	1	0	gen
8	113399081	113399428	MACS_peak_20442	603.06	347	0	1	0	gen
8	113437784	113438019	MACS_peak_20443	1282.94	235	0	0	0	intergen
8	113451788	113452000	MACS_peak_20444	189.07	212	0	0	0	intergen
8	113961228	113961453	MACS_peak_20445	349.95	225	0	0	0	intergen
8	114044974	114045235	MACS_peak_20446	52.01	261	0	0	0	intergen
8	114127613	114127846	MACS_peak_20447	948.66	233	0	0	0	intergen
8	114163817	114164174	MACS_peak_20448	84.83	357	0	0	0	intergen
8	114454379	114454764	MACS_peak_20449	1102.85	385	0	0	0	intergen
8	114460576	114460814	MACS_peak_20450	662.31	238	0	0	0	intergen
8	114505684	114506055	MACS_peak_20451	65.82	371	0	0	0	intergen
8	114848941	114849299	MACS_peak_20452	283.31	358	0	0	0	intergen
8	115031518	115031702	MACS_peak_20453	872.37	184	0	0	0	intergen
8	115088014	115088216	MACS_peak_20454	630.96	202	0	0	0	intergen
8	115127882	115128091	MACS_peak_20455	1046.02	209	0	0	0	intergen
8	115243583	115243794	MACS_peak_20456	596.79	211	0	0	0	intergen
8	115274181	115274411	MACS_peak_20457	517.97	230	0	0	0	intergen
8	115496452	115496705	MACS_peak_20458	1001.34	253	0	1	0	gen
8	115971143	115971422	MACS_peak_20459	312.33	279	0	0	1	other
8	116204845	116205254	MACS_peak_20460	723.39	409	0	0	1	other
8	116615500	116615745	MACS_peak_20461	422.19	245	0	0	0	intergen
8	116703149	116703527	MACS_peak_20462	635.08	378	0	1	0	gen
8	116715793	116716030	MACS_peak_20463	516.86	237	0	1	0	gen
8	116766127	116766460	MACS_peak_20464	424.75	333	1	1	0	promoter
8	116887584	116887973	MACS_peak_20465	1008.5	389	0	0	0	intergen
8	116912709	116912920	MACS_peak_20466	765.58	211	0	0	0	intergen
8	117330175	117330445	MACS_peak_20468	569.72	270	0	0	0	intergen
8	117467922	117468253	MACS_peak_20469	312.33	331	0	0	0	intergen
8	117862073	117862391	MACS_peak_20470	482.12	318	0	1	0	gen
8	117968455	117968704	MACS_peak_20471	275.97	249	0	1	0	gen
8	118069048	118069346	MACS_peak_20472	936.46	298	0	1	0	gen
8	118240335	118240544	MACS_peak_20473	460.69	209	0	1	0	gen
8	118489488	118489799	MACS_peak_20474	812.5	311	0	1	0	gen
8	118532785	118533057	MACS_peak_20475	63.24	272	0	1	0	gen
8	118534375	118534657	MACS_peak_20476	127.5	282	0	1	0	gen
8	118722046	118722425	MACS_peak_20477	59.7	379	0	0	1	other
8	118811974	118812157	MACS_peak_20478	720.32	183	0	0	1	other
8	118977324	118977695	MACS_peak_20479	50.76	371	0	0	0	intergen
8	119027282	119027439	MACS_peak_20480	794.19	157	0	1	0	gen
8	119121420	119121706	MACS_peak_20481	380.13	286	0	0	0	intergen
8	119162309	119162481	MACS_peak_20482	86.93	172	1	0	0	promoter
8	119264023	119264312	MACS_peak_20484	699.78	289	0	0	0	intergen
8	119416916	119417133	MACS_peak_20485	901.33	217	1	0	0	promoter
8	119451937	119452187	MACS_peak_20486	682.16	250	0	0	1	other
8	119550839	119551123	MACS_peak_20487	67.7	284	0	0	0	intergen
8	119598345	119598665	MACS_peak_20488	319.09	320	0	1	0	gen
8	119655167	119655383	MACS_peak_20489	2235.66	216	0	1	0	gen
8	119862955	119863260	MACS_peak_20490	395.39	305	0	0	0	intergen
8	119935885	119936026	MACS_peak_20491	1253.83	141	0	1	0	gen
8	120010002	120010258	MACS_peak_20492	470.06	256	0	1	0	gen
8	120063747	120063996	MACS_peak_20493	763.02	249	1	0	0	promoter
8	120084660	120084870	MACS_peak_20494	780.06	210	0	1	0	gen
8	120118688	120119150	MACS_peak_20495	640.09	462	0	1	0	gen
8	120123512	120123771	MACS_peak_20496	1297.26	259	0	1	0	gen
8	120218054	120218322	MACS_peak_20497	587.27	268	0	1	0	gen
8	120350320	120350664	MACS_peak_20498	96.73	344	0	1	0	gen
8	120388666	120388905	MACS_peak_20499	516.86	239	0	1	0	gen
8	120421502	120421981	MACS_peak_20500	1193.97	479	0	1	0	gen
8	120452820	120453180	MACS_peak_20501	1671.3	360	0	1	0	gen
8	120605740	120606079	MACS_peak_20502	522.76	339	0	1	0	gen
8	120644897	120645137	MACS_peak_20503	135.71	240	0	1	0	gen
8	120723303	120723524	MACS_peak_20504	537.31	221	0	1	0	gen
8	120808653	120808876	MACS_peak_20505	614.29	223	0	1	0	gen
8	120872195	120872499	MACS_peak_20506	430.6	304	0	0	0	intergen
8	120919135	120919582	MACS_peak_20507	3100	447	0	0	1	other
8	120938998	120939393	MACS_peak_20509	669.62	395	0	0	1	other
8	120943592	120943825	MACS_peak_20510	407.44	233	0	0	1	other
8	120951229	120951525	MACS_peak_20511	1285.51	296	0	0	1	other
8	120984842	120985134	MACS_peak_20512	553.52	292	0	0	1	other
8	120992652	120993023	MACS_peak_20513	142.05	371	0	0	1	other
8	121042018	121042342	MACS_peak_20514	50.92	324	0	0	1	other
8	121054539	121054798	MACS_peak_20515	137.12	259	0	0	1	other
8	121232726	121232957	MACS_peak_20516	685.59	231	0	0	0	intergen
8	121248852	121249130	MACS_peak_20517	1124.48	278	0	0	0	intergen
8	121260771	121261144	MACS_peak_20518	1152.72	373	0	0	0	intergen
8	121329906	121330176	MACS_peak_20519	88.77	270	0	0	0	intergen
8	121420772	121421107	MACS_peak_20520	53.99	335	0	0	0	intergen
8	121571120	121571397	MACS_peak_20521	526.8	277	0	0	0	intergen
8	121642332	121642524	MACS_peak_20522	828.83	192	0	0	1	other
8	121678026	121678409	MACS_peak_20523	406.81	383	0	0	2	other
8	121682369	121682567	MACS_peak_20524	534.57	198	0	0	2	other
8	121685705	121685899	MACS_peak_20525	429.55	194	0	0	1	other
8	121830098	121830445	MACS_peak_20527	1317.25	347	0	0	1	other
8	121988336	121988681	MACS_peak_20528	574.33	345	0	0	2	other
8	122054555	122054788	MACS_peak_20529	251.15	233	0	0	1	other
8	122078906	122079221	MACS_peak_20530	611.86	315	0	0	1	other
8	122099710	122099927	MACS_peak_20531	731.97	217	0	0	1	other
8	122236250	122236607	MACS_peak_20532	774.47	357	0	0	0	intergen
8	122246783	122247184	MACS_peak_20533	56.33	401	0	0	0	intergen
8	122248239	122248489	MACS_peak_20534	74.29	250	0	0	0	intergen
8	122280855	122281110	MACS_peak_20535	844.11	255	0	0	0	intergen
8	122297030	122297387	MACS_peak_20536	51.33	357	0	0	0	intergen
8	122329542	122329936	MACS_peak_20537	145.6	394	0	0	0	intergen
8	122348085	122348321	MACS_peak_20538	462.71	236	0	0	0	intergen
8	122445296	122445684	MACS_peak_20539	139.27	388	0	0	0	intergen
8	122447524	122447754	MACS_peak_20540	706.26	230	0	0	0	intergen
8	122563456	122563714	MACS_peak_20541	713.43	258	0	0	0	intergen
8	122572185	122572651	MACS_peak_20542	1339.11	466	0	0	0	intergen
8	122639000	122639274	MACS_peak_20543	458.32	274	0	0	0	intergen
8	122673514	122673734	MACS_peak_20544	883.81	220	0	0	1	other
8	122678858	122679127	MACS_peak_20545	461.5	269	0	0	1	other
8	122733597	122733927	MACS_peak_20546	426.3	330	0	0	0	intergen
8	122794989	122795287	MACS_peak_20547	443.84	298	0	1	0	gen
8	122858189	122858514	MACS_peak_20548	415.68	325	0	1	0	gen
8	122904869	122905148	MACS_peak_20549	578.93	279	0	1	0	gen
8	123065726	123066123	MACS_peak_20550	596.52	397	0	1	0	gen
8	123160464	123160835	MACS_peak_20551	520.09	371	0	0	0	intergen
8	123418979	123419138	MACS_peak_20552	1007.3	159	1	0	0	promoter
8	123422474	123422621	MACS_peak_20553	860.28	147	0	1	0	gen
8	123456045	123456280	MACS_peak_20554	768.86	235	0	1	0	gen
8	123462705	123463152	MACS_peak_20555	1207.45	447	0	1	0	gen
8	123472168	123472348	MACS_peak_20556	726.99	180	0	0	0	intergen
8	123598894	123599054	MACS_peak_20557	383.79	160	0	0	0	intergen
8	123693781	123694047	MACS_peak_20558	2086.01	266	0	1	0	gen
8	123804393	123804600	MACS_peak_20559	585.19	207	0	1	0	gen
8	123823385	123823690	MACS_peak_20560	654.09	305	0	0	0	intergen
8	124010282	124010465	MACS_peak_20562	799.34	183	0	1	1	gen
8	124030380	124030690	MACS_peak_20563	392.63	310	0	1	1	gen
8	124230434	124230781	MACS_peak_20564	229.83	347	0	0	1	other
8	124235308	124235550	MACS_peak_20565	487.14	242	0	0	1	other
8	124425300	124425597	MACS_peak_20567	444.41	297	0	0	0	intergen
8	124426060	124426316	MACS_peak_20568	1007.8	256	0	0	0	intergen
8	124440463	124440756	MACS_peak_20569	1823.57	293	0	0	0	intergen
8	124525999	124526248	MACS_peak_20570	547.91	249	0	1	0	gen
8	124592914	124593252	MACS_peak_20571	1259.18	338	0	1	0	gen
8	124888828	124889181	MACS_peak_20572	470.47	353	0	0	1	other
8	124924723	124924917	MACS_peak_20573	778.31	194	0	0	1	other
8	124953780	124953983	MACS_peak_20574	556.2	203	0	0	1	other
8	125129862	125130137	MACS_peak_20575	2344.71	275	0	1	0	gen
8	125148393	125148591	MACS_peak_20576	509.17	198	0	1	0	gen
8	125215206	125215475	MACS_peak_20577	50.92	269	0	1	0	gen
8	125230676	125230961	MACS_peak_20578	784.02	285	0	1	0	gen
8	125432094	125432346	MACS_peak_20580	1025.76	252	1	0	0	promoter
8	125448817	125448994	MACS_peak_20581	972.07	177	0	0	0	intergen
8	125590112	125590321	MACS_peak_20582	184.06	209	0	0	0	intergen
8	125630382	125630619	MACS_peak_20583	439.49	237	0	0	0	intergen
8	125644527	125644816	MACS_peak_20584	983.49	289	0	0	0	intergen
8	125696659	125697001	MACS_peak_20585	420.18	342	0	0	0	intergen
8	125702572	125702855	MACS_peak_20586	817.22	283	0	0	0	intergen
8	125729251	125729707	MACS_peak_20587	661.83	456	0	0	0	intergen
8	125741494	125741946	MACS_peak_20588	58.69	452	0	0	0	intergen
8	125787763	125788036	MACS_peak_20589	414.32	273	0	0	0	intergen
8	125828845	125829064	MACS_peak_20590	813.46	219	0	0	0	intergen
8	125830796	125831026	MACS_peak_20591	480.3	230	0	0	0	intergen
8	126275425	126275649	MACS_peak_20592	1330.81	224	0	0	0	intergen
8	126301004	126301266	MACS_peak_20593	637.88	262	0	0	0	intergen
8	126383811	126384016	MACS_peak_20594	766.95	205	0	0	0	intergen
8	126563371	126563679	MACS_peak_20595	272.05	308	0	0	1	other
8	126566925	126567314	MACS_peak_20596	533.11	389	0	0	1	other
8	126753293	126753425	MACS_peak_20598	1090.31	132	0	0	1	other
8	126802968	126803382	MACS_peak_20599	52.1	414	0	0	1	other
8	126824431	126824662	MACS_peak_20600	532.66	231	0	0	1	other
8	126869457	126869636	MACS_peak_20601	1302.27	179	0	0	1	other
8	126876505	126876946	MACS_peak_20602	468.95	441	0	0	1	other
8	127096642	127096862	MACS_peak_20603	678.76	220	0	0	2	other
8	127197572	127197978	MACS_peak_20604	372.06	406	0	0	2	other
8	127280918	127281115	MACS_peak_20605	402.97	197	0	0	1	other
8	127314689	127315076	MACS_peak_20606	76.75	387	0	0	2	other
8	127400745	127401088	MACS_peak_20607	1245.8	343	0	1	3	gen
8	127496461	127496785	MACS_peak_20608	834.18	324	0	0	0	intergen
8	127630440	127630746	MACS_peak_20609	171.28	306	0	0	0	intergen
8	127725674	127725975	MACS_peak_20610	821.52	301	0	0	1	other
8	127734005	127734196	MACS_peak_20611	506.94	191	1	0	0	promoter
8	127780733	127780870	MACS_peak_20612	813.46	137	0	0	0	intergen
8	128259362	128259702	MACS_peak_20613	368.68	340	0	0	0	intergen
8	128269541	128270021	MACS_peak_20614	890.07	480	0	0	0	intergen
8	128596587	128596834	MACS_peak_20615	661.14	247	0	0	0	intergen
8	128781932	128782186	MACS_peak_20617	419.5	254	0	0	1	other
8	128802559	128802819	MACS_peak_20618	190.06	260	0	0	1	other
8	128859252	128859638	MACS_peak_20619	1307.33	386	0	0	1	other
8	129052984	129053364	MACS_peak_20620	845.32	380	0	0	1	other
8	129155355	129155660	MACS_peak_20621	131.44	305	0	0	1	other
8	129303364	129303630	MACS_peak_20622	463.44	266	0	0	1	other
8	129439425	129439587	MACS_peak_20623	848.95	162	0	0	2	other
8	129497450	129497854	MACS_peak_20624	418.65	404	0	0	1	other
8	129535843	129536147	MACS_peak_20625	561.16	304	0	0	1	other
8	129677530	129677777	MACS_peak_20626	629.38	247	0	0	1	other
8	129820087	129820327	MACS_peak_20627	645.81	240	0	0	0	intergen
8	129826281	129826489	MACS_peak_20628	780.06	208	0	0	0	intergen
8	129891700	129891927	MACS_peak_20629	695.57	227	0	1	1	gen
8	130129509	130129842	MACS_peak_20630	972.72	333	0	1	0	gen
8	130207519	130207864	MACS_peak_20631	418.68	345	0	1	0	gen
8	130416638	130416854	MACS_peak_20632	580.62	216	0	1	0	gen
8	130502756	130502997	MACS_peak_20633	797.18	241	0	0	0	intergen
8	130524099	130524477	MACS_peak_20634	180.31	378	0	0	0	intergen
8	130749707	130749929	MACS_peak_20635	564.54	222	0	0	0	intergen
8	130796805	130797106	MACS_peak_20636	442.11	301	0	1	0	gen
8	130802705	130802908	MACS_peak_20637	629.38	203	0	1	0	gen
8	130964825	130965009	MACS_peak_20638	872.37	184	0	1	0	gen
8	131081941	131082293	MACS_peak_20639	72.64	352	0	0	0	intergen
8	131114117	131114407	MACS_peak_20640	570.92	290	0	0	0	intergen
8	131286323	131286484	MACS_peak_20642	1569.18	161	0	0	0	intergen
8	131636141	131636537	MACS_peak_20643	50.46	396	0	0	0	intergen
8	131639937	131640394	MACS_peak_20644	66.96	457	0	0	0	intergen
8	131963557	131964028	MACS_peak_20645	70.43	471	0	1	0	gen
8	132144995	132145312	MACS_peak_20646	552.5	317	0	1	0	gen
8	132192092	132192443	MACS_peak_20647	909.63	351	0	1	0	gen
8	132304648	132304906	MACS_peak_20648	834.03	258	0	1	0	gen
8	132489574	132489863	MACS_peak_20649	571.63	289	0	0	0	intergen
8	132600573	132600850	MACS_peak_20650	75.37	277	0	1	0	gen
8	132789617	132790009	MACS_peak_20651	626.35	392	0	1	0	gen
8	132819880	132820094	MACS_peak_20652	596.79	214	0	1	0	gen
8	132875452	132875797	MACS_peak_20653	657.04	345	0	1	0	gen
8	133449474	133449746	MACS_peak_20654	849.55	272	0	0	0	intergen
8	133569704	133569921	MACS_peak_20655	746.04	217	0	1	0	gen
8	133802142	133802551	MACS_peak_20656	62.82	409	0	0	1	other
8	133876547	133876821	MACS_peak_20657	1087.6	274	0	0	0	intergen
8	134039288	134039560	MACS_peak_20658	388.65	272	0	0	0	intergen
8	134671913	134672339	MACS_peak_20659	81.3	426	0	1	0	gen
8	134886429	134886721	MACS_peak_20660	697.28	292	0	0	0	intergen
8	134906117	134906407	MACS_peak_20661	570.92	290	0	0	0	intergen
8	135452378	135452781	MACS_peak_20662	619.72	403	0	0	0	intergen
8	135465857	135466284	MACS_peak_20663	1241.35	427	0	1	0	gen
8	135878117	135878421	MACS_peak_20664	57.38	304	0	0	1	other
8	135993246	135993688	MACS_peak_20665	597.62	442	0	0	1	other
8	136021989	136022321	MACS_peak_20666	69	332	0	0	1	other
8	136193117	136193394	MACS_peak_20667	109.53	277	0	0	1	other
8	137023725	137023917	MACS_peak_20669	445.84	192	0	0	1	other
8	137062545	137062898	MACS_peak_20671	777.57	353	0	0	1	other
8	137153215	137153425	MACS_peak_20672	607.01	210	0	0	0	intergen
8	137235937	137236279	MACS_peak_20673	488.85	342	0	0	0	intergen
8	137348059	137348314	MACS_peak_20674	470.06	255	0	0	0	intergen
8	137563121	137563489	MACS_peak_20675	71.21	368	0	0	1	other
8	137843310	137843594	MACS_peak_20676	704	284	0	0	1	other
8	137891013	137891273	MACS_peak_20677	593.56	260	0	0	2	other
8	138047298	138047701	MACS_peak_20678	69.09	403	0	0	1	other
8	138120313	138120560	MACS_peak_20679	85.16	247	0	0	0	intergen
8	138442025	138442221	MACS_peak_20680	457.7	196	0	1	0	gen
8	138700227	138700589	MACS_peak_20681	375.01	362	0	1	0	gen
8	138727356	138727739	MACS_peak_20682	684.11	383	0	1	0	gen
8	139066193	139066335	MACS_peak_20683	983.72	142	0	0	0	intergen
8	139461973	139462283	MACS_peak_20685	408.16	310	0	0	1	other
8	139630861	139631208	MACS_peak_20686	417.69	347	0	1	0	gen
8	140099283	140099487	MACS_peak_20687	629.38	204	0	1	1	gen
8	140338737	140339183	MACS_peak_20688	406.81	446	0	1	0	gen
8	140393807	140394185	MACS_peak_20689	516.25	378	0	1	0	gen
8	140432060	140432298	MACS_peak_20690	662.31	238	0	1	0	gen
8	140595696	140596024	MACS_peak_20691	427.34	328	0	1	0	gen
8	140668327	140668546	MACS_peak_20692	580.62	219	0	1	0	gen
8	140977873	140978301	MACS_peak_20693	81.72	428	0	1	0	gen
8	141100393	141100580	MACS_peak_20694	712.32	187	0	0	0	intergen
8	141169125	141169440	MACS_peak_20695	1222.71	315	0	1	0	gen
8	141174978	141175199	MACS_peak_20696	710.43	221	0	1	0	gen
8	141183543	141183870	MACS_peak_20697	1497.88	327	0	1	0	gen
8	141270261	141270393	MACS_peak_20698	1116.4	132	0	1	0	gen
8	141347098	141347332	MACS_peak_20699	662.31	234	0	0	0	intergen
8	141386818	141387051	MACS_peak_20700	972.07	233	0	0	0	intergen
8	141507976	141508190	MACS_peak_20701	596.79	214	0	0	0	intergen
8	141726987	141727329	MACS_peak_20702	536.84	342	0	0	0	intergen
8	142255518	142255802	MACS_peak_20703	358.74	284	0	1	0	gen
8	142447375	142447771	MACS_peak_20704	1002.36	396	1	0	0	promoter
8	142710408	142710701	MACS_peak_20705	446.75	293	0	0	1	other
8	142726874	142727240	MACS_peak_20706	408.57	366	1	0	0	promoter
8	142943620	142943903	MACS_peak_20708	575.98	283	0	0	0	intergen
8	143029385	143029635	MACS_peak_20709	613.04	250	0	0	0	intergen
8	143041541	143041817	MACS_peak_20710	114.74	276	0	0	1	other
8	143048351	143048494	MACS_peak_20711	1264.23	143	0	0	1	other
8	143058702	143059073	MACS_peak_20712	972.38	371	0	0	1	other
8	143131001	143131315	MACS_peak_20713	434.84	314	0	0	0	intergen
8	143281581	143281932	MACS_peak_20714	652.89	351	0	0	0	intergen
8	143314757	143315090	MACS_peak_20715	634.13	333	0	1	0	gen
8	143401309	143401525	MACS_peak_20716	1079.97	216	0	0	0	intergen
8	143748611	143748918	MACS_peak_20717	685.18	307	0	1	0	gen
8	143749173	143749478	MACS_peak_20718	439.84	305	0	1	0	gen
8	143836495	143836696	MACS_peak_20719	814.37	201	1	0	0	promoter
8	143843922	143844237	MACS_peak_20720	348.12	315	0	0	0	intergen
8	144234269	144234635	MACS_peak_20721	306.6	366	0	1	0	gen
8	144443956	144444246	MACS_peak_20722	448.52	290	0	1	0	gen
8	144509755	144510062	MACS_peak_20723	438.71	307	2	0	0	promoter
8	144567128	144567476	MACS_peak_20724	603.06	348	0	1	0	gen
8	144730226	144730594	MACS_peak_20725	505.54	368	0	1	0	gen
8	144805143	144805330	MACS_peak_20726	453.36	187	0	1	0	gen
8	145022169	145022530	MACS_peak_20727	348.12	361	0	0	0	intergen
9	11262	11712	MACS_peak_20730	832.82	450	1	0	0	promoter
9	82814	83124	MACS_peak_20731	221.61	310	0	0	1	other
9	88614	88982	MACS_peak_20732	2331.68	368	0	0	0	intergen
9	176171	176527	MACS_peak_20733	588.26	356	0	1	0	gen
9	687737	687985	MACS_peak_20735	613.04	248	0	1	0	gen
9	757609	757845	MACS_peak_20736	502.51	236	0	0	0	intergen
9	764035	764385	MACS_peak_20737	653.58	350	0	0	0	intergen
9	893681	894073	MACS_peak_20738	469.86	392	0	1	0	gen
9	897803	898063	MACS_peak_20739	577.54	260	0	1	0	gen
9	1009131	1009393	MACS_peak_20741	859.93	262	0	0	0	intergen
9	1101019	1101210	MACS_peak_20742	1061.85	191	0	0	0	intergen
9	1143089	1143291	MACS_peak_20743	854.55	202	0	0	0	intergen
9	1605110	1605400	MACS_peak_20744	448.52	290	0	0	0	intergen
9	1645394	1645586	MACS_peak_20745	527.71	192	0	0	0	intergen
9	1936923	1937298	MACS_peak_20747	211.42	375	0	0	0	intergen
9	2060118	2060260	MACS_peak_20748	1067.21	142	0	1	0	gen
9	2728151	2728356	MACS_peak_20749	629.38	205	0	2	0	gen
9	2857616	2857970	MACS_peak_20750	722.05	354	0	0	0	intergen
9	2931974	2932235	MACS_peak_20751	466.72	261	0	0	1	other
9	3090649	3090998	MACS_peak_20752	312.33	349	0	0	0	intergen
9	3147858	3148022	MACS_peak_20753	168.28	164	0	0	0	intergen
9	3240742	3241070	MACS_peak_20754	427.34	328	0	1	0	gen
9	3427222	3427504	MACS_peak_20756	453.35	282	0	1	0	gen
9	3504781	3505257	MACS_peak_20757	1069.92	476	0	1	0	gen
9	3535714	3535961	MACS_peak_20758	184.19	247	0	0	1	other
9	3811390	3811769	MACS_peak_20759	324.85	379	0	0	0	intergen
9	4604627	4604844	MACS_peak_20760	353.56	217	0	1	0	gen
9	4735192	4735543	MACS_peak_20761	1466.06	351	0	1	0	gen
9	4759453	4759645	MACS_peak_20762	678.9	192	0	0	0	intergen
9	4948663	4948978	MACS_peak_20763	68.21	315	0	0	0	intergen
9	4950628	4951056	MACS_peak_20764	56.93	428	0	0	0	intergen
9	5080622	5080886	MACS_peak_20765	395.93	264	0	1	0	gen
9	5137960	5138188	MACS_peak_20766	263.57	228	0	1	0	gen
9	5258963	5259294	MACS_peak_20767	201.59	331	0	0	0	intergen
9	5424440	5424828	MACS_peak_20768	510.89	388	0	1	0	gen
9	5679914	5680257	MACS_peak_20769	68.83	343	0	1	0	gen
9	5799216	5799480	MACS_peak_20770	590.39	264	0	1	0	gen
9	5963272	5963633	MACS_peak_20771	102.67	361	0	1	0	gen
9	6137147	6137504	MACS_peak_20772	73.17	357	0	0	0	intergen
9	6259905	6260222	MACS_peak_20773	57.81	317	0	0	0	intergen
9	6488248	6488398	MACS_peak_20774	853.84	150	0	1	0	gen
9	6708500	6708977	MACS_peak_20775	695.04	477	0	0	0	intergen
9	6907725	6908068	MACS_peak_20776	536.24	343	0	1	1	gen
9	7867469	7867898	MACS_peak_20777	52.99	429	0	1	0	gen
9	7870293	7870661	MACS_peak_20778	183.32	368	0	1	0	gen
9	8203004	8203375	MACS_peak_20779	70.17	371	0	0	0	intergen
9	8808562	8808845	MACS_peak_20780	704.85	283	0	1	0	gen
9	8948392	8948647	MACS_peak_20781	388.1	255	0	1	1	gen
9	9818506	9818656	MACS_peak_20782	936.57	150	0	1	0	gen
9	9934673	9934943	MACS_peak_20783	107.69	270	0	1	0	gen
9	9976681	9976816	MACS_peak_20784	925.76	135	0	1	0	gen
9	10045694	10045929	MACS_peak_20785	516.86	235	0	1	0	gen
9	10099521	10099730	MACS_peak_20786	509	209	0	1	0	gen
9	10750269	10750637	MACS_peak_20787	133.55	368	0	0	0	intergen
9	11628874	11629239	MACS_peak_20788	109.04	365	0	0	1	other
9	11635754	11636137	MACS_peak_20789	145.07	383	0	0	1	other
9	11944724	11945090	MACS_peak_20790	56.38	366	0	0	1	other
9	12334491	12334839	MACS_peak_20791	106.78	348	0	0	0	intergen
9	12723742	12723990	MACS_peak_20792	485.56	248	0	0	1	other
9	12762484	12762866	MACS_peak_20793	125.63	382	0	0	1	other
9	12812579	12812826	MACS_peak_20794	629.38	247	0	1	1	gen
9	12962742	12962981	MACS_peak_20795	797.18	239	0	0	1	other
9	13040835	13041061	MACS_peak_20796	88.09	226	0	0	0	intergen
9	13145060	13145340	MACS_peak_20797	634.13	280	0	1	0	gen
9	13351798	13352148	MACS_peak_20798	416.22	350	0	0	0	intergen
9	13997797	13998001	MACS_peak_20799	154.92	204	0	0	0	intergen
9	13999594	14000006	MACS_peak_20800	85	412	0	0	0	intergen
9	14465344	14465664	MACS_peak_20801	550.56	320	0	0	0	intergen
9	15025269	15025592	MACS_peak_20804	82.61	323	0	0	1	other
9	15037115	15037463	MACS_peak_20805	103.45	348	0	0	1	other
9	15135065	15135485	MACS_peak_20806	854.1	420	0	0	1	other
9	15625023	15625367	MACS_peak_20807	79.9	344	0	1	0	gen
9	15629851	15630267	MACS_peak_20808	143.14	416	0	1	0	gen
9	15630736	15631060	MACS_peak_20809	61.31	324	0	1	0	gen
9	15646806	15647173	MACS_peak_20810	139.36	367	0	1	0	gen
9	15824301	15824644	MACS_peak_20811	190.65	343	0	1	0	gen
9	15873581	15873866	MACS_peak_20812	574.52	285	0	1	0	gen
9	16066529	16066877	MACS_peak_20813	99.46	348	0	0	0	intergen
9	16467358	16467684	MACS_peak_20814	51.4	326	0	1	0	gen
9	16978622	16978755	MACS_peak_20816	1023.01	133	0	0	1	other
9	17531674	17531953	MACS_peak_20817	578.93	279	0	0	0	intergen
9	17802372	17802741	MACS_peak_20818	407.18	369	0	0	0	intergen
9	17823320	17823713	MACS_peak_20819	142.43	393	0	0	0	intergen
9	19541522	19541832	MACS_peak_20821	63.44	310	0	1	0	gen
9	19707678	19707945	MACS_peak_20823	83.12	267	0	1	0	gen
9	19735409	19735839	MACS_peak_20824	149.97	430	0	1	0	gen
9	19855795	19856077	MACS_peak_20825	687.04	282	0	0	0	intergen
9	20164203	20164487	MACS_peak_20827	57	284	0	0	0	intergen
9	20524888	20525270	MACS_peak_20828	401.26	382	0	1	0	gen
9	20565891	20566135	MACS_peak_20829	487.14	244	0	1	0	gen
9	20768222	20768659	MACS_peak_20830	66.51	437	0	1	0	gen
9	20854638	20854845	MACS_peak_20831	769.12	207	0	1	0	gen
9	21072914	21073189	MACS_peak_20832	581.92	275	1	0	0	promoter
9	21098244	21098488	MACS_peak_20833	501.16	244	0	0	0	intergen
9	21111085	21111353	MACS_peak_20834	1671.3	268	0	0	0	intergen
9	21143728	21144131	MACS_peak_20835	52.16	403	1	0	0	promoter
9	21183171	21183357	MACS_peak_20836	676.7	186	1	0	0	promoter
9	21253077	21253299	MACS_peak_20837	564.54	222	0	0	0	intergen
9	21455401	21455641	MACS_peak_20838	334.14	240	0	0	0	intergen
9	21458914	21459134	MACS_peak_20839	134.16	220	0	0	1	other
9	21465947	21466264	MACS_peak_20840	536.57	317	0	0	1	other
9	21506134	21506267	MACS_peak_20841	1098.16	133	0	0	1	other
9	21561036	21561406	MACS_peak_20842	1372.86	370	0	0	0	intergen
9	21789611	21789864	MACS_peak_20843	596.79	253	0	0	0	intergen
9	21813969	21814214	MACS_peak_20844	780.06	245	0	2	0	gen
9	22092503	22092823	MACS_peak_20845	147.8	320	0	0	1	other
9	22244732	22244973	MACS_peak_20846	501.16	241	0	0	0	intergen
9	22307074	22307286	MACS_peak_20847	596.79	212	0	0	0	intergen
9	22330552	22330919	MACS_peak_20848	219.32	367	0	0	0	intergen
9	22352664	22353113	MACS_peak_20849	76.3	449	0	0	0	intergen
9	22353996	22354364	MACS_peak_20850	101.87	368	0	0	0	intergen
9	23779796	23780113	MACS_peak_20851	272.05	317	0	1	0	gen
9	23974584	23974797	MACS_peak_20852	877.68	213	0	0	0	intergen
9	24227164	24227444	MACS_peak_20853	56.84	280	0	0	0	intergen
9	24305758	24306116	MACS_peak_20854	412.35	358	0	0	0	intergen
9	24523626	24523940	MACS_peak_20855	60.7	314	0	0	0	intergen
9	24577723	24578112	MACS_peak_20856	143.14	389	0	0	1	other
9	24751883	24752208	MACS_peak_20857	145.34	325	0	0	0	intergen
9	25041851	25042228	MACS_peak_20858	81.66	377	0	0	0	intergen
9	25069511	25069712	MACS_peak_20859	257.25	201	0	0	0	intergen
9	25328834	25329188	MACS_peak_20861	776.79	354	0	0	0	intergen
9	25484505	25484825	MACS_peak_20862	50.92	320	0	0	0	intergen
9	25887515	25887860	MACS_peak_20863	1329.55	345	0	0	0	intergen
9	25932433	25932787	MACS_peak_20864	115.05	354	0	0	0	intergen
9	26253959	26254283	MACS_peak_20865	78.7	324	0	0	0	intergen
9	26326609	26326915	MACS_peak_20866	439.28	306	0	0	0	intergen
9	26777734	26778032	MACS_peak_20868	81.85	298	0	0	1	other
9	26834980	26835340	MACS_peak_20869	90.41	360	0	0	0	intergen
9	27224830	27225145	MACS_peak_20870	158.81	315	0	1	0	gen
9	27598870	27599013	MACS_peak_20871	1924.5	143	0	0	0	intergen
9	27696116	27696439	MACS_peak_20872	50.92	323	0	0	0	intergen
9	28097344	28097665	MACS_peak_20873	56.38	321	0	1	0	gen
9	28115315	28115520	MACS_peak_20874	131.23	205	0	1	0	gen
9	28117258	28117491	MACS_peak_20875	112.83	233	0	1	0	gen
9	28220956	28221338	MACS_peak_20876	603.02	382	0	1	0	gen
9	28642966	28643224	MACS_peak_20878	577.8	258	0	1	0	gen
9	29626910	29627135	MACS_peak_20879	222.64	225	0	0	0	intergen
9	29723571	29723997	MACS_peak_20880	148.8	426	0	0	0	intergen
9	30109154	30109537	MACS_peak_20882	50.14	383	0	0	0	intergen
9	30112025	30112418	MACS_peak_20883	86.4	393	0	0	0	intergen
9	30594675	30595005	MACS_peak_20884	156.2	330	0	0	0	intergen
9	30595295	30595595	MACS_peak_20885	97.28	300	0	0	0	intergen
9	30787185	30787611	MACS_peak_20886	65.25	426	0	0	0	intergen
9	30788178	30788480	MACS_peak_20887	166.21	302	0	0	0	intergen
9	31029004	31029206	MACS_peak_20888	289.07	202	0	0	0	intergen
9	31226938	31227352	MACS_peak_20889	198.4	414	0	0	0	intergen
9	31410231	31410558	MACS_peak_20890	232.85	327	0	0	0	intergen
9	31768445	31768699	MACS_peak_20892	862.08	254	0	0	0	intergen
9	31935138	31935588	MACS_peak_20893	57.86	450	0	0	0	intergen
9	32148515	32148813	MACS_peak_20894	447.2	298	0	0	0	intergen
9	32150953	32151258	MACS_peak_20895	72.16	305	0	0	0	intergen
9	32213711	32214142	MACS_peak_20896	68.39	431	0	0	0	intergen
9	32228345	32228726	MACS_peak_20897	50.92	381	0	0	0	intergen
9	32579697	32580083	MACS_peak_20899	630.05	386	0	0	0	intergen
9	32688991	32689368	MACS_peak_20900	53.73	377	0	0	0	intergen
9	32703741	32704018	MACS_peak_20901	580.42	277	0	0	0	intergen
9	32730222	32730448	MACS_peak_20902	108.67	226	0	0	0	intergen
9	32968442	32968690	MACS_peak_20903	485.56	248	1	0	0	promoter
9	33088220	33088566	MACS_peak_20904	58.44	346	0	0	0	intergen
9	33111144	33111285	MACS_peak_20905	1025.76	141	0	1	0	gen
9	33374880	33375250	MACS_peak_20906	488.85	370	0	0	0	intergen
9	33714338	33714692	MACS_peak_20908	414.27	354	0	0	0	intergen
9	33886046	33886267	MACS_peak_20909	482.68	221	0	1	0	gen
9	33886640	33886779	MACS_peak_20910	902.92	139	0	1	0	gen
9	33995349	33995721	MACS_peak_20911	638.92	372	0	1	0	gen
9	34176278	34176506	MACS_peak_20912	541.5	228	1	0	0	promoter
9	34309965	34310106	MACS_peak_20913	1077.51	141	0	1	0	gen
9	34548077	34548359	MACS_peak_20914	576.71	282	1	0	0	promoter
9	34658759	34658944	MACS_peak_20915	901.33	185	1	1	0	promoter
9	34664372	34664600	MACS_peak_20916	695.57	228	2	0	1	promoter
9	35494845	35495212	MACS_peak_20917	611.86	367	0	0	0	intergen
9	35554056	35554307	MACS_peak_20918	613.04	251	0	1	0	gen
9	35848566	35848698	MACS_peak_20919	977.06	132	0	1	0	gen
9	35882317	35882734	MACS_peak_20920	731.8	417	0	0	0	intergen
9	35954986	35955262	MACS_peak_20921	651.13	276	1	0	0	promoter
9	36257463	36257928	MACS_peak_20922	109.53	465	0	2	0	gen
9	36270403	36270535	MACS_peak_20923	857.98	132	0	2	0	gen
9	36323535	36323842	MACS_peak_20924	611.86	307	0	0	0	intergen
9	36490398	36490647	MACS_peak_20925	389.4	249	0	0	0	intergen
9	36663859	36664185	MACS_peak_20926	348.12	326	0	1	0	gen
9	37069851	37070089	MACS_peak_20927	777.13	238	0	0	0	intergen
9	37305881	37306094	MACS_peak_20928	659.6	213	0	1	0	gen
9	37594629	37594943	MACS_peak_20929	434.84	314	0	1	0	gen
9	37808432	37808830	MACS_peak_20930	619.03	398	0	2	0	gen
9	38371275	38371473	MACS_peak_20931	662.31	198	0	0	1	other
9	38620559	38620834	MACS_peak_20932	581.92	275	0	0	1	other
9	38799422	38799556	MACS_peak_20933	1315.78	134	0	0	0	intergen
9	38849068	38849291	MACS_peak_20934	561.48	223	0	0	1	other
9	39149661	39150109	MACS_peak_20935	457.34	448	0	1	0	gen
9	66805309	66805692	MACS_peak_20938	1008.94	383	0	0	0	intergen
9	60838081	60838529	MACS_peak_20942	457.34	448	0	0	0	intergen
9	39559404	39559716	MACS_peak_20943	1019.35	312	0	0	0	intergen
9	39712578	39712852	MACS_peak_20944	1057.49	274	0	0	0	intergen
9	39719801	39719984	MACS_peak_20945	501.35	183	0	0	0	intergen
9	39821405	39821785	MACS_peak_20946	287.19	380	0	0	2	other
9	39944821	39945082	MACS_peak_20947	364.76	261	0	0	1	other
9	40169240	40169619	MACS_peak_20949	553.4	379	0	0	1	other
9	40250198	40250530	MACS_peak_20950	243.62	332	0	1	0	gen
9	40378624	40378855	MACS_peak_20951	370.4	231	0	0	0	intergen
9	65275520	65275827	MACS_peak_20952	96.3	307	0	0	0	intergen
9	65257686	65258164	MACS_peak_20953	3100	478	0	0	0	intergen
9	65252154	65252551	MACS_peak_20954	899.04	397	0	0	0	intergen
9	65245463	65245827	MACS_peak_20955	214.05	364	0	0	0	intergen
9	64639725	64639962	MACS_peak_20961	604.07	237	0	0	1	other
9	64396488	64396820	MACS_peak_20963	233.64	332	0	1	0	gen
9	66206605	66206984	MACS_peak_20964	549.79	379	0	0	1	other
9	41311514	41311860	MACS_peak_20965	1143.87	346	0	0	1	other
9	42254299	42254624	MACS_peak_20966	115.67	325	0	0	1	other
9	61113749	61114086	MACS_peak_20967	277.64	337	0	0	0	intergen
9	61088649	61089130	MACS_peak_20968	81.3	481	0	0	1	other
9	61686667	61686809	MACS_peak_20973	1067.21	142	0	0	0	intergen
9	62007289	62007654	MACS_peak_20974	115.34	365	0	0	0	intergen
9	62073501	62073715	MACS_peak_20975	576.65	214	0	0	1	other
9	40152108	40152461	MACS_peak_20976	1371.75	353	0	0	1	other
9	41518469	41518755	MACS_peak_20977	449.15	286	0	0	0	intergen
9	41568806	41569180	MACS_peak_20979	62.38	374	0	0	0	intergen
9	41621867	41622204	MACS_peak_20980	76.3	337	0	0	0	intergen
9	41622344	41622690	MACS_peak_20981	64.9	346	0	0	0	intergen
9	62297156	62297407	MACS_peak_20982	334.57	251	0	0	0	intergen
9	62305637	62305898	MACS_peak_20983	360.79	261	0	0	0	intergen
9	62408643	62408956	MACS_peak_20984	380.3	313	0	0	1	other
9	62409259	62409472	MACS_peak_20985	693.88	213	0	0	1	other
9	62499721	62499916	MACS_peak_20986	600.37	195	0	0	0	intergen
9	62500237	62500550	MACS_peak_20987	380.3	313	0	0	0	intergen
9	62550611	62550850	MACS_peak_20988	571.15	239	0	0	0	intergen
9	62620979	62621322	MACS_peak_20989	312.33	343	0	0	0	intergen
9	62629564	62629838	MACS_peak_20990	1076.16	274	0	0	0	intergen
9	62670512	62670816	MACS_peak_20991	224.66	304	0	0	0	intergen
9	41847126	41847486	MACS_peak_20992	402.85	360	0	0	0	intergen
9	67514670	67514884	MACS_peak_20996	460.03	214	0	0	1	other
9	66664082	66664356	MACS_peak_20997	932.94	274	0	0	0	intergen
9	62816751	62816992	MACS_peak_20999	196.06	241	0	0	0	intergen
9	40754096	40754404	MACS_peak_21000	859.6	308	0	0	0	intergen
9	40808413	40808647	MACS_peak_21001	111.21	234	0	0	0	intergen
9	40815869	40816236	MACS_peak_21002	63.13	367	0	0	0	intergen
9	40821569	40821987	MACS_peak_21003	87.95	418	0	0	0	intergen
9	40823342	40823703	MACS_peak_21004	61.46	361	0	0	0	intergen
9	40825403	40825726	MACS_peak_21005	50.92	323	0	0	0	intergen
9	40826395	40826679	MACS_peak_21006	74.4	284	0	0	0	intergen
9	40828703	40829055	MACS_peak_21007	51.8	352	0	0	0	intergen
9	40830608	40830921	MACS_peak_21008	92.94	313	0	0	0	intergen
9	40832544	40832845	MACS_peak_21009	70.59	301	0	0	0	intergen
9	40833418	40833879	MACS_peak_21010	108.11	461	0	0	0	intergen
9	40835833	40836229	MACS_peak_21011	215.73	396	0	0	0	intergen
9	40846168	40846553	MACS_peak_21013	91.73	385	0	0	0	intergen
9	40846668	40846894	MACS_peak_21014	57.39	226	0	0	0	intergen
9	40847661	40848101	MACS_peak_21015	176	440	0	0	0	intergen
9	40850769	40850980	MACS_peak_21016	103.17	211	0	0	0	intergen
9	40853777	40854006	MACS_peak_21017	82.02	229	0	0	0	intergen
9	40865074	40865293	MACS_peak_21019	65.36	219	0	0	0	intergen
9	40869289	40869441	MACS_peak_21021	139.81	152	0	0	0	intergen
9	40886548	40886774	MACS_peak_21024	390.55	226	0	0	0	intergen
9	40903216	40903659	MACS_peak_21027	64.75	443	0	0	0	intergen
9	63031560	63031958	MACS_peak_21029	105.65	398	0	0	0	intergen
9	63066966	63067283	MACS_peak_21031	79.65	317	0	0	0	intergen
9	63068490	63068793	MACS_peak_21032	148.85	303	0	0	0	intergen
9	63073397	63073697	MACS_peak_21033	63.32	300	0	0	0	intergen
9	63076555	63076921	MACS_peak_21034	51.32	366	0	0	0	intergen
9	63124990	63125227	MACS_peak_21035	394.53	237	0	0	1	other
9	63132187	63132350	MACS_peak_21036	592.22	163	0	0	1	other
9	63335220	63335457	MACS_peak_21037	566.52	237	0	0	2	other
9	63362950	63363428	MACS_peak_21038	161.59	478	0	0	1	other
9	63407384	63407601	MACS_peak_21040	191.87	217	0	0	0	intergen
9	38784512	38784937	MACS_peak_21042	182.3	425	0	0	0	intergen
9	67886217	67886549	MACS_peak_21043	235.8	332	0	1	0	gen
9	67907023	67907376	MACS_peak_21044	119.78	353	0	0	1	other
9	63542930	63543216	MACS_peak_21045	437.62	286	0	0	0	intergen
9	63743871	63744211	MACS_peak_21046	508.53	340	0	0	1	other
9	63819131	63819430	MACS_peak_21047	65.97	299	0	0	0	intergen
9	63881298	63881771	MACS_peak_21048	1130.38	473	0	0	0	intergen
9	63889138	63889618	MACS_peak_21049	211.79	480	0	0	0	intergen
9	40962400	40962880	MACS_peak_21050	396.6	480	0	0	0	intergen
9	41088667	41089118	MACS_peak_21052	1922.78	451	0	0	1	other
9	40936788	40937044	MACS_peak_21053	63.04	256	0	0	0	intergen
9	64608292	64608657	MACS_peak_21059	50.9	365	0	0	0	intergen
9	64632605	64632767	MACS_peak_21060	571.06	162	0	0	1	other
9	64648329	64648641	MACS_peak_21062	388.99	312	0	0	1	other
9	64672001	64672186	MACS_peak_21063	182.97	185	0	0	0	intergen
9	64688031	64688397	MACS_peak_21064	64.79	366	0	0	0	intergen
9	64696157	64696620	MACS_peak_21065	186.72	463	0	0	0	intergen
9	64697637	64697985	MACS_peak_21066	91.31	348	0	0	0	intergen
9	64699559	64699876	MACS_peak_21068	53.96	317	0	0	0	intergen
9	64731397	64731795	MACS_peak_21069	96.97	398	0	0	0	intergen
9	64752783	64753087	MACS_peak_21070	2648.22	304	0	0	0	intergen
9	64759976	64760340	MACS_peak_21072	209.06	364	0	0	0	intergen
9	64766681	64767078	MACS_peak_21073	739.88	397	0	0	0	intergen
9	64781598	64781978	MACS_peak_21075	124.14	380	0	0	0	intergen
9	64784989	64785323	MACS_peak_21076	71.12	334	0	0	0	intergen
9	64877701	64878009	MACS_peak_21077	869.73	308	0	0	0	intergen
9	64929121	64929459	MACS_peak_21078	72.21	338	0	0	0	intergen
9	64959629	64959929	MACS_peak_21079	58.83	300	0	0	0	intergen
9	64965900	64966351	MACS_peak_21080	106.55	451	0	0	0	intergen
9	64970395	64970825	MACS_peak_21083	408.49	430	0	0	0	intergen
9	64978115	64978283	MACS_peak_21085	50.66	168	0	0	0	intergen
9	64984125	64984354	MACS_peak_21086	102.59	229	0	0	0	intergen
9	64995343	64995642	MACS_peak_21088	67.03	299	0	0	0	intergen
9	65177527	65177846	MACS_peak_21090	69	319	0	0	0	intergen
9	65216887	65217285	MACS_peak_21092	96.97	398	0	0	0	intergen
9	65844297	65844515	MACS_peak_21098	156.34	218	0	0	0	intergen
9	65843851	65844170	MACS_peak_21099	69	319	0	0	0	intergen
9	65804730	65805128	MACS_peak_21101	96.97	398	0	0	0	intergen
9	65776133	65776497	MACS_peak_21104	212.03	364	0	0	0	intergen
9	65769409	65769806	MACS_peak_21105	793.59	397	0	0	0	intergen
9	65710542	65710814	MACS_peak_21107	59.86	272	0	1	0	gen
9	68342475	68342926	MACS_peak_21112	2118.01	451	0	1	0	gen
9	68507374	68507749	MACS_peak_21113	404.42	375	0	1	0	gen
9	68658269	68658600	MACS_peak_21114	425.78	331	0	0	0	intergen
9	69212139	69212438	MACS_peak_21115	634.13	299	0	2	0	gen
9	69223653	69223848	MACS_peak_21116	658.86	195	0	2	0	gen
9	69292155	69292460	MACS_peak_21117	266.75	305	0	0	0	intergen
9	69682371	69682726	MACS_peak_21118	65.05	355	0	0	0	intergen
9	69682764	69682998	MACS_peak_21119	103.49	234	0	0	0	intergen
9	69860971	69861307	MACS_peak_21120	1955.51	336	0	1	0	gen
9	69971931	69972225	MACS_peak_21121	1105.11	294	0	0	0	intergen
9	70236054	70236355	MACS_peak_21123	89.02	301	0	0	1	other
9	70309227	70309451	MACS_peak_21124	846.42	224	0	1	0	gen
9	70340676	70340909	MACS_peak_21125	415.89	233	0	1	0	gen
9	70352799	70353168	MACS_peak_21126	640.87	369	0	1	0	gen
9	70432414	70432800	MACS_peak_21127	52.99	386	0	0	0	intergen
9	71420883	71421054	MACS_peak_21129	777.13	171	0	1	0	gen
9	71480167	71480378	MACS_peak_21130	929.6	211	0	0	0	intergen
9	71497860	71498270	MACS_peak_21131	83.74	410	0	0	0	intergen
9	71716313	71716691	MACS_peak_21132	403.06	378	0	1	0	gen
9	71732587	71732729	MACS_peak_21133	1125.19	142	0	1	0	gen
9	71759021	71759254	MACS_peak_21134	532.66	233	0	1	0	gen
9	71806805	71807081	MACS_peak_21135	581.17	276	0	1	0	gen
9	71819159	71819444	MACS_peak_21136	574.52	285	0	0	0	intergen
9	71853670	71853961	MACS_peak_21137	427.9	291	0	0	0	intergen
9	71975902	71976152	MACS_peak_21138	901.33	250	0	1	0	gen
9	72450665	72450994	MACS_peak_21139	81.72	329	0	0	0	intergen
9	73023050	73023343	MACS_peak_21140	965.74	293	0	1	0	gen
9	73054579	73054960	MACS_peak_21141	147.15	381	0	1	1	gen
9	73200808	73200943	MACS_peak_21142	1079.97	135	0	0	0	intergen
9	73345449	73345671	MACS_peak_21143	564.54	222	0	0	0	intergen
9	73547192	73547379	MACS_peak_21144	712.32	187	0	0	0	intergen
9	73552431	73552712	MACS_peak_21145	248.09	281	0	0	0	intergen
9	73683904	73684141	MACS_peak_21146	516.86	237	0	0	0	intergen
9	73711296	73711610	MACS_peak_21147	390.44	314	0	0	0	intergen
9	73835327	73835681	MACS_peak_21148	54.09	354	0	0	0	intergen
9	74019755	74020133	MACS_peak_21149	635.08	378	0	0	0	intergen
9	74153772	74154120	MACS_peak_21150	312.33	348	0	0	0	intergen
9	74425826	74426078	MACS_peak_21151	56.84	252	0	0	0	intergen
9	74570958	74571211	MACS_peak_21153	746.04	253	0	1	0	gen
9	75077261	75077458	MACS_peak_21154	662.31	197	0	1	0	gen
9	75185606	75185848	MACS_peak_21155	645.81	242	0	0	0	intergen
9	75186820	75187105	MACS_peak_21156	574.52	285	0	0	0	intergen
9	75631630	75631926	MACS_peak_21157	68.74	296	0	0	0	intergen
9	75684826	75685154	MACS_peak_21158	76.3	328	0	0	0	intergen
9	75855677	75856074	MACS_peak_21159	623.31	397	0	0	0	intergen
9	75869806	75870014	MACS_peak_21160	594.99	208	0	0	0	intergen
9	75880441	75880574	MACS_peak_21161	1176.51	133	0	0	0	intergen
9	76175128	76175360	MACS_peak_21162	289.29	232	0	1	0	gen
9	76403223	76403563	MACS_peak_21163	421.18	340	0	0	0	intergen
9	76666019	76666230	MACS_peak_21164	584.64	211	0	1	0	gen
9	76810327	76810667	MACS_peak_21165	538.05	340	0	1	1	gen
9	77116087	77116219	MACS_peak_21166	1028.85	132	0	0	0	intergen
9	77215970	77216392	MACS_peak_21167	493.69	422	0	1	0	gen
9	77433733	77434006	MACS_peak_21168	583.44	273	0	1	0	gen
9	77480855	77481184	MACS_peak_21169	76.3	329	0	1	1	gen
9	77488578	77488859	MACS_peak_21170	840.54	281	0	1	1	gen
9	77657320	77657658	MACS_peak_21171	418.39	338	0	0	0	intergen
9	77759944	77760108	MACS_peak_21172	946.88	164	0	1	0	gen
9	77827895	77828198	MACS_peak_21173	534.92	303	0	1	0	gen
9	78086837	78086989	MACS_peak_21174	454.08	152	0	0	0	intergen
9	78121596	78121861	MACS_peak_21175	834.03	265	0	0	0	intergen
9	78261491	78261746	MACS_peak_21176	596.79	255	0	1	0	gen
9	78379289	78379432	MACS_peak_21177	898.3	143	0	0	0	intergen
9	78878151	78878436	MACS_peak_21178	50.92	285	0	0	0	intergen
9	78883414	78883573	MACS_peak_21179	637.75	159	0	0	0	intergen
9	79058843	79059161	MACS_peak_21180	467.02	318	0	0	0	intergen
9	79074243	79074588	MACS_peak_21181	54.77	345	0	0	0	intergen
9	79100804	79101120	MACS_peak_21182	54.41	316	0	0	0	intergen
9	79102737	79103070	MACS_peak_21183	152.32	333	0	0	0	intergen
9	79443354	79443615	MACS_peak_21184	56.33	261	0	0	0	intergen
9	79482423	79482687	MACS_peak_21185	590.39	264	0	0	0	intergen
9	79496795	79497117	MACS_peak_21186	78.47	322	0	0	0	intergen
9	79677879	79678107	MACS_peak_21187	605.41	228	0	1	0	gen
9	79758181	79758404	MACS_peak_21188	549.18	223	0	0	0	intergen
9	79906089	79906343	MACS_peak_21189	1001.34	254	0	0	0	intergen
9	79971149	79971387	MACS_peak_21191	516.86	238	0	0	0	intergen
9	80175285	80175728	MACS_peak_21192	1499.94	443	0	0	0	intergen
9	80475725	80476039	MACS_peak_21193	62.38	314	0	0	0	intergen
9	80500463	80500715	MACS_peak_21194	470.06	252	0	0	0	intergen
9	80509477	80509916	MACS_peak_21195	599.25	439	0	0	0	intergen
9	80618555	80618795	MACS_peak_21196	516.86	240	0	0	0	intergen
9	80657012	80657383	MACS_peak_21197	64.38	371	0	0	0	intergen
9	80660494	80660840	MACS_peak_21198	83.12	346	0	0	0	intergen
9	80820250	80820604	MACS_peak_21200	103.07	354	0	0	0	intergen
9	81711641	81712109	MACS_peak_21201	400.21	468	0	0	1	other
9	81746884	81747017	MACS_peak_21202	1285.12	133	0	0	1	other
9	82532429	82532770	MACS_peak_21203	1626.33	341	0	0	1	other
9	82903397	82903735	MACS_peak_21204	661.98	338	0	0	0	intergen
9	82961618	82961876	MACS_peak_21205	468.72	258	0	0	0	intergen
9	83049063	83049264	MACS_peak_21206	364.71	201	0	1	0	gen
9	83169257	83169393	MACS_peak_21207	1061.85	136	0	0	0	intergen
9	83230974	83231369	MACS_peak_21208	397.32	395	0	0	1	other
9	83378544	83378783	MACS_peak_21209	516.86	239	0	1	0	gen
9	83461564	83461951	MACS_peak_21210	164.26	387	0	1	0	gen
9	83620464	83620791	MACS_peak_21211	546.09	327	1	0	0	promoter
9	83620832	83621079	MACS_peak_21212	901.33	247	1	0	0	promoter
9	83649117	83649419	MACS_peak_21213	405.48	302	0	0	0	intergen
9	83727139	83727317	MACS_peak_21214	1144.35	178	0	0	0	intergen
9	83837035	83837382	MACS_peak_21215	911.37	347	1	0	2	promoter
9	84042679	84042903	MACS_peak_21216	413.13	224	0	0	0	intergen
9	84397096	84397380	MACS_peak_21217	821.83	284	0	0	1	other
9	84404120	84404357	MACS_peak_21218	604.07	237	0	0	1	other
9	84668353	84668599	MACS_peak_21219	485.56	246	1	0	0	promoter
9	84697580	84697795	MACS_peak_21220	596.79	215	0	1	0	gen
9	84954017	84954381	MACS_peak_21222	409.51	364	0	1	0	gen
9	85759618	85759933	MACS_peak_21223	59.5	315	0	0	2	other
9	85786200	85786545	MACS_peak_21224	1104.01	345	0	0	2	other
9	85811570	85811795	MACS_peak_21225	71.61	225	0	0	1	other
9	85818914	85819293	MACS_peak_21226	473.12	379	0	0	1	other
9	85963256	85963390	MACS_peak_21227	1000.85	134	0	1	0	gen
9	86076314	86076455	MACS_peak_21228	1913.8	141	0	1	0	gen
9	86158253	86158671	MACS_peak_21229	62.29	418	0	0	0	intergen
9	86287084	86287404	MACS_peak_21230	431.58	320	1	0	0	promoter
9	86377632	86377904	MACS_peak_21231	80.93	272	0	0	0	intergen
9	86379399	86379690	MACS_peak_21232	84.4	291	0	0	0	intergen
9	86392610	86393005	MACS_peak_21233	154.68	395	0	0	0	intergen
9	86414295	86414576	MACS_peak_21234	840.54	281	0	0	0	intergen
9	86434078	86434293	MACS_peak_21235	746.04	215	0	0	0	intergen
9	86586797	86587110	MACS_peak_21236	202.95	313	0	0	0	intergen
9	87047094	87047410	MACS_peak_21237	50.04	316	0	0	0	intergen
9	87200713	87200889	MACS_peak_21238	711.62	176	0	0	0	intergen
9	87290223	87290487	MACS_peak_21239	464.74	264	0	0	0	intergen
9	87663001	87663255	MACS_peak_21240	729.14	254	0	1	0	gen
9	87678723	87678971	MACS_peak_21241	475.45	248	0	1	0	gen
9	87684660	87684835	MACS_peak_21242	972.07	175	0	1	0	gen
9	87812907	87813328	MACS_peak_21243	1977	421	0	0	2	other
9	88173474	88173682	MACS_peak_21244	596.67	208	0	0	0	intergen
9	88297703	88298055	MACS_peak_21245	62.38	352	0	0	0	intergen
9	88343829	88344200	MACS_peak_21246	520.09	371	0	0	0	intergen
9	88548046	88548464	MACS_peak_21247	482.54	418	0	1	0	gen
9	88578512	88578808	MACS_peak_21248	693.99	296	0	1	0	gen
9	88874515	88874713	MACS_peak_21249	662.31	198	0	0	0	intergen
9	89130712	89131113	MACS_peak_21250	69.92	401	0	1	0	gen
9	89163393	89163603	MACS_peak_21251	148.87	210	0	1	0	gen
9	89549119	89549477	MACS_peak_21252	773.7	358	0	0	0	intergen
9	89576315	89576577	MACS_peak_21253	859.93	262	0	0	1	other
9	90194842	90195213	MACS_peak_21254	70.17	371	0	0	0	intergen
9	90202684	90203010	MACS_peak_21255	434.94	326	0	0	0	intergen
9	90226841	90227100	MACS_peak_21256	1004.17	259	0	0	0	intergen
9	90643043	90643294	MACS_peak_21257	485.56	251	0	0	0	intergen
9	90755827	90756127	MACS_peak_21258	958.39	300	0	0	0	intergen
9	90773547	90773920	MACS_peak_21259	638.28	373	0	0	0	intergen
9	90871064	90871361	MACS_peak_21260	693.18	297	0	1	0	gen
9	90914968	90915319	MACS_peak_21261	415.73	351	0	0	0	intergen
9	91426185	91426407	MACS_peak_21262	564.54	222	0	0	0	intergen
9	91727309	91727650	MACS_peak_21264	537.45	341	0	1	0	gen
9	91758487	91758752	MACS_peak_21265	720.77	265	0	1	0	gen
9	92016094	92016375	MACS_peak_21266	439.97	281	0	1	0	gen
9	92140312	92140530	MACS_peak_21267	901.33	218	0	0	0	intergen
9	92502040	92502329	MACS_peak_21269	571.63	289	0	2	0	gen
9	92571239	92571533	MACS_peak_21270	71.37	294	0	1	0	gen
9	92571770	92572126	MACS_peak_21271	69	356	0	1	0	gen
9	92716530	92716829	MACS_peak_21272	823.37	299	0	1	0	gen
9	92765382	92765647	MACS_peak_21273	464.09	265	0	0	0	intergen
9	92855527	92855718	MACS_peak_21274	606.05	191	0	1	1	gen
9	92957210	92957547	MACS_peak_21275	455.24	337	0	1	0	gen
9	92996472	92996824	MACS_peak_21276	100.11	352	0	1	0	gen
9	93109190	93109477	MACS_peak_21277	437.02	287	0	1	0	gen
9	93302713	93302992	MACS_peak_21278	980.98	279	0	1	0	gen
9	93682193	93682421	MACS_peak_21279	848.95	228	0	0	0	intergen
9	93740601	93740846	MACS_peak_21280	396.08	245	0	0	0	intergen
9	93759141	93759464	MACS_peak_21281	672.92	323	0	0	0	intergen
9	93786612	93786945	MACS_peak_21282	845.32	333	0	0	0	intergen
9	93841315	93841705	MACS_peak_21283	50.38	390	0	0	0	intergen
9	93909032	93909469	MACS_peak_21284	600.34	437	0	0	0	intergen
9	94002688	94002919	MACS_peak_21285	532.66	231	0	0	0	intergen
9	94023080	94023317	MACS_peak_21286	80.49	237	0	0	0	intergen
9	94065530	94065770	MACS_peak_21287	797.18	240	0	1	0	gen
9	94270646	94271029	MACS_peak_21288	573.91	383	0	1	0	gen
9	94539536	94539820	MACS_peak_21290	928.69	284	0	0	0	intergen
9	94668804	94669158	MACS_peak_21291	480	354	0	0	0	intergen
9	95167920	95168178	MACS_peak_21292	727.26	258	0	1	0	gen
9	95213402	95213649	MACS_peak_21293	901.33	247	0	1	0	gen
9	95230081	95230346	MACS_peak_21294	419.41	265	0	1	0	gen
9	95496299	95496563	MACS_peak_21295	464.74	264	0	1	0	gen
9	95697827	95698105	MACS_peak_21296	82.66	278	0	0	1	other
9	95736440	95736707	MACS_peak_21297	391.8	267	0	0	0	intergen
9	95959467	95959747	MACS_peak_21298	94.54	280	0	1	0	gen
9	96061359	96061537	MACS_peak_21299	896.47	178	0	0	0	intergen
9	96218251	96218428	MACS_peak_21300	1171.45	177	0	0	0	intergen
9	96232450	96232711	MACS_peak_21301	353.13	261	2	0	0	promoter
9	96317482	96317710	MACS_peak_21302	541.47	228	1	1	0	promoter
9	96327855	96328071	MACS_peak_21303	564.92	216	0	2	0	gen
9	96441846	96442109	MACS_peak_21304	893.83	263	0	0	0	intergen
9	96651670	96652026	MACS_peak_21305	649.49	356	0	1	0	gen
9	96666704	96667108	MACS_peak_21306	761.42	404	0	0	0	intergen
9	96856884	96857150	MACS_peak_21307	588.83	266	0	1	0	gen
9	97207931	97208178	MACS_peak_21308	56.16	247	0	0	2	other
9	97298856	97299103	MACS_peak_21310	612.68	247	0	0	1	other
9	97336046	97336402	MACS_peak_21311	96.24	356	0	1	1	gen
9	97399188	97399477	MACS_peak_21312	970.02	289	0	0	0	intergen
9	97411557	97412024	MACS_peak_21313	945.76	467	1	0	0	promoter
9	97493837	97494217	MACS_peak_21314	178.37	380	0	1	0	gen
9	97585141	97585547	MACS_peak_21315	58.08	406	0	1	0	gen
9	97586176	97586580	MACS_peak_21316	83.52	404	0	1	0	gen
9	97598798	97599062	MACS_peak_21317	464.74	264	1	1	0	promoter
9	98205784	98206048	MACS_peak_21318	1165.47	264	0	1	0	gen
9	98263832	98264089	MACS_peak_21319	573.71	257	0	0	0	intergen
9	98266137	98266517	MACS_peak_21320	129.15	380	0	0	0	intergen
9	98424762	98425043	MACS_peak_21321	95.8	281	0	1	0	gen
9	98512074	98512417	MACS_peak_21322	77.16	343	0	1	0	gen
9	98681003	98681294	MACS_peak_21323	69	291	0	1	0	gen
9	98775952	98776212	MACS_peak_21324	456.88	260	0	1	0	gen
9	98791288	98791482	MACS_peak_21325	678.9	194	0	1	0	gen
9	98848566	98848851	MACS_peak_21326	574.52	285	0	1	1	gen
9	98952713	98952985	MACS_peak_21327	459.58	272	0	1	0	gen
9	99000504	99000777	MACS_peak_21328	713.56	273	0	1	0	gen
9	99140698	99141054	MACS_peak_21329	905.24	356	0	1	0	gen
9	99224449	99224662	MACS_peak_21330	914.46	213	1	0	0	promoter
9	99257428	99257613	MACS_peak_21331	589.52	185	0	0	0	intergen
9	99816413	99816699	MACS_peak_21333	406.36	286	0	0	1	other
9	99947423	99947651	MACS_peak_21334	522.21	228	0	1	0	gen
9	100222761	100223032	MACS_peak_21336	715.34	271	0	1	0	gen
9	100323036	100323257	MACS_peak_21337	729.14	221	0	1	0	gen
9	100483573	100483855	MACS_peak_21339	611.86	282	0	2	0	gen
9	100595609	100596008	MACS_peak_21340	1133.01	399	0	0	0	intergen
9	100602405	100602625	MACS_peak_21341	729.14	220	0	0	0	intergen
9	100634352	100634732	MACS_peak_21342	76.3	380	0	0	0	intergen
9	100646933	100647193	MACS_peak_21343	169.5	260	0	0	0	intergen
9	100985985	100986419	MACS_peak_21344	54.53	434	0	0	0	intergen
9	101292797	101293112	MACS_peak_21345	56.38	315	0	1	0	gen
9	101449898	101450140	MACS_peak_21346	501.16	242	0	0	0	intergen
9	101459135	101459397	MACS_peak_21347	788.19	262	0	0	0	intergen
9	101495130	101495439	MACS_peak_21348	683.61	309	0	1	0	gen
9	101530113	101530495	MACS_peak_21349	401.26	382	1	1	0	promoter
9	101549614	101549967	MACS_peak_21350	673.34	353	0	1	0	gen
9	101617856	101618115	MACS_peak_21351	56.38	259	0	1	0	gen
9	101711403	101711618	MACS_peak_21352	596.79	215	0	1	0	gen
9	101865954	101866187	MACS_peak_21353	678.9	233	0	0	0	intergen
9	101977595	101977998	MACS_peak_21354	1317.25	403	0	0	0	intergen
9	102080414	102080792	MACS_peak_21355	845.32	378	0	0	0	intergen
9	102086169	102086547	MACS_peak_21356	516.25	378	0	0	0	intergen
9	102363627	102364069	MACS_peak_21357	715.86	442	0	0	0	intergen
9	102584009	102584340	MACS_peak_21358	425.78	331	0	0	1	other
9	102687863	102688078	MACS_peak_21359	484	215	0	0	0	intergen
9	103014068	103014323	MACS_peak_21362	596.79	255	0	1	0	gen
9	103108897	103109061	MACS_peak_21363	831.63	164	0	0	0	intergen
9	103490358	103490565	MACS_peak_21365	114.29	207	0	0	0	intergen
9	103617951	103618260	MACS_peak_21366	400.9	309	0	0	0	intergen
9	103764005	103764271	MACS_peak_21367	1069.92	266	0	0	0	intergen
9	103805877	103806082	MACS_peak_21368	218.87	205	0	0	0	intergen
9	103955331	103955563	MACS_peak_21369	1220.56	232	0	0	0	intergen
9	104063205	104063496	MACS_peak_21370	77.53	291	0	0	0	intergen
9	104177005	104177327	MACS_peak_21371	936.39	322	0	0	0	intergen
9	104386534	104386976	MACS_peak_21372	705.9	442	0	0	0	intergen
9	104395004	104395209	MACS_peak_21373	573.39	205	0	0	0	intergen
9	104494891	104495078	MACS_peak_21374	555.36	187	0	0	0	intergen
9	104682641	104683008	MACS_peak_21375	951.01	367	0	0	0	intergen
9	104863192	104863500	MACS_peak_21376	1231.26	308	0	1	0	gen
9	104926428	104926696	MACS_peak_21377	587.27	268	0	1	0	gen
9	105157222	105157380	MACS_peak_21378	1116.4	158	0	0	0	intergen
9	105415514	105415674	MACS_peak_21379	866.35	160	0	1	0	gen
9	105425999	105426334	MACS_peak_21380	541.11	335	0	1	0	gen
9	105449968	105450150	MACS_peak_21381	936.57	182	1	0	0	promoter
9	105565353	105565603	MACS_peak_21382	172.13	250	0	1	0	gen
9	105580814	105580988	MACS_peak_21383	66.54	174	0	1	0	gen
9	105637837	105638081	MACS_peak_21384	629.38	244	0	1	0	gen
9	105690886	105691125	MACS_peak_21385	645.81	239	1	0	0	promoter
9	105718598	105718897	MACS_peak_21386	350.09	299	0	1	0	gen
9	105728918	105729285	MACS_peak_21387	84.86	367	0	1	0	gen
9	105842057	105842367	MACS_peak_21389	324.37	310	0	0	0	intergen
9	105881619	105882001	MACS_peak_21390	401.26	382	0	0	0	intergen
9	106168464	106168664	MACS_peak_21391	60.08	200	0	0	1	other
9	106538095	106538415	MACS_peak_21392	78.16	320	0	0	1	other
9	106635348	106635681	MACS_peak_21393	665.57	333	0	0	1	other
9	106650405	106650764	MACS_peak_21394	72.09	359	0	0	1	other
9	106814415	106814794	MACS_peak_21395	106.16	379	0	0	0	intergen
9	106855154	106855292	MACS_peak_21396	1220.56	138	0	0	0	intergen
9	107083911	107084132	MACS_peak_21397	432.48	221	0	0	1	other
9	107137612	107137939	MACS_peak_21398	722.05	327	0	0	0	intergen
9	107172307	107172646	MACS_peak_21399	538.66	339	0	0	0	intergen
9	107255923	107256142	MACS_peak_21400	150.32	219	0	0	0	intergen
9	107287829	107287962	MACS_peak_21401	1176.51	133	1	0	0	promoter
9	107307954	107308240	MACS_peak_21402	518.15	286	0	1	0	gen
9	107341202	107341469	MACS_peak_21403	718.95	267	0	0	0	intergen
9	107416654	107416988	MACS_peak_21404	918.9	334	0	0	0	intergen
9	107766158	107766291	MACS_peak_21405	1396.21	133	0	0	0	intergen
9	107822165	107822309	MACS_peak_21406	213.96	144	0	0	0	intergen
9	107962319	107962674	MACS_peak_21407	413.79	355	0	0	0	intergen
9	108028937	108029308	MACS_peak_21408	93.27	371	0	0	0	intergen
9	108029363	108029747	MACS_peak_21409	136.8	384	0	0	0	intergen
9	108323626	108323865	MACS_peak_21410	877.68	239	0	0	0	intergen
9	108503301	108503591	MACS_peak_21411	67.35	290	0	0	0	intergen
9	108507456	108507778	MACS_peak_21412	150.71	322	0	0	0	intergen
9	108671253	108671527	MACS_peak_21413	582.68	274	0	0	0	intergen
9	108725546	108725791	MACS_peak_21414	487.14	245	0	0	0	intergen
9	108850313	108850689	MACS_peak_21415	403.97	376	1	0	0	promoter
9	108954101	108954323	MACS_peak_21416	693.94	222	0	1	0	gen
9	109183439	109183791	MACS_peak_21417	530.91	352	0	1	0	gen
9	109244606	109244795	MACS_peak_21418	994.68	189	0	1	0	gen
9	109266631	109267017	MACS_peak_21419	448.19	386	0	1	0	gen
9	109401454	109401749	MACS_peak_21420	694.81	295	0	1	0	gen
9	109411987	109412233	MACS_peak_21421	918.92	246	0	1	0	gen
9	109469676	109469996	MACS_peak_21422	349.84	320	0	1	0	gen
9	109520543	109520794	MACS_peak_21423	613.04	251	0	0	0	intergen
9	109578058	109578414	MACS_peak_21424	413.31	356	0	0	0	intergen
9	109701475	109701867	MACS_peak_21425	59.21	392	0	1	0	gen
9	109817840	109818193	MACS_peak_21426	1320.05	353	0	2	0	gen
9	109859505	109859722	MACS_peak_21427	442.02	217	0	2	0	gen
9	110232072	110232423	MACS_peak_21428	50.92	351	0	0	0	intergen
9	110452238	110452580	MACS_peak_21429	659.14	342	0	1	0	gen
9	110638441	110638668	MACS_peak_21430	848.95	227	0	0	0	intergen
9	110680929	110681191	MACS_peak_21431	838.54	262	0	1	0	gen
9	110701706	110701946	MACS_peak_21433	126.23	240	0	1	0	gen
9	110835377	110835747	MACS_peak_21434	640.22	370	0	0	0	intergen
9	110858780	110859033	MACS_peak_21435	470.06	253	0	0	0	intergen
9	110904165	110904466	MACS_peak_21436	972.38	301	0	1	0	gen
9	110998842	110999042	MACS_peak_21437	814.37	200	0	1	0	gen
9	111027781	111027915	MACS_peak_21438	1164.86	134	0	1	0	gen
9	111109211	111109435	MACS_peak_21439	557.22	224	0	0	0	intergen
9	111225805	111226135	MACS_peak_21440	50.92	330	0	0	1	other
9	111299349	111299742	MACS_peak_21441	677.09	393	0	0	0	intergen
9	111349850	111350081	MACS_peak_21442	1290.73	231	0	0	0	intergen
9	111352466	111352739	MACS_peak_21443	3100	273	0	0	0	intergen
9	111581235	111581434	MACS_peak_21444	1208.41	199	0	1	0	gen
9	111597806	111598136	MACS_peak_21445	1059.89	330	0	1	0	gen
9	111691741	111691998	MACS_peak_21446	380.3	257	0	1	0	gen
9	111803765	111804095	MACS_peak_21447	265.34	330	0	0	0	intergen
9	111889300	111889636	MACS_peak_21448	260.48	336	0	0	0	intergen
9	112086627	112087001	MACS_peak_21449	518.44	374	0	1	0	gen
9	112097795	112098069	MACS_peak_21450	847.52	274	0	1	0	gen
9	112113041	112113239	MACS_peak_21451	721.03	198	0	1	0	gen
9	112361169	112361455	MACS_peak_21452	312.33	286	0	0	0	intergen
9	112443148	112443584	MACS_peak_21453	1232.74	436	0	1	1	gen
9	112462457	112462634	MACS_peak_21454	1570.55	177	0	1	1	gen
9	112508418	112508614	MACS_peak_21455	640.4	196	0	1	0	gen
9	112517763	112518007	MACS_peak_21456	473.21	244	0	1	0	gen
9	112545819	112545953	MACS_peak_21457	1445.82	134	0	1	0	gen
9	112665437	112665833	MACS_peak_21458	406.81	396	0	1	0	gen
9	112711160	112711417	MACS_peak_21459	424.66	257	0	1	0	gen
9	112756336	112756566	MACS_peak_21460	445.1	230	0	1	0	gen
9	112819943	112820115	MACS_peak_21461	1007.8	172	0	1	0	gen
9	113111351	113111729	MACS_peak_21462	1889.85	378	0	0	0	intergen
9	113112839	113113221	MACS_peak_21463	1883.99	382	0	0	0	intergen
9	113182066	113182288	MACS_peak_21464	712.32	222	0	1	0	gen
9	113274381	113274806	MACS_peak_21465	492.24	425	1	1	0	promoter
9	113285239	113285397	MACS_peak_21466	540.72	158	0	1	0	gen
9	113309200	113309570	MACS_peak_21467	1494.88	370	1	0	0	promoter
9	113401408	113401729	MACS_peak_21468	549.92	321	0	0	0	intergen
9	113442755	113443109	MACS_peak_21469	68.99	354	1	0	0	promoter
9	113682304	113682537	MACS_peak_21471	517.97	233	0	0	1	other
9	113807447	113807652	MACS_peak_21472	797.18	205	0	0	0	intergen
9	113823934	113824151	MACS_peak_21473	1079.97	217	0	0	0	intergen
9	113876758	113877061	MACS_peak_21474	688.35	303	1	0	0	promoter
9	114339149	114339445	MACS_peak_21475	445	296	0	0	0	intergen
9	114504332	114504565	MACS_peak_21476	532.66	233	0	1	0	gen
9	114507756	114508041	MACS_peak_21477	451.52	285	0	0	0	intergen
9	114653627	114653863	MACS_peak_21478	619.51	236	1	0	0	promoter
9	114849522	114849796	MACS_peak_21479	826.15	274	1	0	0	promoter
9	115015119	115015346	MACS_peak_21480	695.57	227	1	1	0	promoter
9	115290331	115290467	MACS_peak_21481	478.67	136	0	1	0	gen
9	115419012	115419337	MACS_peak_21482	51.7	325	0	0	1	other
9	115591513	115591760	MACS_peak_21483	485.56	247	0	0	1	other
9	115593560	115593811	MACS_peak_21484	746.04	251	0	0	1	other
9	115693937	115694246	MACS_peak_21485	721.05	309	0	0	1	other
9	115883747	115884009	MACS_peak_21486	466.05	262	0	0	0	intergen
9	116120120	116120350	MACS_peak_21487	387.94	230	0	0	0	intergen
9	116495181	116495346	MACS_peak_21488	831.63	165	0	1	0	gen
9	116601474	116601734	MACS_peak_21489	593.56	260	0	1	0	gen
9	116647359	116647628	MACS_peak_21490	448.17	269	0	1	0	gen
9	116681358	116681753	MACS_peak_21491	56.34	395	0	1	0	gen
9	116860561	116860831	MACS_peak_21492	460.86	270	0	1	1	gen
9	116933001	116933135	MACS_peak_21493	1128.92	134	0	1	0	gen
9	117220914	117221240	MACS_peak_21494	415.15	326	0	1	0	gen
9	117411622	117411888	MACS_peak_21495	463.44	266	0	1	0	gen
9	117587537	117587745	MACS_peak_21496	604.98	208	0	0	0	intergen
9	117629452	117629875	MACS_peak_21497	476.21	423	0	0	0	intergen
9	117644771	117645018	MACS_peak_21498	629.38	247	0	0	0	intergen
9	117783249	117783451	MACS_peak_21499	1377.21	202	0	1	1	gen
9	118170077	118170287	MACS_peak_21500	613.04	210	0	0	0	intergen
9	118345133	118345388	MACS_peak_21501	561.02	255	0	0	0	intergen
9	118750190	118750439	MACS_peak_21502	306.26	249	0	0	0	intergen
9	118951080	118951212	MACS_peak_21503	1116.4	132	0	0	0	intergen
9	119038505	119038877	MACS_peak_21504	53.9	372	0	0	0	intergen
9	119066376	119066617	MACS_peak_21505	95.76	241	0	0	0	intergen
9	119072371	119072653	MACS_peak_21506	440.04	282	0	0	0	intergen
9	119289750	119290155	MACS_peak_21507	865.33	405	0	1	0	gen
9	119365764	119365971	MACS_peak_21508	613.04	207	0	1	0	gen
9	119480957	119481171	MACS_peak_21509	481.47	214	0	0	0	intergen
9	119745747	119746128	MACS_peak_21510	169.37	381	0	0	0	intergen
9	119969198	119969470	MACS_peak_21511	459.58	272	0	0	0	intergen
9	120057776	120058045	MACS_peak_21512	55.85	269	0	0	0	intergen
9	120221714	120221872	MACS_peak_21513	767.82	158	0	0	0	intergen
9	120348942	120349228	MACS_peak_21514	702.3	286	0	0	0	intergen
9	120477475	120477677	MACS_peak_21515	1569.18	202	0	1	0	gen
9	120531862	120532025	MACS_peak_21516	844.76	163	0	1	0	gen
9	120612131	120612468	MACS_peak_21517	416.46	337	0	1	0	gen
9	120619801	120620024	MACS_peak_21518	680.1	223	0	1	0	gen
9	120743013	120743212	MACS_peak_21519	1097.76	199	0	0	0	intergen
9	120755880	120756184	MACS_peak_21520	924.12	304	1	0	0	promoter
9	120936613	120936811	MACS_peak_21521	662.31	198	0	0	0	intergen
9	121092441	121092829	MACS_peak_21522	848.61	388	0	1	0	gen
9	121100534	121100905	MACS_peak_21523	208.73	371	0	1	0	gen
9	121101993	121102235	MACS_peak_21524	147.28	242	0	1	0	gen
9	121169147	121169438	MACS_peak_21525	698.11	291	0	1	0	gen
9	121213292	121213719	MACS_peak_21526	976.47	427	0	2	0	gen
9	121222469	121222730	MACS_peak_21527	705.75	261	0	2	0	gen
9	121228306	121228444	MACS_peak_21528	869.22	138	0	1	0	gen
9	121278765	121279055	MACS_peak_21529	448.52	290	0	1	0	gen
9	121320106	121320524	MACS_peak_21530	866.21	418	0	1	0	gen
9	121415827	121416125	MACS_peak_21531	57.07	298	0	0	1	other
9	121463102	121463352	MACS_peak_21532	746.04	250	0	0	1	other
9	121735058	121735267	MACS_peak_21533	613.04	209	0	1	0	gen
9	121986939	121987256	MACS_peak_21534	1106.44	317	0	1	0	gen
9	122005643	122005931	MACS_peak_21535	436.42	288	0	1	0	gen
9	122016824	122017170	MACS_peak_21536	783.08	346	0	1	0	gen
9	122024521	122024749	MACS_peak_21537	668.89	228	0	1	0	gen
9	122095341	122095538	MACS_peak_21538	641.55	197	0	0	0	intergen
9	122125083	122125398	MACS_peak_21539	1222.71	315	0	0	0	intergen
9	122217804	122218076	MACS_peak_21540	459.58	272	0	1	0	gen
9	122453251	122453424	MACS_peak_21541	561.45	173	0	0	0	intergen
9	122454658	122454910	MACS_peak_21542	611.88	252	0	0	0	intergen
9	122465054	122465365	MACS_peak_21543	436.49	311	0	0	0	intergen
9	122590406	122590886	MACS_peak_21544	90.37	480	0	0	0	intergen
9	122678933	122679213	MACS_peak_21545	265.34	280	1	0	0	promoter
9	122761199	122761545	MACS_peak_21546	56.38	346	0	0	0	intergen
9	122764817	122765124	MACS_peak_21547	73.66	307	0	0	0	intergen
9	122809434	122809661	MACS_peak_21548	709.61	227	0	1	0	gen
9	122991385	122991757	MACS_peak_21549	506.92	372	0	1	0	gen
9	123081881	123082097	MACS_peak_21550	879.27	216	0	1	0	gen
9	123145886	123146151	MACS_peak_21551	1131.32	265	0	1	0	gen
9	123349935	123350199	MACS_peak_21552	857.82	264	0	0	0	intergen
9	123365345	123365591	MACS_peak_21553	629.38	246	0	1	0	gen
9	123385420	123385652	MACS_peak_21554	721.03	232	0	1	0	gen
9	123401956	123402294	MACS_peak_21555	789.53	338	0	1	0	gen
9	123907853	123908256	MACS_peak_21557	54.86	403	0	1	0	gen
9	124126801	124127078	MACS_peak_21558	456.44	277	0	0	0	intergen
9	124140422	124140649	MACS_peak_21559	501.44	227	0	0	0	intergen
9	124320404	124320693	MACS_peak_21560	449.12	289	0	1	0	gen
9	124410353	124410626	MACS_peak_21561	529.8	273	0	1	0	gen
9	124536743	124537099	MACS_peak_21562	265.34	356	0	1	0	gen
9	124568802	124569132	MACS_peak_21563	243.49	330	0	1	0	gen
9	124698720	124698999	MACS_peak_21564	455.19	279	0	1	0	gen
9	124711985	124712426	MACS_peak_21565	1804.08	441	0	1	0	gen
9	125011482	125011895	MACS_peak_21566	90.87	413	0	1	0	gen
9	125089378	125089565	MACS_peak_21567	646.78	187	0	1	0	gen
9	125143716	125144080	MACS_peak_21568	524.01	364	1	0	0	promoter
9	125374736	125374995	MACS_peak_21569	594.37	259	0	0	0	intergen
9	125428035	125428312	MACS_peak_21570	1271.64	277	0	0	0	intergen
9	125558480	125558814	MACS_peak_21571	1200.45	334	0	1	0	gen
9	125624915	125625295	MACS_peak_21572	103.45	380	0	1	0	gen
9	125631434	125631655	MACS_peak_21573	564.54	221	0	1	0	gen
9	125687880	125688075	MACS_peak_21574	662.31	195	0	1	0	gen
9	125913406	125913569	MACS_peak_21575	848.95	163	0	1	0	gen
9	126228888	126229195	MACS_peak_21576	559.13	307	0	0	0	intergen
9	126446402	126446534	MACS_peak_21577	1116.4	132	0	1	0	gen
9	126491359	126491704	MACS_peak_21578	657.04	345	0	1	0	gen
9	126499237	126499540	MACS_peak_21579	955.3	303	0	1	0	gen
9	126500887	126501172	MACS_peak_21580	451.52	285	0	1	0	gen
9	126509208	126509343	MACS_peak_21581	1359.65	135	0	0	0	intergen
9	126555420	126555708	MACS_peak_21582	541.36	288	0	0	0	intergen
9	126705285	126705559	MACS_peak_21583	582.68	274	0	0	0	intergen
9	126860250	126860526	MACS_peak_21584	581.17	276	1	0	0	promoter
9	126940661	126940889	MACS_peak_21585	1144.35	228	0	1	0	gen
9	126997818	126998070	MACS_peak_21586	88.17	252	0	1	0	gen
9	127203070	127203390	MACS_peak_21587	722.05	320	0	1	0	gen
9	127311255	127311598	MACS_peak_21588	596.19	343	0	1	0	gen
9	127455309	127455631	MACS_peak_21589	430.51	322	1	0	0	promoter
9	127618366	127618630	MACS_peak_21590	702.98	264	0	1	0	gen
9	127786876	127787199	MACS_peak_21591	429.98	323	1	0	0	promoter
9	127870019	127870228	MACS_peak_21592	606	209	2	0	0	promoter
9	127886953	127887099	MACS_peak_21593	972.07	146	1	1	0	promoter
9	127910795	127911031	MACS_peak_21594	516.86	236	1	0	0	promoter
9	127989875	127990203	MACS_peak_21595	282.05	328	0	0	0	intergen
9	128117661	128117997	MACS_peak_21596	1058.97	336	1	0	1	promoter
9	128130117	128130418	MACS_peak_21597	1212.36	301	0	0	1	other
9	128181444	128181855	MACS_peak_21598	470.08	411	0	1	0	gen
9	128255286	128255544	MACS_peak_21599	1005.37	258	1	0	0	promoter
9	128291972	128292129	MACS_peak_21600	428.95	157	0	0	0	intergen
9	128414533	128414906	MACS_peak_21601	762.41	373	1	0	0	promoter
9	128420097	128420415	MACS_peak_21602	758.83	318	0	1	0	gen
9	128733175	128733545	MACS_peak_21603	496.77	370	1	0	0	promoter
9	128795272	128795580	MACS_peak_21604	592.79	308	0	1	0	gen
9	128818222	128818499	MACS_peak_21605	610.43	277	2	0	0	promoter
9	128851942	128852373	MACS_peak_21606	580.49	431	0	1	0	gen
9	128927928	128928303	MACS_peak_21607	563.34	375	0	1	0	gen
9	129028498	129028825	MACS_peak_21608	889.59	327	0	0	0	intergen
9	129139130	129139476	MACS_peak_21609	783.08	346	0	1	0	gen
9	129142896	129143253	MACS_peak_21610	412.83	357	0	1	0	gen
9	129182626	129182950	MACS_peak_21611	547.99	324	0	0	1	other
9	129611089	129611307	MACS_peak_21613	580.62	218	2	0	0	promoter
9	129617253	129617606	MACS_peak_21614	530.32	353	0	2	0	gen
9	129720637	129720875	MACS_peak_21615	516.86	238	0	1	0	gen
9	129804836	129804968	MACS_peak_21616	771.26	132	1	0	0	promoter
9	129885703	129885964	MACS_peak_21617	466.72	261	1	0	0	promoter
9	129906908	129907364	MACS_peak_21618	349.84	456	0	1	0	gen
9	129907481	129907619	MACS_peak_21619	672.15	138	0	1	0	gen
9	130099734	130100016	MACS_peak_21620	142.05	282	0	1	0	gen
9	130107209	130107427	MACS_peak_21621	580.62	218	0	1	0	gen
9	130442556	130442689	MACS_peak_21622	1396.21	133	1	0	0	promoter
9	130682613	130682845	MACS_peak_21623	514.21	232	0	1	0	gen
9	130707472	130707651	MACS_peak_21624	876.89	179	0	0	0	intergen
9	130770970	130771235	MACS_peak_21625	488.85	265	0	1	0	gen
9	130866451	130866798	MACS_peak_21626	655.65	347	0	1	0	gen
9	130870033	130870370	MACS_peak_21627	845.32	337	0	1	0	gen
9	131057909	131058077	MACS_peak_21628	982.95	168	0	1	0	gen
9	131178373	131178681	MACS_peak_21629	1339.28	308	0	1	0	gen
9	131317148	131317280	MACS_peak_21630	724.36	132	0	1	0	gen
9	131336316	131336625	MACS_peak_21631	232.59	309	0	1	0	gen
9	131363809	131363954	MACS_peak_21632	814.98	145	0	0	0	intergen
9	131404105	131404238	MACS_peak_21633	1201.31	133	0	1	0	gen
9	131740110	131740340	MACS_peak_21634	827.5	230	0	0	0	intergen
9	131747523	131747908	MACS_peak_21635	145.73	385	0	0	0	intergen
9	131954379	131954621	MACS_peak_21636	1725.79	242	0	1	0	gen
9	132236412	132236709	MACS_peak_21637	565.98	297	0	1	0	gen
9	132259233	132259425	MACS_peak_21638	619.53	192	1	0	0	promoter
9	132312972	132313221	MACS_peak_21639	763.02	249	0	1	0	gen
9	132651275	132651528	MACS_peak_21640	596.79	253	0	1	0	gen
9	132653236	132653622	MACS_peak_21641	219.32	386	0	1	0	gen
9	132673456	132673661	MACS_peak_21642	608.4	205	1	0	0	promoter
9	132768949	132769090	MACS_peak_21643	1025.76	141	0	1	0	gen
9	132800249	132800499	MACS_peak_21644	613.04	250	0	1	0	gen
9	132977510	132977884	MACS_peak_21645	404.88	374	0	1	0	gen
9	133044042	133044316	MACS_peak_21646	582.68	274	0	1	0	gen
9	133144502	133144842	MACS_peak_21647	660.56	340	0	2	0	gen
9	133160863	133161233	MACS_peak_21648	406.71	370	0	2	0	gen
9	133180002	133180193	MACS_peak_21649	834.1	191	0	0	0	intergen
9	133329505	133329725	MACS_peak_21650	1365.09	220	1	0	0	promoter
9	133403909	133404181	MACS_peak_21651	849.55	272	1	1	0	promoter
9	133514022	133514380	MACS_peak_21652	57.86	358	1	0	0	promoter
9	133533125	133533344	MACS_peak_21653	901.33	219	1	0	0	promoter
9	133782185	133782402	MACS_peak_21654	580.62	217	0	1	0	gen
9	133793099	133793265	MACS_peak_21655	1043.77	166	0	1	0	gen
9	134099186	134099521	MACS_peak_21656	541.11	335	0	0	0	intergen
9	134170849	134171029	MACS_peak_21657	746.04	180	0	0	0	intergen
9	134480790	134481155	MACS_peak_21658	297.38	365	0	0	0	intergen
9	134561114	134561319	MACS_peak_21659	469.81	205	0	0	0	intergen
9	134698528	134698858	MACS_peak_21660	1065.19	330	0	1	0	gen
9	135206577	135206885	MACS_peak_21661	272.05	308	0	0	1	other
9	135412586	135412957	MACS_peak_21662	954.43	371	0	0	0	intergen
9	135500500	135500723	MACS_peak_21663	564.54	223	1	1	0	promoter
9	135504637	135504888	MACS_peak_21664	485.56	251	1	0	1	promoter
9	135602754	135603071	MACS_peak_21665	1079.07	317	1	0	0	promoter
9	135603976	135604163	MACS_peak_21666	901.33	187	1	0	0	promoter
9	135864412	135864747	MACS_peak_21667	423.72	335	0	1	0	gen
9	136226228	136226459	MACS_peak_21668	678.9	231	0	1	0	gen
9	136631517	136631736	MACS_peak_21669	901.33	219	0	0	0	intergen
9	136766437	136766763	MACS_peak_21670	428.39	326	0	0	0	intergen
9	136791813	136792079	MACS_peak_21671	603.02	266	3	0	0	promoter
9	137004103	137004542	MACS_peak_21672	803.92	439	1	0	0	promoter
9	137064156	137064386	MACS_peak_21673	675.38	230	1	0	1	promoter
9	137118514	137118891	MACS_peak_21674	640.09	377	0	0	0	intergen
9	137121449	137121768	MACS_peak_21675	834.03	319	0	0	0	intergen
9	137227578	137227801	MACS_peak_21676	712.32	223	3	0	0	promoter
9	137236522	137236787	MACS_peak_21677	1141.07	265	1	0	0	promoter
9	137262181	137262533	MACS_peak_21678	1207.14	352	0	1	0	gen
9	137295351	137295664	MACS_peak_21679	422.13	313	0	0	1	other
9	137509931	137510216	MACS_peak_21680	350.33	285	0	1	0	gen
9	137525811	137526120	MACS_peak_21681	868.72	309	0	1	0	gen
9	137534713	137535091	MACS_peak_21682	343.03	378	0	1	0	gen
9	137545536	137545902	MACS_peak_21683	1460.78	366	0	1	0	gen
9	137559138	137559490	MACS_peak_21684	1402.87	352	1	0	0	promoter
9	137672811	137673112	MACS_peak_21685	442.11	301	0	1	1	gen
9	137716110	137716583	MACS_peak_21686	1068.72	473	0	1	0	gen
9	137721091	137721417	MACS_peak_21687	127.5	326	0	1	0	gen
9	138030715	138030946	MACS_peak_21688	517.97	231	0	1	0	gen
9	138211845	138212120	MACS_peak_21690	550.01	275	0	0	0	intergen
9	138220911	138221154	MACS_peak_21691	743.8	243	0	0	1	other
9	138226951	138227272	MACS_peak_21692	266.88	321	0	0	1	other
9	60529522	60529888	MACS_peak_21719	522.88	366	0	0	0	intergen
9	60532479	60532697	MACS_peak_21720	580.62	218	0	0	0	intergen
9	60550347	60550693	MACS_peak_21723	534.45	346	0	0	0	intergen
9	60550904	60551196	MACS_peak_21724	1107.47	292	0	0	0	intergen
9	60644615	60644907	MACS_peak_21733	966.8	292	0	0	0	intergen
9	60645756	60646099	MACS_peak_21734	419.68	343	0	0	0	intergen
9	42402188	42402497	MACS_peak_21740	557.79	309	0	0	0	intergen
9	64030271	64030551	MACS_peak_21742	454.58	280	0	0	0	intergen
9	64091403	64091766	MACS_peak_21743	409.98	363	0	0	0	intergen
10	36490	36814	MACS_peak_1903	61.31	324	0	0	0	intergen
10	40731	41069	MACS_peak_1904	91.68	338	0	0	0	intergen
10	122226	122587	MACS_peak_1905	90.07	361	0	0	0	intergen
10	178212	178666	MACS_peak_1906	591.23	454	0	1	0	gen
10	230883	231132	MACS_peak_1907	471.88	249	0	1	0	gen
10	295495	295697	MACS_peak_1908	170.79	202	0	1	0	gen
10	477822	477972	MACS_peak_1909	936.57	150	0	1	0	gen
10	668100	668285	MACS_peak_1910	712.32	185	0	2	0	gen
10	810565	810800	MACS_peak_1911	662.31	235	1	0	0	promoter
10	1050853	1051121	MACS_peak_1912	488.85	268	1	0	0	promoter
10	1224179	1224543	MACS_peak_1913	89.06	364	0	1	0	gen
10	1275947	1276381	MACS_peak_1914	362.25	434	0	1	0	gen
10	1277127	1277373	MACS_peak_1915	86.3	246	0	1	0	gen
10	1298621	1298861	MACS_peak_1916	501.5	240	0	1	0	gen
10	1301232	1301476	MACS_peak_1917	290.89	244	0	1	0	gen
10	1420963	1421272	MACS_peak_1919	557.79	309	0	1	0	gen
10	1767811	1768149	MACS_peak_1920	84.64	338	0	0	0	intergen
10	2028318	2028570	MACS_peak_1922	164.73	252	0	0	0	intergen
10	2261853	2262137	MACS_peak_1923	837.6	284	0	0	0	intergen
10	2583609	2584037	MACS_peak_1924	724.67	428	0	0	0	intergen
10	2584172	2584346	MACS_peak_1925	780.06	174	0	0	0	intergen
10	2839096	2839380	MACS_peak_1926	452.13	284	0	0	0	intergen
10	3192908	3193124	MACS_peak_1927	1079.97	216	0	0	0	intergen
10	3771514	3771872	MACS_peak_1928	214.17	358	1	0	0	promoter
10	4419527	4419691	MACS_peak_1929	831.63	164	0	0	1	other
10	4585600	4585798	MACS_peak_1930	943.85	198	0	0	0	intergen
10	4767098	4767342	MACS_peak_1931	918.92	244	0	0	0	intergen
10	4849712	4849962	MACS_peak_1933	389.4	250	0	0	0	intergen
10	4864251	4864564	MACS_peak_1934	76.3	313	0	0	0	intergen
10	4896311	4896638	MACS_peak_1935	102.4	327	0	0	0	intergen
10	4902676	4903000	MACS_peak_1936	363.93	324	0	0	0	intergen
10	4906280	4906573	MACS_peak_1937	568.79	293	0	0	0	intergen
10	5086240	5086481	MACS_peak_1938	129.76	241	0	1	0	gen
10	5094584	5094954	MACS_peak_1939	640.22	370	0	1	0	gen
10	5144875	5145176	MACS_peak_1940	85.72	301	0	0	0	intergen
10	5145239	5145641	MACS_peak_1941	130.15	402	0	0	0	intergen
10	5166921	5167297	MACS_peak_1943	103.11	376	0	1	0	gen
10	5189150	5189409	MACS_peak_1944	726.32	259	0	0	0	intergen
10	5245601	5245940	MACS_peak_1945	106	339	0	0	1	other
10	5629841	5630133	MACS_peak_1948	484.4	292	0	0	0	intergen
10	6088653	6089055	MACS_peak_1949	1855.58	402	1	0	0	promoter
10	6151532	6151746	MACS_peak_1950	918.92	214	0	1	0	gen
10	6173233	6173485	MACS_peak_1951	470.06	252	0	1	0	gen
10	6279137	6279385	MACS_peak_1952	388.01	248	0	0	1	other
10	6416842	6417149	MACS_peak_1954	1377.95	307	0	0	0	intergen
10	6445676	6445975	MACS_peak_1955	582.6	299	0	1	0	gen
10	6449382	6449657	MACS_peak_1956	142.33	275	0	1	0	gen
10	6453532	6453913	MACS_peak_1957	56.38	381	0	1	0	gen
10	6667016	6667322	MACS_peak_1958	426	306	0	0	0	intergen
10	6816512	6816715	MACS_peak_1959	59.79	203	0	0	4	other
10	6861394	6861755	MACS_peak_1960	116.8	361	0	0	2	other
10	6883531	6883759	MACS_peak_1961	548.55	228	0	0	0	intergen
10	6906610	6906983	MACS_peak_1962	131.69	373	0	0	1	other
10	7059953	7060342	MACS_peak_1963	93.19	389	0	0	0	intergen
10	7110991	7111217	MACS_peak_1964	389.44	226	0	0	0	intergen
10	7139793	7140271	MACS_peak_1965	59.07	478	0	0	0	intergen
10	7260245	7260723	MACS_peak_1966	694.47	478	0	1	0	gen
10	7417142	7417386	MACS_peak_1967	487.14	244	0	0	0	intergen
10	7687270	7687571	MACS_peak_1968	509.73	301	0	0	0	intergen
10	7871898	7872284	MACS_peak_1970	511.95	386	0	1	0	gen
10	8269004	8269363	MACS_peak_1971	510.99	359	0	0	0	intergen
10	8864062	8864369	MACS_peak_1973	59.31	307	0	0	0	intergen
10	9209262	9209496	MACS_peak_1974	1985.53	234	0	0	0	intergen
10	9331514	9331925	MACS_peak_1975	989.58	411	0	0	0	intergen
10	9371429	9371817	MACS_peak_1976	93.22	388	0	0	0	intergen
10	9402052	9402322	MACS_peak_1977	616.56	270	0	0	0	intergen
10	9464979	9465177	MACS_peak_1978	470	198	0	0	0	intergen
10	9485565	9485877	MACS_peak_1979	160.8	312	0	0	0	intergen
10	9522773	9523183	MACS_peak_1980	119.23	410	0	0	0	intergen
10	9525558	9525878	MACS_peak_1981	243.49	320	0	0	0	intergen
10	9571360	9571611	MACS_peak_1982	619.89	251	0	0	0	intergen
10	9596139	9596357	MACS_peak_1983	403.16	218	0	0	0	intergen
10	9608598	9609010	MACS_peak_1984	488.85	412	0	0	0	intergen
10	9930908	9931253	MACS_peak_1985	662.91	345	0	0	0	intergen
10	9960829	9961184	MACS_peak_1986	50.92	355	0	0	0	intergen
10	10305821	10306019	MACS_peak_1987	831.63	198	0	0	0	intergen
10	10424443	10424846	MACS_peak_1988	406.81	403	0	0	1	other
10	10557932	10558230	MACS_peak_1989	84.34	298	0	0	0	intergen
10	10653963	10654367	MACS_peak_1990	81.59	404	0	0	0	intergen
10	11108678	11108896	MACS_peak_1991	594.26	218	0	1	0	gen
10	11494984	11495337	MACS_peak_1992	863.32	353	0	1	0	gen
10	11732431	11732739	MACS_peak_1993	56.38	308	0	0	0	intergen
10	11792718	11793011	MACS_peak_1994	1069.92	293	0	0	0	intergen
10	11819891	11820094	MACS_peak_1995	509.1	203	1	0	0	promoter
10	12111036	12111382	MACS_peak_1996	418.18	346	0	1	0	gen
10	12214568	12214946	MACS_peak_1997	516.25	378	0	1	0	gen
10	12286022	12286356	MACS_peak_1998	254.65	334	0	0	0	intergen
10	12401084	12401331	MACS_peak_1999	629.38	247	0	1	0	gen
10	12518491	12518871	MACS_peak_2000	69	380	0	1	0	gen
10	12570688	12570823	MACS_peak_2001	1079.97	135	0	1	0	gen
10	12672697	12672914	MACS_peak_2002	746.04	217	0	1	0	gen
10	12693825	12694294	MACS_peak_2003	1628.64	469	0	1	0	gen
10	12694442	12694734	MACS_peak_2004	447.34	292	0	1	0	gen
10	12707662	12707960	MACS_peak_2005	443.84	298	0	1	0	gen
10	12711158	12711387	MACS_peak_2006	848.95	229	0	1	0	gen
10	12969182	12969363	MACS_peak_2007	746.04	181	0	1	0	gen
10	13056592	13056779	MACS_peak_2008	901.33	187	0	1	0	gen
10	13126170	13126337	MACS_peak_2010	856.32	167	0	1	0	gen
10	13171761	13171893	MACS_peak_2011	1116.4	132	0	1	0	gen
10	13206591	13206959	MACS_peak_2012	950.42	368	0	1	0	gen
10	13217229	13217633	MACS_peak_2013	204.25	404	1	0	0	promoter
10	13371882	13372232	MACS_peak_2014	416.22	350	0	0	0	intergen
10	13440516	13440815	MACS_peak_2015	564.59	299	1	0	0	promoter
10	13485701	13485943	MACS_peak_2016	1079.97	242	0	1	0	gen
10	13536877	13537036	MACS_peak_2017	866.35	159	0	0	0	intergen
10	13586686	13586992	MACS_peak_2018	559.8	306	1	0	0	promoter
10	13613430	13613850	MACS_peak_2019	506.92	420	1	1	0	promoter
10	13660022	13660329	MACS_peak_2020	685.18	307	0	1	1	gen
10	13787833	13788053	MACS_peak_2021	729.14	220	0	1	0	gen
10	14240950	14241148	MACS_peak_2022	662.31	198	0	1	0	gen
10	14397491	14397709	MACS_peak_2023	729.14	218	0	1	0	gen
10	14536976	14537265	MACS_peak_2024	699.78	289	0	1	0	gen
10	14904175	14904350	MACS_peak_2025	341.55	175	0	1	0	gen
10	14971955	14972216	MACS_peak_2026	466.72	261	0	1	0	gen
10	14991447	14991789	MACS_peak_2027	659.14	342	0	0	0	intergen
10	15106483	15106715	MACS_peak_2028	678.9	232	1	1	0	promoter
10	15725843	15726125	MACS_peak_2030	453.35	282	0	0	0	intergen
10	15878992	15879257	MACS_peak_2031	555.87	265	0	0	0	intergen
10	15916002	15916333	MACS_peak_2032	101.89	331	0	0	0	intergen
10	16129700	16130087	MACS_peak_2033	118.14	387	0	0	0	intergen
10	16545179	16545444	MACS_peak_2034	589.61	265	0	0	0	intergen
10	16809336	16809651	MACS_peak_2035	421.03	315	0	1	0	gen
10	16843318	16843623	MACS_peak_2036	524.89	305	0	1	0	gen
10	17137230	17137484	MACS_peak_2037	596.79	254	0	0	0	intergen
10	17290231	17290570	MACS_peak_2038	421.69	339	0	0	0	intergen
10	17352002	17352173	MACS_peak_2039	797.18	171	0	1	0	gen
10	17491707	17492057	MACS_peak_2040	541.55	350	0	0	0	intergen
10	17607509	17607782	MACS_peak_2041	571.62	273	0	1	0	gen
10	17742894	17743221	MACS_peak_2042	427.87	327	0	0	0	intergen
10	18033108	18033429	MACS_peak_2044	51.17	321	0	1	0	gen
10	18033979	18034369	MACS_peak_2045	82.85	390	0	1	0	gen
10	18035202	18035608	MACS_peak_2046	100.3	406	0	1	0	gen
10	18104335	18104650	MACS_peak_2047	434.29	315	0	0	0	intergen
10	18181494	18181729	MACS_peak_2048	468.75	235	0	1	0	gen
10	18214964	18215273	MACS_peak_2049	621.17	309	0	1	1	gen
10	18216612	18216839	MACS_peak_2050	695.57	227	0	1	1	gen
10	18238914	18239228	MACS_peak_2051	554.47	314	0	1	1	gen
10	18496494	18496852	MACS_peak_2052	265.34	358	0	1	0	gen
10	18536237	18536374	MACS_peak_2053	693.63	137	0	1	1	gen
10	18630374	18630754	MACS_peak_2054	74.78	380	0	1	0	gen
10	18630768	18631100	MACS_peak_2055	156.26	332	0	1	0	gen
10	18632877	18633190	MACS_peak_2056	189.21	313	0	1	0	gen
10	18726263	18726682	MACS_peak_2057	114.33	419	0	0	0	intergen
10	18793998	18794201	MACS_peak_2058	573.39	203	0	0	0	intergen
10	18818515	18818966	MACS_peak_2059	166.7	451	0	0	0	intergen
10	19089887	19090200	MACS_peak_2060	78.93	313	0	1	0	gen
10	19090515	19090773	MACS_peak_2061	84.98	258	0	1	0	gen
10	19204331	19204649	MACS_peak_2062	339.76	318	0	1	0	gen
10	19320035	19320169	MACS_peak_2065	1098.16	134	0	1	0	gen
10	19348585	19348810	MACS_peak_2066	346.64	225	0	1	0	gen
10	19609095	19609451	MACS_peak_2067	1316.54	356	0	1	0	gen
10	19684124	19684317	MACS_peak_2068	661.2	193	0	1	0	gen
10	19788217	19788473	MACS_peak_2069	729.14	256	0	1	0	gen
10	19811570	19811883	MACS_peak_2070	422.13	313	1	0	0	promoter
10	20292388	20292785	MACS_peak_2071	137.17	397	0	0	0	intergen
10	20338029	20338401	MACS_peak_2072	57.21	372	0	0	0	intergen
10	20439824	20440300	MACS_peak_2073	181.72	476	0	0	0	intergen
10	20498295	20498585	MACS_peak_2074	133.52	290	0	0	0	intergen
10	20570400	20570829	MACS_peak_2075	82.07	429	0	0	0	intergen
10	20570896	20571228	MACS_peak_2076	56.79	332	0	0	0	intergen
10	20752607	20752919	MACS_peak_2077	63.34	312	0	0	0	intergen
10	20768926	20769158	MACS_peak_2078	289.34	232	0	0	0	intergen
10	20858374	20858684	MACS_peak_2079	557.12	310	0	1	0	gen
10	20915536	20915858	MACS_peak_2080	142.05	322	0	1	0	gen
10	20939188	20939578	MACS_peak_2081	105.74	390	0	1	0	gen
10	20941726	20941937	MACS_peak_2082	185.02	211	0	1	0	gen
10	21191745	21191987	MACS_peak_2083	628.77	242	0	0	0	intergen
10	21269980	21270337	MACS_peak_2084	1315.38	357	0	0	0	intergen
10	21321921	21322234	MACS_peak_2085	202.95	313	0	0	0	intergen
10	21433755	21433974	MACS_peak_2087	852.08	219	0	0	0	intergen
10	21675243	21675470	MACS_peak_2088	548.55	227	0	1	0	gen
10	21781569	21781828	MACS_peak_2089	158.29	259	0	1	0	gen
10	21782523	21782890	MACS_peak_2090	169.77	367	0	1	0	gen
10	21839338	21839628	MACS_peak_2091	104.63	290	0	1	0	gen
10	21907939	21908315	MACS_peak_2092	721.05	376	0	1	0	gen
10	21953498	21953980	MACS_peak_2093	950.42	482	0	1	0	gen
10	21993414	21993653	MACS_peak_2094	797.18	239	0	1	0	gen
10	22646243	22646466	MACS_peak_2097	462.45	223	0	1	0	gen
10	22857459	22857838	MACS_peak_2098	78	379	0	0	0	intergen
10	23158237	23158584	MACS_peak_2099	477.27	347	0	0	0	intergen
10	23235970	23236292	MACS_peak_2100	592.79	322	0	1	0	gen
10	23294686	23294933	MACS_peak_2101	1036.76	247	0	1	0	gen
10	23506761	23507065	MACS_peak_2102	70.34	304	0	0	0	intergen
10	23507102	23507412	MACS_peak_2103	147.32	310	0	0	0	intergen
10	23758683	23758873	MACS_peak_2104	847.66	190	0	1	0	gen
10	23773343	23773673	MACS_peak_2105	172.97	330	0	1	0	gen
10	23824593	23824762	MACS_peak_2106	902.86	169	0	1	0	gen
10	23853864	23854181	MACS_peak_2107	90.93	317	0	1	0	gen
10	23893657	23894041	MACS_peak_2108	130.39	384	0	1	0	gen
10	24064491	24064803	MACS_peak_2109	84.4	312	0	1	0	gen
10	24094572	24094881	MACS_peak_2110	180.31	309	0	1	0	gen
10	24146664	24147025	MACS_peak_2111	525.71	361	0	1	0	gen
10	24222799	24223077	MACS_peak_2112	229.83	278	0	1	0	gen
10	24463185	24463389	MACS_peak_2113	629.38	204	0	1	0	gen
10	24484977	24485109	MACS_peak_2114	1116.4	132	0	1	0	gen
10	24519111	24519296	MACS_peak_2115	675.42	185	0	1	0	gen
10	24642890	24643201	MACS_peak_2116	812.5	311	0	1	0	gen
10	25186017	25186426	MACS_peak_2118	89.02	409	0	1	0	gen
10	25200855	25200988	MACS_peak_2119	1143.04	133	0	1	0	gen
10	25244840	25244972	MACS_peak_2120	746.93	132	0	1	0	gen
10	25250207	25250448	MACS_peak_2121	71.13	241	0	1	0	gen
10	25251454	25251818	MACS_peak_2122	92.97	364	0	1	0	gen
10	25334186	25334465	MACS_peak_2123	821.16	279	0	1	0	gen
10	25471964	25472312	MACS_peak_2124	298.95	348	0	1	0	gen
10	25515377	25515759	MACS_peak_2125	80.73	382	0	1	0	gen
10	25516263	25516656	MACS_peak_2126	126.91	393	0	1	0	gen
10	25516929	25517284	MACS_peak_2127	99.62	355	0	1	0	gen
10	25539970	25540304	MACS_peak_2128	137.17	334	0	1	0	gen
10	25700824	25701184	MACS_peak_2129	646.8	360	0	0	1	other
10	25875620	25875846	MACS_peak_2130	545.36	226	0	0	0	intergen
10	26250602	26250903	MACS_peak_2131	311.78	301	0	1	0	gen
10	26557086	26557308	MACS_peak_2132	549.18	222	0	1	0	gen
10	26632485	26632863	MACS_peak_2133	124.74	378	0	0	0	intergen
10	26890929	26891224	MACS_peak_2134	609.45	295	0	0	0	intergen
10	27046903	27047164	MACS_peak_2135	661.73	261	0	1	0	gen
10	27312280	27312616	MACS_peak_2136	540.49	336	0	0	0	intergen
10	27885514	27885902	MACS_peak_2137	722.05	388	0	1	0	gen
10	28241815	28242092	MACS_peak_2138	823.14	277	0	1	0	gen
10	28250842	28251097	MACS_peak_2139	1144.35	255	0	1	0	gen
10	28381860	28382174	MACS_peak_2140	554.47	314	0	0	0	intergen
10	28394036	28394283	MACS_peak_2141	629.38	247	0	0	0	intergen
10	28475159	28475308	MACS_peak_2142	933.27	149	0	0	1	other
10	28626047	28626183	MACS_peak_2143	1061.85	136	0	0	0	intergen
10	28902060	28902294	MACS_peak_2144	532.66	234	0	0	1	other
10	29130144	29130373	MACS_peak_2145	677.53	229	0	0	0	intergen
10	29304678	29304885	MACS_peak_2146	613.04	207	0	1	0	gen
10	29377365	29377746	MACS_peak_2147	1885.45	381	0	0	0	intergen
10	29517367	29517570	MACS_peak_2148	814.37	203	0	1	0	gen
10	29544650	29544795	MACS_peak_2149	1340.42	145	0	1	0	gen
10	30298323	30298552	MACS_peak_2150	548.55	229	0	0	0	intergen
10	30392570	30392720	MACS_peak_2151	936.57	150	0	0	0	intergen
10	30406723	30407182	MACS_peak_2152	152.33	459	0	0	0	intergen
10	30534574	30534846	MACS_peak_2153	714.45	272	0	0	0	intergen
10	30581864	30582070	MACS_peak_2154	797.18	206	0	0	0	intergen
10	30618035	30618358	MACS_peak_2155	147.82	323	0	1	0	gen
10	30751905	30752145	MACS_peak_2156	797.18	240	0	0	0	intergen
10	30950328	30950744	MACS_peak_2157	66.68	416	0	1	0	gen
10	30952860	30953186	MACS_peak_2158	93.4	326	0	1	0	gen
10	31010794	31010932	MACS_peak_2159	900.62	138	0	1	0	gen
10	31065786	31066082	MACS_peak_2160	843.52	296	0	0	0	intergen
10	31107227	31107539	MACS_peak_2161	132.22	312	0	0	0	intergen
10	31110862	31111097	MACS_peak_2162	100.83	235	0	0	0	intergen
10	31407699	31408081	MACS_peak_2165	83.72	382	0	1	0	gen
10	31460413	31460618	MACS_peak_2166	469.81	205	0	1	0	gen
10	31471058	31471379	MACS_peak_2167	51.24	321	0	1	0	gen
10	31471463	31471831	MACS_peak_2168	78.27	368	0	1	0	gen
10	31491280	31491444	MACS_peak_2169	831.63	164	0	1	0	gen
10	31687083	31687308	MACS_peak_2170	1189.9	225	0	0	0	intergen
10	31714707	31715029	MACS_peak_2171	100.97	322	0	0	0	intergen
10	32086282	32086513	MACS_peak_2172	584.47	231	0	0	0	intergen
10	32189388	32189736	MACS_peak_2173	912.29	348	0	0	0	intergen
10	32190968	32191415	MACS_peak_2174	834.88	447	0	0	0	intergen
10	32210862	32211177	MACS_peak_2175	627.13	315	0	0	0	intergen
10	32399780	32400107	MACS_peak_2176	125.66	327	0	0	0	intergen
10	32485805	32486143	MACS_peak_2177	85.62	338	0	1	0	gen
10	32486620	32486868	MACS_peak_2178	290.67	248	0	1	0	gen
10	32561649	32561935	MACS_peak_2179	81.88	286	0	1	0	gen
10	32594144	32594431	MACS_peak_2180	148.3	287	0	1	0	gen
10	32743284	32743518	MACS_peak_2182	225.14	234	0	1	0	gen
10	32795652	32795889	MACS_peak_2183	516.86	237	0	1	0	gen
10	32916799	32917162	MACS_peak_2184	62	363	0	1	0	gen
10	33008823	33009096	MACS_peak_2185	713.56	273	0	0	1	other
10	33155965	33156166	MACS_peak_2186	989.9	201	0	0	0	intergen
10	33512399	33512673	MACS_peak_2188	101.74	274	0	0	0	intergen
10	34492021	34492247	MACS_peak_2189	673.42	226	0	1	0	gen
10	34666208	34666564	MACS_peak_2190	413.31	356	0	1	0	gen
10	34716290	34716725	MACS_peak_2191	534.92	435	0	1	0	gen
10	34734062	34734437	MACS_peak_2192	265.34	375	0	1	0	gen
10	34974432	34974818	MACS_peak_2193	511.95	386	0	0	1	other
10	34994686	34994926	MACS_peak_2194	797.18	240	0	0	0	intergen
10	35218550	35218706	MACS_peak_2195	901.33	156	0	0	0	intergen
10	35269387	35269854	MACS_peak_2196	349.84	467	0	1	0	gen
10	35563255	35563562	MACS_peak_2198	816.07	307	0	1	0	gen
10	35861619	35861987	MACS_peak_2199	67.67	368	0	0	0	intergen
10	36009643	36010020	MACS_peak_2200	77.6	377	0	0	0	intergen
10	36162646	36162997	MACS_peak_2201	104.15	351	0	0	0	intergen
10	36402445	36402735	MACS_peak_2202	118	290	0	0	0	intergen
10	36779214	36779554	MACS_peak_2203	538.05	340	0	0	0	intergen
10	36880829	36881193	MACS_peak_2204	380.3	364	0	0	0	intergen
10	36894542	36894865	MACS_peak_2205	219.32	323	0	0	0	intergen
10	37030500	37030860	MACS_peak_2206	343.72	360	0	0	0	intergen
10	37086534	37086780	MACS_peak_2207	153.62	246	0	0	0	intergen
10	37330818	37331144	MACS_peak_2208	1069.4	326	0	1	1	gen
10	37495506	37495721	MACS_peak_2210	1079.97	215	0	0	0	intergen
10	37694839	37695156	MACS_peak_2211	249.04	317	0	0	0	intergen
10	37897469	37897913	MACS_peak_2212	144.27	444	0	0	0	intergen
10	37901648	37902009	MACS_peak_2213	166.85	361	0	0	0	intergen
10	37976664	37977001	MACS_peak_2214	539.88	337	0	0	0	intergen
10	37998301	37998657	MACS_peak_2215	120.97	356	0	0	0	intergen
10	38263580	38263923	MACS_peak_2217	56.38	343	0	1	1	gen
10	38365945	38366237	MACS_peak_2218	697.28	292	0	0	1	other
10	38438302	38438576	MACS_peak_2219	284.14	274	0	0	1	other
10	38448228	38448399	MACS_peak_2221	643.4	171	0	0	1	other
10	38485095	38485467	MACS_peak_2222	227.74	372	0	0	0	intergen
10	38487456	38487865	MACS_peak_2224	132.22	409	0	0	0	intergen
10	38488890	38489313	MACS_peak_2225	126.24	423	0	0	0	intergen
10	38490209	38490431	MACS_peak_2226	143.94	222	0	0	0	intergen
10	38490525	38490955	MACS_peak_2227	70.99	430	0	0	0	intergen
10	38491308	38491682	MACS_peak_2228	124.08	374	0	0	0	intergen
10	38491694	38491921	MACS_peak_2229	211.34	227	0	0	0	intergen
10	38494763	38494969	MACS_peak_2231	247.5	206	0	0	0	intergen
10	38495779	38496118	MACS_peak_2232	402.12	339	0	0	0	intergen
10	38497604	38497960	MACS_peak_2233	201.85	356	0	0	0	intergen
10	38500233	38500660	MACS_peak_2234	172.39	427	0	0	0	intergen
10	38500691	38501047	MACS_peak_2235	207.62	356	0	0	0	intergen
10	38501334	38501777	MACS_peak_2236	354.85	443	0	0	0	intergen
10	38504158	38504581	MACS_peak_2237	240.61	423	0	0	0	intergen
10	38504746	38505124	MACS_peak_2238	141.52	378	0	0	0	intergen
10	38505178	38505404	MACS_peak_2239	175.51	226	0	0	0	intergen
10	38506539	38506967	MACS_peak_2240	159.56	428	0	0	0	intergen
10	38507085	38507353	MACS_peak_2241	191.3	268	0	0	0	intergen
10	38507643	38508016	MACS_peak_2242	206.14	373	0	0	0	intergen
10	38514513	38514720	MACS_peak_2243	168.85	207	0	0	0	intergen
10	38516890	38517100	MACS_peak_2244	196.86	210	0	0	0	intergen
10	38522371	38522589	MACS_peak_2247	407.63	218	0	0	0	intergen
10	38528300	38528644	MACS_peak_2250	230.98	344	0	0	0	intergen
10	38529164	38529613	MACS_peak_2251	148.8	449	0	0	0	intergen
10	38575902	38576211	MACS_peak_2252	124.86	309	0	0	0	intergen
10	38578864	38579260	MACS_peak_2253	319.91	396	0	0	0	intergen
10	38581720	38582043	MACS_peak_2255	159.26	323	0	0	0	intergen
10	38586212	38586693	MACS_peak_2256	159.67	481	0	0	0	intergen
10	38589315	38589670	MACS_peak_2258	103.08	355	0	0	0	intergen
10	38590134	38590582	MACS_peak_2259	83.02	448	0	0	0	intergen
10	38593704	38594052	MACS_peak_2260	64.79	348	0	0	0	intergen
10	38594569	38594943	MACS_peak_2261	105.65	374	0	0	0	intergen
10	38652930	38653250	MACS_peak_2262	342.18	320	0	0	1	other
10	38777563	38777905	MACS_peak_2263	1568.33	342	0	0	0	intergen
10	38782740	38783165	MACS_peak_2264	304.93	425	0	0	0	intergen
10	38787079	38787398	MACS_peak_2265	78.57	319	0	0	0	intergen
10	38787492	38787895	MACS_peak_2266	182.05	403	0	0	0	intergen
10	38788352	38788691	MACS_peak_2267	147.29	339	0	0	0	intergen
10	38789013	38789347	MACS_peak_2268	56.13	334	0	0	0	intergen
10	38794651	38794964	MACS_peak_2272	106.76	313	0	0	0	intergen
10	38801581	38801881	MACS_peak_2275	145.99	300	0	0	0	intergen
10	38803603	38803970	MACS_peak_2276	82.99	367	0	0	0	intergen
10	38805134	38805437	MACS_peak_2277	101.86	303	0	0	0	intergen
10	38814733	38815037	MACS_peak_2278	343.7	304	0	0	0	intergen
10	38819529	38819760	MACS_peak_2281	297.37	231	0	0	0	intergen
10	38821998	38822211	MACS_peak_2282	109.12	213	0	0	0	intergen
10	38825227	38825462	MACS_peak_2283	133.97	235	0	0	0	intergen
10	38831295	38831717	MACS_peak_2284	297.57	422	0	0	0	intergen
10	38833415	38833716	MACS_peak_2285	112.89	301	0	0	0	intergen
10	38834804	38835039	MACS_peak_2286	122.69	235	0	0	0	intergen
10	38838738	38839196	MACS_peak_2287	119.64	458	0	0	0	intergen
10	38843471	38843786	MACS_peak_2288	100.2	315	0	0	0	intergen
10	38855200	38855630	MACS_peak_2292	139.01	430	0	0	0	intergen
10	38855943	38856359	MACS_peak_2293	239.04	416	0	0	0	intergen
10	38859785	38860133	MACS_peak_2295	185.61	348	0	0	0	intergen
10	38860135	38860464	MACS_peak_2296	161.97	329	0	0	0	intergen
10	41863696	41863990	MACS_peak_2301	80.4	294	0	0	0	intergen
10	41832690	41832931	MACS_peak_2310	76.71	241	0	0	0	intergen
10	41821458	41821681	MACS_peak_2313	105.2	223	0	0	0	intergen
10	41798491	41798824	MACS_peak_2314	103.58	333	0	0	0	intergen
10	41797058	41797414	MACS_peak_2315	126.91	356	0	0	0	intergen
10	41794997	41795297	MACS_peak_2316	56.38	300	0	0	0	intergen
10	41776019	41776335	MACS_peak_2317	244.75	316	0	0	0	intergen
10	41752884	41753310	MACS_peak_2318	107.84	426	0	0	0	intergen
10	42127042	42127412	MACS_peak_2324	59.97	370	0	0	0	intergen
10	42151527	42151792	MACS_peak_2325	183.67	265	0	0	0	intergen
10	42159711	42160120	MACS_peak_2326	298.95	409	0	0	0	intergen
10	42160431	42160702	MACS_peak_2327	180.31	271	0	0	0	intergen
10	42167765	42168083	MACS_peak_2329	125.71	318	0	0	0	intergen
10	42171150	42171520	MACS_peak_2330	64.62	370	0	0	0	intergen
10	42178309	42178690	MACS_peak_2331	3100	381	0	0	0	intergen
10	42183766	42184163	MACS_peak_2332	1002.9	397	0	0	0	intergen
10	42269884	42270196	MACS_peak_2334	703.12	312	0	0	1	other
10	42286199	42286463	MACS_peak_2335	597.2	264	0	0	0	intergen
10	42295634	42295993	MACS_peak_2336	370.58	359	0	0	0	intergen
10	42296989	42297308	MACS_peak_2337	129.02	319	0	0	0	intergen
10	42299351	42299706	MACS_peak_2338	59.94	355	0	0	0	intergen
10	42302263	42302607	MACS_peak_2339	164.26	344	0	0	0	intergen
10	42303233	42303537	MACS_peak_2340	156.18	304	0	0	0	intergen
10	42308247	42308562	MACS_peak_2342	343.04	315	0	0	0	intergen
10	42309027	42309369	MACS_peak_2343	127.5	342	0	0	0	intergen
10	42311226	42311551	MACS_peak_2344	57.86	325	0	0	0	intergen
10	42311968	42312309	MACS_peak_2345	157.34	341	0	0	0	intergen
10	42312656	42312994	MACS_peak_2346	56.38	338	0	0	0	intergen
10	42318612	42318772	MACS_peak_2347	127	160	0	0	0	intergen
10	42319494	42319825	MACS_peak_2348	80.35	331	0	0	0	intergen
10	42354400	42354697	MACS_peak_2349	178.65	297	0	0	1	other
10	42428601	42428968	MACS_peak_2350	1028.54	367	0	0	1	other
10	42440387	42440763	MACS_peak_2351	70.75	376	0	0	1	other
10	42440783	42441135	MACS_peak_2352	93.4	352	0	0	1	other
10	42527496	42527853	MACS_peak_2353	68.55	357	0	0	1	other
10	42528320	42528588	MACS_peak_2354	114.74	268	0	0	1	other
10	42528885	42529271	MACS_peak_2355	115.17	386	0	0	1	other
10	42669006	42669294	MACS_peak_2357	147.8	288	0	0	0	intergen
10	43498011	43498306	MACS_peak_2358	178.37	295	0	0	0	intergen
10	43528425	43528878	MACS_peak_2359	102.92	453	0	0	0	intergen
10	44098924	44099215	MACS_peak_2360	603.06	291	0	0	0	intergen
10	44189894	44190278	MACS_peak_2361	180.31	384	0	0	0	intergen
10	44272020	44272471	MACS_peak_2362	106.55	451	0	0	0	intergen
10	44272616	44272982	MACS_peak_2363	71.88	366	0	0	0	intergen
10	44483828	44484084	MACS_peak_2364	172.39	256	0	0	0	intergen
10	44484516	44484872	MACS_peak_2365	102.3	356	0	0	0	intergen
10	44485700	44485947	MACS_peak_2366	82.05	247	0	0	0	intergen
10	44523085	44523447	MACS_peak_2367	150.71	362	0	0	0	intergen
10	44563636	44563997	MACS_peak_2368	439.97	361	0	0	0	intergen
10	44691648	44691964	MACS_peak_2369	158.81	316	0	0	0	intergen
10	44857745	44858032	MACS_peak_2370	450.32	287	0	0	1	other
10	44866317	44866617	MACS_peak_2371	628.25	300	0	0	1	other
10	44932652	44932959	MACS_peak_2372	559.13	307	0	1	1	gen
10	45013689	45014014	MACS_peak_2374	109.53	325	0	0	1	other
10	45175620	45175880	MACS_peak_2375	1102.85	260	0	0	2	other
10	45318538	45318912	MACS_peak_2376	284.7	374	0	0	0	intergen
10	45349911	45350287	MACS_peak_2377	130.59	376	0	0	0	intergen
10	45539985	45540228	MACS_peak_2378	100.65	243	0	1	0	gen
10	45667234	45667579	MACS_peak_2379	272.37	345	0	1	0	gen
10	47047676	47047859	MACS_peak_2380	1134.69	183	0	0	0	intergen
10	46987256	46987449	MACS_peak_2381	678.9	193	0	1	0	gen
10	46868680	46868963	MACS_peak_2382	452.74	283	0	0	0	intergen
10	46693359	46693631	MACS_peak_2383	1078.69	272	0	0	0	intergen
10	46666954	46667308	MACS_peak_2384	344.16	354	0	0	0	intergen
10	46653917	46654160	MACS_peak_2385	944.23	243	0	0	0	intergen
10	46586810	46587014	MACS_peak_2386	797.18	204	0	1	1	gen
10	46565507	46565934	MACS_peak_2387	887.67	427	0	0	0	intergen
10	46468172	46468472	MACS_peak_2388	563.9	300	0	0	1	other
10	47604486	47604687	MACS_peak_2389	588.69	201	0	0	0	intergen
10	47687543	47687753	MACS_peak_2391	1210.75	210	0	0	0	intergen
10	50156451	50156788	MACS_peak_2394	65.52	337	0	0	0	intergen
10	47460470	47460695	MACS_peak_2395	844.95	225	1	0	0	promoter
10	47340674	47340895	MACS_peak_2396	564.54	221	0	0	0	intergen
10	47006482	47006823	MACS_peak_2399	90.6	341	0	0	0	intergen
10	46963352	46963631	MACS_peak_2401	452.54	279	0	1	0	gen
10	47646754	47647026	MACS_peak_2402	1085.15	272	0	0	0	intergen
10	47674717	47675069	MACS_peak_2403	445.27	352	0	0	0	intergen
10	48064411	48064604	MACS_peak_2405	678.9	193	0	0	1	other
10	48088219	48088498	MACS_peak_2406	575.75	279	0	0	1	other
10	48346195	48346515	MACS_peak_2407	306.6	320	0	1	0	gen
10	48642873	48643274	MACS_peak_2408	266.23	401	0	1	0	gen
10	48680199	48680443	MACS_peak_2409	501.16	244	1	0	0	promoter
10	48686312	48686444	MACS_peak_2410	1116.4	132	1	0	0	promoter
10	48885416	48885719	MACS_peak_2411	440.97	303	0	1	1	gen
10	49263298	49263647	MACS_peak_2413	416.71	349	0	0	0	intergen
10	49519119	49519375	MACS_peak_2414	470.06	256	0	1	0	gen
10	49594557	49594885	MACS_peak_2415	545.46	328	0	0	0	intergen
10	49716901	49717249	MACS_peak_2416	54.59	348	0	0	0	intergen
10	49890077	49890301	MACS_peak_2417	564.54	224	0	1	0	gen
10	46089029	46089162	MACS_peak_2418	1396.21	133	0	0	0	intergen
10	50622079	50622299	MACS_peak_2419	564.54	220	0	1	0	gen
10	50789044	50789270	MACS_peak_2420	451.22	226	0	1	0	gen
10	51190165	51190425	MACS_peak_2421	593.56	260	0	1	0	gen
10	51506500	51506845	MACS_peak_2423	186.49	345	0	1	0	gen
10	51601628	51601853	MACS_peak_2424	422.81	225	0	1	0	gen
10	51942389	51942738	MACS_peak_2425	61.75	349	0	1	0	gen
10	52235692	52235948	MACS_peak_2426	71.71	256	0	1	1	gen
10	52237315	52237732	MACS_peak_2428	72.97	417	0	1	1	gen
10	52238394	52238693	MACS_peak_2429	89.18	299	0	1	1	gen
10	52327730	52328100	MACS_peak_2430	1130.06	370	0	0	0	intergen
10	52405168	52405507	MACS_peak_2431	178.37	339	0	0	0	intergen
10	52567093	52567521	MACS_peak_2432	1106.47	428	0	0	1	other
10	52732464	52732781	MACS_peak_2434	90.46	317	0	0	1	other
10	52780204	52780406	MACS_peak_2435	814.37	202	0	0	0	intergen
10	53199134	53199479	MACS_peak_2436	74.93	345	0	0	0	intergen
10	53384827	53385212	MACS_peak_2437	611.86	385	0	0	0	intergen
10	53494639	53495067	MACS_peak_2438	82.9	428	0	0	0	intergen
10	53518013	53518238	MACS_peak_2439	548.55	225	0	0	0	intergen
10	53601340	53601601	MACS_peak_2440	592.77	261	0	0	0	intergen
10	53654336	53654665	MACS_peak_2441	195.36	329	0	0	0	intergen
10	53933692	53934089	MACS_peak_2443	173.81	397	0	1	0	gen
10	54028030	54028341	MACS_peak_2444	108.85	311	0	1	0	gen
10	54178742	54179148	MACS_peak_2445	164.26	406	0	1	0	gen
10	54332176	54332605	MACS_peak_2446	1675.08	429	0	1	0	gen
10	54415571	54415751	MACS_peak_2447	746.04	180	0	1	0	gen
10	54518317	54518717	MACS_peak_2448	125.63	400	0	1	1	gen
10	54622443	54622780	MACS_peak_2449	922.25	337	0	1	1	gen
10	54874133	54874448	MACS_peak_2450	76.3	315	0	1	0	gen
10	54954293	54954492	MACS_peak_2451	831.63	199	0	1	0	gen
10	55000329	55000687	MACS_peak_2452	320.39	358	0	1	0	gen
10	55071892	55072270	MACS_peak_2453	87.81	378	0	1	0	gen
10	55091795	55091992	MACS_peak_2454	557.32	197	0	1	0	gen
10	55421033	55421320	MACS_peak_2455	380.3	287	0	1	1	gen
10	55528821	55529174	MACS_peak_2456	103.45	353	0	1	1	gen
10	55547238	55547466	MACS_peak_2457	797.05	228	0	1	1	gen
10	55589487	55589816	MACS_peak_2458	160.7	329	0	1	1	gen
10	55606037	55606440	MACS_peak_2459	97.58	403	0	1	0	gen
10	55683371	55683701	MACS_peak_2460	97.88	330	0	0	0	intergen
10	55688281	55688651	MACS_peak_2461	96.02	370	0	0	0	intergen
10	55695463	55695768	MACS_peak_2462	158.81	305	0	0	0	intergen
10	55774907	55775248	MACS_peak_2463	160.49	341	0	0	0	intergen
10	55902062	55902406	MACS_peak_2464	61.13	344	0	0	0	intergen
10	56023317	56023528	MACS_peak_2465	368.39	211	0	0	0	intergen
10	56144420	56144716	MACS_peak_2466	158.81	296	0	0	0	intergen
10	56190342	56190811	MACS_peak_2468	170.04	469	0	0	0	intergen
10	56349732	56349946	MACS_peak_2469	682.16	214	0	0	0	intergen
10	56442674	56442908	MACS_peak_2471	363.11	234	0	0	0	intergen
10	56526689	56527000	MACS_peak_2472	141.76	311	0	0	0	intergen
10	56527078	56527434	MACS_peak_2473	138.14	356	0	0	0	intergen
10	56686511	56686802	MACS_peak_2474	82.22	291	0	0	0	intergen
10	56711184	56711523	MACS_peak_2475	91.89	339	0	0	0	intergen
10	57303319	57303507	MACS_peak_2476	695.57	188	0	0	0	intergen
10	57357672	57357902	MACS_peak_2477	149.53	230	0	0	0	intergen
10	57849817	57850155	MACS_peak_2479	539.27	338	0	0	0	intergen
10	57895529	57895899	MACS_peak_2480	57.77	370	0	0	0	intergen
10	58131329	58131519	MACS_peak_2481	806.28	190	0	0	0	intergen
10	58216477	58216721	MACS_peak_2482	629.38	244	0	1	0	gen
10	58297469	58297789	MACS_peak_2483	103.45	320	0	0	0	intergen
10	58299449	58299796	MACS_peak_2484	307.54	347	0	0	0	intergen
10	58781870	58782145	MACS_peak_2486	825.15	275	0	1	0	gen
10	59173915	59174064	MACS_peak_2487	1222.2	149	1	0	0	promoter
10	59516177	59516541	MACS_peak_2488	644.14	364	0	0	0	intergen
10	59541102	59541462	MACS_peak_2489	84.06	360	0	0	0	intergen
10	59796123	59796442	MACS_peak_2490	158.81	319	0	1	0	gen
10	60099112	60099367	MACS_peak_2491	470.06	255	0	1	0	gen
10	60118005	60118295	MACS_peak_2492	1722.91	290	0	1	0	gen
10	60208783	60209034	MACS_peak_2493	613.04	251	0	1	0	gen
10	60640054	60640512	MACS_peak_2494	237.14	458	0	1	0	gen
10	60647314	60647546	MACS_peak_2495	532.66	232	0	1	0	gen
10	60816590	60816860	MACS_peak_2497	851.59	270	0	0	0	intergen
10	60964269	60964467	MACS_peak_2498	662.31	198	0	1	0	gen
10	61307854	61308056	MACS_peak_2499	628.77	202	0	0	0	intergen
10	61568842	61568993	MACS_peak_2500	936.57	151	0	0	0	intergen
10	61607412	61607668	MACS_peak_2501	596.79	256	0	0	0	intergen
10	62028959	62029171	MACS_peak_2502	596.79	212	0	1	0	gen
10	62304482	62304646	MACS_peak_2503	534.96	164	0	0	0	intergen
10	62603564	62603882	MACS_peak_2504	96.1	318	0	2	1	gen
10	62673186	62673550	MACS_peak_2505	84.4	364	0	0	0	intergen
10	62674557	62674844	MACS_peak_2506	112.45	287	0	0	0	intergen
10	62710013	62710250	MACS_peak_2507	404.91	237	0	0	1	other
10	62954925	62955229	MACS_peak_2508	119.15	304	0	0	0	intergen
10	63387525	63387730	MACS_peak_2509	321.35	205	0	1	0	gen
10	63446599	63446807	MACS_peak_2510	1108.27	208	0	1	0	gen
10	63720019	63720359	MACS_peak_2511	1054.89	340	0	0	1	other
10	63788900	63789142	MACS_peak_2512	232.76	242	0	0	1	other
10	63852828	63853111	MACS_peak_2513	128.8	283	0	0	1	other
10	63866820	63867163	MACS_peak_2514	406.46	343	0	0	1	other
10	63872384	63872584	MACS_peak_2515	814.37	200	0	0	1	other
10	63945267	63945578	MACS_peak_2516	114.74	311	0	0	1	other
10	63976628	63976855	MACS_peak_2517	548.55	227	0	0	1	other
10	64009881	64010103	MACS_peak_2518	564.54	222	0	0	0	intergen
10	64041252	64041485	MACS_peak_2519	678.9	233	0	0	0	intergen
10	64123762	64124133	MACS_peak_2520	140.25	371	0	0	0	intergen
10	64124221	64124472	MACS_peak_2521	137.65	251	0	0	0	intergen
10	64928462	64928789	MACS_peak_2524	83.88	327	0	0	0	intergen
10	64929165	64929470	MACS_peak_2525	125.63	305	0	0	0	intergen
10	65068078	65068406	MACS_peak_2526	545.46	328	0	0	0	intergen
10	65087411	65087770	MACS_peak_2527	367.74	359	0	0	0	intergen
10	65131844	65132120	MACS_peak_2528	581.17	276	0	0	1	other
10	65143638	65144013	MACS_peak_2529	517.89	375	0	0	0	intergen
10	65358705	65358999	MACS_peak_2530	446.16	294	0	0	0	intergen
10	65385923	65386189	MACS_peak_2531	103.45	266	0	0	0	intergen
10	65964583	65964879	MACS_peak_2532	445	296	0	1	0	gen
10	66197875	66198103	MACS_peak_2533	548.55	228	0	1	0	gen
10	66278110	66278349	MACS_peak_2534	1402.54	239	0	1	0	gen
10	66448060	66448363	MACS_peak_2535	123.48	303	0	1	0	gen
10	66618609	66619072	MACS_peak_2536	69.82	463	0	1	0	gen
10	66692271	66692567	MACS_peak_2537	69	296	0	1	0	gen
10	66901499	66901821	MACS_peak_2538	332.47	322	0	1	0	gen
10	66931257	66931599	MACS_peak_2539	536.84	342	0	2	0	gen
10	67145320	67145463	MACS_peak_2540	1007.8	143	0	1	0	gen
10	67563788	67564016	MACS_peak_2542	246.7	228	0	1	0	gen
10	67564470	67564769	MACS_peak_2543	185.62	299	0	1	0	gen
10	67578945	67579215	MACS_peak_2544	230.84	270	0	1	0	gen
10	67671675	67672132	MACS_peak_2546	88.6	457	0	1	0	gen
10	67726112	67726402	MACS_peak_2547	448.52	290	0	0	0	intergen
10	67726403	67726745	MACS_peak_2548	1191.46	342	0	0	0	intergen
10	67739333	67739687	MACS_peak_2549	76.3	354	0	0	0	intergen
10	67742478	67742853	MACS_peak_2550	60.82	375	0	0	0	intergen
10	67855689	67855934	MACS_peak_2552	494.55	245	0	0	0	intergen
10	67974050	67974184	MACS_peak_2553	1072.4	134	0	1	0	gen
10	68059603	68059966	MACS_peak_2554	899.21	363	0	1	0	gen
10	68061779	68062020	MACS_peak_2555	430.9	241	0	1	0	gen
10	69289356	69289500	MACS_peak_2556	649.84	144	0	1	0	gen
10	69310419	69310552	MACS_peak_2557	1396.21	133	0	1	0	gen
10	69629980	69630340	MACS_peak_2558	772.16	360	1	0	0	promoter
10	69696031	69696390	MACS_peak_2559	751.7	359	0	0	0	intergen
10	69958192	69958553	MACS_peak_2560	1034.22	361	0	1	0	gen
10	70220704	70221079	MACS_peak_2561	404.42	375	0	1	0	gen
10	70387721	70388078	MACS_peak_2562	528	357	0	0	0	intergen
10	70759042	70759419	MACS_peak_2563	516.8	377	0	1	0	gen
10	71023324	71023679	MACS_peak_2564	413.79	355	0	0	1	other
10	71532617	71532838	MACS_peak_2565	1043.77	221	0	1	0	gen
10	71853960	71854111	MACS_peak_2566	936.57	151	0	0	0	intergen
10	72696076	72696292	MACS_peak_2567	328.76	216	1	0	0	promoter
10	72875224	72875542	MACS_peak_2568	676.68	318	0	1	0	gen
10	73149979	73150342	MACS_peak_2569	146.63	363	0	1	0	gen
10	73307281	73307559	MACS_peak_2570	709.17	278	0	1	0	gen
10	73328510	73328874	MACS_peak_2571	61.7	364	0	1	0	gen
10	74103650	74103854	MACS_peak_2572	616.96	204	0	1	0	gen
10	74458016	74458322	MACS_peak_2573	623.5	306	0	1	0	gen
10	74570949	74571203	MACS_peak_2574	58.33	254	0	1	0	gen
10	75120279	75120645	MACS_peak_2576	158.81	366	0	1	0	gen
10	75187536	75187680	MACS_peak_2577	910.25	144	0	0	0	intergen
10	75187995	75188263	MACS_peak_2578	462.14	268	0	0	0	intergen
10	75230610	75230857	MACS_peak_2579	471.88	247	1	1	0	promoter
10	75235930	75236242	MACS_peak_2580	555.79	312	1	0	0	promoter
10	76145832	76146279	MACS_peak_2582	181.04	447	0	1	0	gen
10	76147207	76147584	MACS_peak_2583	103.45	377	0	1	0	gen
10	76589307	76589683	MACS_peak_2584	68.24	376	0	0	0	intergen
10	76591208	76591607	MACS_peak_2586	140.02	399	0	0	0	intergen
10	76616570	76616961	MACS_peak_2587	372.88	391	0	0	0	intergen
10	77004927	77005252	MACS_peak_2590	428.92	325	0	1	0	gen
10	77534293	77534530	MACS_peak_2591	814.37	237	0	1	0	gen
10	77569045	77569453	MACS_peak_2592	81.72	408	0	1	0	gen
10	77756472	77756863	MACS_peak_2594	749.46	391	0	0	0	intergen
10	77793528	77793670	MACS_peak_2595	1549.78	142	1	0	0	promoter
10	77995270	77995711	MACS_peak_2596	91.01	441	0	1	0	gen
10	78047225	78047658	MACS_peak_2597	602.54	433	0	1	0	gen
10	78090613	78091082	MACS_peak_2598	118.52	469	0	0	0	intergen
10	78093496	78093848	MACS_peak_2601	100.11	352	0	0	0	intergen
10	78094006	78094233	MACS_peak_2602	189.95	227	0	0	0	intergen
10	78117942	78118179	MACS_peak_2603	516.86	237	0	0	0	intergen
10	78676774	78677171	MACS_peak_2604	103.17	397	0	0	0	intergen
10	78679714	78680077	MACS_peak_2605	62	363	0	0	0	intergen
10	79055288	79055471	MACS_peak_2606	666.39	183	0	0	1	other
10	79467329	79467715	MACS_peak_2607	722.05	386	0	0	0	intergen
10	79477245	79477395	MACS_peak_2608	1189.9	150	0	0	0	intergen
10	79509403	79509851	MACS_peak_2609	1356.72	448	1	0	1	promoter
10	79621735	79622070	MACS_peak_2610	200.83	335	0	0	0	intergen
10	79647467	79647613	MACS_peak_2612	972.07	146	0	0	0	intergen
10	79960941	79961307	MACS_peak_2613	123.22	366	0	1	0	gen
10	80222763	80223122	MACS_peak_2614	280.24	359	0	0	0	intergen
10	80250478	80250927	MACS_peak_2615	1493.46	449	0	0	1	other
10	80479418	80479685	MACS_peak_2616	78.76	267	0	1	0	gen
10	80530305	80530596	MACS_peak_2617	698.11	291	0	1	1	gen
10	80596708	80596978	MACS_peak_2618	716.24	270	0	1	0	gen
10	80662673	80663017	MACS_peak_2619	419.18	344	0	0	0	intergen
10	80725221	80725574	MACS_peak_2620	62.73	353	0	0	0	intergen
10	80829609	80829915	MACS_peak_2621	330.98	306	0	0	0	intergen
10	80832208	80832570	MACS_peak_2622	57.89	362	0	0	0	intergen
10	80855437	80855664	MACS_peak_2623	548.55	227	0	0	0	intergen
10	80884062	80884479	MACS_peak_2624	159.41	417	0	0	0	intergen
10	81004766	81005136	MACS_peak_2625	56.38	370	0	0	0	intergen
10	81019372	81019803	MACS_peak_2626	722.76	431	0	0	0	intergen
10	81140925	81141160	MACS_peak_2627	662.31	235	0	0	0	intergen
10	81219098	81219347	MACS_peak_2628	763.02	249	0	0	0	intergen
10	81251378	81251590	MACS_peak_2629	936.57	212	0	0	0	intergen
10	81441181	81441446	MACS_peak_2630	199.2	265	0	0	0	intergen
10	81560614	81561060	MACS_peak_2631	264.6	446	0	0	0	intergen
10	81772083	81772464	MACS_peak_2633	61.47	381	0	0	0	intergen
10	82045217	82045555	MACS_peak_2634	240.61	338	0	1	0	gen
10	82344637	82345018	MACS_peak_2635	119.28	381	0	1	0	gen
10	82345470	82345764	MACS_peak_2636	81.01	294	0	1	0	gen
10	82348224	82348500	MACS_peak_2637	96.04	276	0	1	0	gen
10	82348954	82349402	MACS_peak_2638	79.9	448	0	1	0	gen
10	82478189	82478637	MACS_peak_2639	217.12	448	0	1	0	gen
10	83310785	83311159	MACS_peak_2640	404.88	374	0	0	0	intergen
10	83373854	83374088	MACS_peak_2641	532.66	234	0	0	0	intergen
10	83439700	83440039	MACS_peak_2642	158.81	339	0	0	0	intergen
10	83782988	83783393	MACS_peak_2644	93.58	405	0	0	0	intergen
10	83899302	83899673	MACS_peak_2646	80.49	371	0	0	0	intergen
10	84071192	84071507	MACS_peak_2647	97.28	315	0	0	0	intergen
10	84282820	84283302	MACS_peak_2648	54.32	482	0	0	1	other
10	84284025	84284273	MACS_peak_2649	86.3	248	0	0	1	other
10	84441640	84441853	MACS_peak_2650	438.69	213	0	1	0	gen
10	84457135	84457469	MACS_peak_2651	1460.78	334	0	1	0	gen
10	84610826	84611126	MACS_peak_2652	488.85	300	0	0	0	intergen
10	84758269	84758623	MACS_peak_2653	83.04	354	0	0	0	intergen
10	84858555	84858889	MACS_peak_2656	99.72	334	0	0	0	intergen
10	84858948	84859275	MACS_peak_2657	137.17	327	0	0	0	intergen
10	85075466	85075787	MACS_peak_2658	70.9	321	0	0	0	intergen
10	85360929	85361226	MACS_peak_2659	98.84	297	0	0	0	intergen
10	85517581	85517944	MACS_peak_2660	89.02	363	0	0	0	intergen
10	85745046	85745464	MACS_peak_2661	265.75	418	0	1	0	gen
10	85771769	85772178	MACS_peak_2662	98.91	409	0	1	0	gen
10	85792219	85792516	MACS_peak_2663	565.98	297	0	1	0	gen
10	85995754	85996074	MACS_peak_2664	550.56	320	0	1	0	gen
10	86398182	86398542	MACS_peak_2665	178.37	360	0	0	0	intergen
10	86960470	86960735	MACS_peak_2666	464.09	265	1	1	0	promoter
10	87081641	87081904	MACS_peak_2667	243.49	263	0	1	0	gen
10	87149180	87149376	MACS_peak_2668	1193.18	196	0	1	0	gen
10	87280774	87281064	MACS_peak_2669	517.37	290	0	0	1	other
10	87301567	87301966	MACS_peak_2670	631.16	399	0	0	1	other
10	87436000	87436399	MACS_peak_2671	421.15	399	0	0	0	intergen
10	87456909	87457199	MACS_peak_2672	517.37	290	0	0	0	intergen
10	87533683	87534073	MACS_peak_2673	569.72	390	0	1	0	gen
10	87735160	87735524	MACS_peak_2674	409.51	364	0	1	0	gen
10	87967122	87967375	MACS_peak_2675	470.06	253	0	1	0	gen
10	88114219	88114677	MACS_peak_2676	827.39	458	0	0	0	intergen
10	88351805	88352282	MACS_peak_2677	251.35	477	0	1	0	gen
10	88448389	88448742	MACS_peak_2678	184.74	353	0	1	0	gen
10	88654032	88654308	MACS_peak_2680	229.83	276	0	0	0	intergen
10	88987046	88987336	MACS_peak_2681	448.52	290	1	1	0	promoter
10	89217808	89218181	MACS_peak_2682	1158.54	373	1	0	0	promoter
10	89260428	89260657	MACS_peak_2683	548.55	229	0	1	0	gen
10	89320368	89320661	MACS_peak_2684	97.29	293	0	1	0	gen
10	89320840	89321269	MACS_peak_2685	208.52	429	0	1	0	gen
10	89764581	89764855	MACS_peak_2686	210.33	274	0	1	0	gen
10	89788274	89788685	MACS_peak_2687	615.01	411	0	0	0	intergen
10	89793756	89794073	MACS_peak_2688	433.2	317	0	0	0	intergen
10	90085237	90085584	MACS_peak_2689	115.17	347	0	0	0	intergen
10	90115443	90115746	MACS_peak_2690	90.3	303	0	0	0	intergen
10	90254416	90254718	MACS_peak_2691	120.03	302	0	0	0	intergen
10	90851327	90851630	MACS_peak_2692	312.33	303	0	1	0	gen
10	90880140	90880379	MACS_peak_2693	645.81	239	0	1	0	gen
10	90922698	90922942	MACS_peak_2694	398.3	244	0	0	0	intergen
10	91006283	91006527	MACS_peak_2695	629.38	244	0	0	0	intergen
10	91251543	91251867	MACS_peak_2696	672.17	324	0	1	0	gen
10	91320985	91321293	MACS_peak_2697	130.65	308	0	0	0	intergen
10	91326388	91326773	MACS_peak_2699	63.13	385	0	0	0	intergen
10	91338758	91338971	MACS_peak_2700	914.78	213	0	0	0	intergen
10	91370095	91370522	MACS_peak_2701	473.28	427	0	0	0	intergen
10	91508159	91508639	MACS_peak_2703	90.54	480	0	1	0	gen
10	91614986	91615235	MACS_peak_2704	485.56	249	0	0	0	intergen
10	91635470	91635735	MACS_peak_2705	589.61	265	0	0	0	intergen
10	91643692	91644025	MACS_peak_2706	380.47	333	0	0	0	intergen
10	92060682	92060967	MACS_peak_2707	451.52	285	0	1	0	gen
10	92140577	92140960	MACS_peak_2708	109.04	383	0	1	0	gen
10	92303370	92303635	MACS_peak_2709	406.81	265	0	1	0	gen
10	92524230	92524608	MACS_peak_2710	2991.26	378	0	1	0	gen
10	92894942	92895124	MACS_peak_2711	522.04	182	0	1	0	gen
10	92983805	92984050	MACS_peak_2712	1061.85	245	0	1	0	gen
10	93271615	93271771	MACS_peak_2713	901.33	156	0	0	0	intergen
10	93292250	93292578	MACS_peak_2714	282.05	328	0	0	0	intergen
10	93376404	93376708	MACS_peak_2715	488.85	304	0	1	0	gen
10	93511361	93511629	MACS_peak_2716	462.14	268	0	1	0	gen
10	93523629	93523898	MACS_peak_2717	80.03	269	0	1	0	gen
10	93526538	93526818	MACS_peak_2718	127.5	280	0	1	0	gen
10	93542081	93542357	MACS_peak_2719	310.36	276	0	0	0	intergen
10	93821479	93821683	MACS_peak_2720	629.38	204	0	0	0	intergen
10	93854408	93854547	MACS_peak_2721	1884.9	139	0	0	0	intergen
10	93916606	93916917	MACS_peak_2722	682.05	311	0	1	0	gen
10	94162339	94162665	MACS_peak_2723	84.24	326	0	1	0	gen
10	94163496	94163748	MACS_peak_2724	124.29	252	0	1	0	gen
10	94320348	94320542	MACS_peak_2725	631.23	194	0	1	0	gen
10	94444405	94444631	MACS_peak_2726	640.7	226	0	1	0	gen
10	94570303	94570635	MACS_peak_2727	542.96	332	0	1	0	gen
10	94600817	94601017	MACS_peak_2728	996.34	200	0	1	1	gen
10	94827824	94828190	MACS_peak_2729	125.63	366	0	2	0	gen
10	94955401	94955737	MACS_peak_2730	192.17	336	0	1	0	gen
10	94956628	94956966	MACS_peak_2731	125.62	338	0	1	0	gen
10	95015971	95016269	MACS_peak_2732	86.92	298	0	0	0	intergen
10	95080754	95081132	MACS_peak_2733	93.4	378	0	0	0	intergen
10	95081970	95082346	MACS_peak_2734	50.01	376	0	0	0	intergen
10	95084710	95085052	MACS_peak_2735	125.63	342	0	0	0	intergen
10	95865308	95865543	MACS_peak_2736	516.86	235	1	1	2	promoter
10	95948180	95948556	MACS_peak_2737	93.4	376	0	1	1	gen
10	96182249	96182587	MACS_peak_2738	208.22	338	0	1	0	gen
10	96370561	96370886	MACS_peak_2739	428.92	325	0	1	0	gen
10	96511277	96511493	MACS_peak_2740	746.04	216	0	1	0	gen
10	96734906	96735253	MACS_peak_2741	158.81	347	0	0	0	intergen
10	96830539	96830968	MACS_peak_2743	722.05	429	1	0	0	promoter
10	97148616	97148781	MACS_peak_2744	831.63	165	1	1	0	promoter
10	97234399	97234821	MACS_peak_2745	603.02	422	0	2	0	gen
10	97277126	97277456	MACS_peak_2746	88.51	330	0	2	1	gen
10	97407184	97407438	MACS_peak_2747	470.06	254	0	1	1	gen
10	97676655	97676988	MACS_peak_2748	1344.22	333	1	0	0	promoter
10	97701457	97701642	MACS_peak_2749	841.91	185	0	0	0	intergen
10	97731835	97732126	MACS_peak_2750	447.93	291	0	0	0	intergen
10	98228944	98229277	MACS_peak_2751	76.3	333	0	1	0	gen
10	98230175	98230491	MACS_peak_2752	63.99	316	0	1	0	gen
10	98545207	98545570	MACS_peak_2753	76.3	363	0	1	0	gen
10	98700310	98700685	MACS_peak_2754	130.39	375	0	1	0	gen
10	98701031	98701381	MACS_peak_2755	116.55	350	0	1	0	gen
10	98748184	98748532	MACS_peak_2756	417.2	348	0	1	0	gen
10	98783409	98783760	MACS_peak_2757	117.77	351	0	1	0	gen
10	98927970	98928317	MACS_peak_2760	115.17	347	0	1	0	gen
10	98941905	98942287	MACS_peak_2761	52.41	382	0	1	0	gen
10	98986372	98986707	MACS_peak_2762	86.69	335	0	1	0	gen
10	99029822	99030242	MACS_peak_2763	534.92	420	0	1	0	gen
10	99246829	99247101	MACS_peak_2765	584.2	272	0	0	0	intergen
10	99392348	99392825	MACS_peak_2766	972.07	477	1	1	0	promoter
10	99417059	99417453	MACS_peak_2767	75.01	394	0	1	0	gen
10	99506764	99506957	MACS_peak_2768	866.35	193	0	0	0	intergen
10	99845913	99846091	MACS_peak_2771	763.02	178	0	1	0	gen
10	99892567	99892837	MACS_peak_2772	127.5	270	0	1	0	gen
10	100240862	100241024	MACS_peak_2773	1079.97	162	0	1	0	gen
10	100338516	100338896	MACS_peak_2774	608.29	380	0	0	1	other
10	100518824	100519027	MACS_peak_2775	989.9	203	1	2	0	promoter
10	100675061	100675322	MACS_peak_2776	142.05	261	0	0	0	intergen
10	100797930	100798126	MACS_peak_2777	848.95	196	0	1	0	gen
10	100994358	100994537	MACS_peak_2778	746.04	179	1	0	0	promoter
10	101012867	101013271	MACS_peak_2779	1232.32	404	0	1	0	gen
10	101034344	101034638	MACS_peak_2780	380.3	294	1	0	0	promoter
10	101041233	101041619	MACS_peak_2781	880.18	386	0	0	0	intergen
10	101067797	101068158	MACS_peak_2782	509.85	361	0	0	0	intergen
10	101272363	101272625	MACS_peak_2783	466.05	262	0	0	0	intergen
10	101297836	101298134	MACS_peak_2784	565.28	298	0	0	0	intergen
10	101366735	101367066	MACS_peak_2785	667.02	331	0	1	0	gen
10	102009938	102010164	MACS_peak_2786	1189.9	226	0	1	0	gen
10	102229677	102230104	MACS_peak_2787	491.28	427	2	0	0	promoter
10	102399527	102399809	MACS_peak_2788	839.55	282	1	1	0	promoter
10	102479041	102479299	MACS_peak_2789	468.72	258	0	1	0	gen
10	102596500	102596858	MACS_peak_2790	648.14	358	0	1	0	gen
10	102916884	102917097	MACS_peak_2792	451.43	213	1	0	0	promoter
10	103174693	103174919	MACS_peak_2793	1530.43	226	0	1	0	gen
10	103368822	103369002	MACS_peak_2794	936.57	180	1	0	0	promoter
10	103461864	103462157	MACS_peak_2795	201.59	293	0	0	1	other
10	103542829	103543065	MACS_peak_2796	662.31	236	0	1	0	gen
10	104017126	104017388	MACS_peak_2797	466.05	262	0	1	0	gen
10	104274719	104274999	MACS_peak_2798	454.58	280	0	1	0	gen
10	104696397	104696649	MACS_peak_2799	746.04	252	0	1	0	gen
10	104859674	104860013	MACS_peak_2800	161.46	339	0	1	0	gen
10	104972766	104972939	MACS_peak_2801	390.55	173	0	1	0	gen
10	105379309	105379572	MACS_peak_2804	61.78	263	0	0	0	intergen
10	105669589	105669970	MACS_peak_2805	514.63	381	0	0	0	intergen
10	105740569	105740866	MACS_peak_2807	236.69	297	0	0	0	intergen
10	105740989	105741336	MACS_peak_2808	136.97	347	0	0	0	intergen
10	105811184	105811475	MACS_peak_2811	201.59	291	0	0	1	other
10	105851299	105851609	MACS_peak_2812	87.52	310	0	0	0	intergen
10	105856313	105856581	MACS_peak_2813	429.31	268	0	0	0	intergen
10	106401187	106401480	MACS_peak_2814	446.75	293	0	0	0	intergen
10	106845220	106845601	MACS_peak_2815	54.75	381	0	1	0	gen
10	107233743	107233992	MACS_peak_2818	144.78	249	0	0	0	intergen
10	107285513	107285734	MACS_peak_2819	79.34	221	0	0	0	intergen
10	107326775	107327110	MACS_peak_2820	158.81	335	0	0	0	intergen
10	107466286	107466641	MACS_peak_2821	112.56	355	0	0	0	intergen
10	108268940	108269261	MACS_peak_2824	655.81	321	0	0	0	intergen
10	108461325	108461460	MACS_peak_2825	925.76	135	0	0	0	intergen
10	108548329	108548635	MACS_peak_2826	1091.28	306	0	0	1	other
10	108794521	108794874	MACS_peak_2828	69	353	0	0	1	other
10	108858230	108858609	MACS_peak_2829	152.87	379	0	0	0	intergen
10	109226167	109226547	MACS_peak_2830	74.78	380	0	0	0	intergen
10	109241591	109241915	MACS_peak_2831	187.08	324	0	0	0	intergen
10	109242694	109243034	MACS_peak_2832	155.96	340	0	0	0	intergen
10	109607602	109607930	MACS_peak_2833	62.03	328	0	0	0	intergen
10	109631671	109632008	MACS_peak_2834	93.4	337	0	0	0	intergen
10	109812288	109812420	MACS_peak_2835	426.73	132	0	0	0	intergen
10	109817736	109817976	MACS_peak_2837	108.52	240	0	0	0	intergen
10	109829011	109829394	MACS_peak_2838	87.75	383	0	0	0	intergen
10	109830474	109830862	MACS_peak_2839	87.24	388	0	0	0	intergen
10	109884321	109884572	MACS_peak_2840	746.04	251	0	1	0	gen
10	110514369	110514605	MACS_peak_2841	235.88	236	0	0	0	intergen
10	110856324	110856749	MACS_peak_2842	137.17	425	0	0	0	intergen
10	111007879	111008163	MACS_peak_2843	575.25	284	0	1	0	gen
10	111045774	111046146	MACS_peak_2844	93.03	372	0	0	0	intergen
10	111048316	111048620	MACS_peak_2845	64.17	304	0	0	0	intergen
10	111076114	111076313	MACS_peak_2846	831.63	199	1	0	0	promoter
10	111178229	111178587	MACS_peak_2847	320.39	358	0	0	0	intergen
10	111430675	111430973	MACS_peak_2848	380.3	298	0	0	0	intergen
10	111588970	111589373	MACS_peak_2849	242.84	403	0	0	0	intergen
10	111640185	111640511	MACS_peak_2850	62.38	326	0	0	0	intergen
10	111642198	111642609	MACS_peak_2851	88.38	411	0	0	0	intergen
10	111792645	111792970	MACS_peak_2852	99.8	325	0	0	0	intergen
10	111793628	111793991	MACS_peak_2853	152.68	363	0	0	0	intergen
10	111816458	111816828	MACS_peak_2854	90.41	370	0	0	0	intergen
10	111818128	111818495	MACS_peak_2855	102.28	367	0	0	0	intergen
10	111863422	111863665	MACS_peak_2856	674.85	243	0	0	0	intergen
10	112253430	112253745	MACS_peak_2857	114.44	315	0	0	0	intergen
10	113942482	113942869	MACS_peak_2858	488.85	387	0	0	0	intergen
10	114030597	114030742	MACS_peak_2859	1227.12	145	0	0	0	intergen
10	114083815	114084154	MACS_peak_2860	1236.43	339	0	0	0	intergen
10	114138029	114138192	MACS_peak_2861	1867.1	163	0	1	0	gen
10	114471387	114471693	MACS_peak_2862	559.8	306	0	1	0	gen
10	115583094	115583450	MACS_peak_2865	110.15	356	0	1	0	gen
10	115584981	115585346	MACS_peak_2866	63.13	365	0	1	0	gen
10	116154310	116154554	MACS_peak_2867	501.16	244	0	1	0	gen
10	116396365	116396748	MACS_peak_2868	137.17	383	0	0	0	intergen
10	116444522	116444864	MACS_peak_2869	536.84	342	0	1	0	gen
10	116521378	116521803	MACS_peak_2870	850.44	425	0	0	0	intergen
10	116962944	116963280	MACS_peak_2872	411.25	336	0	1	0	gen
10	117081912	117082160	MACS_peak_2873	79.26	248	0	1	0	gen
10	117089603	117089912	MACS_peak_2875	437.6	309	0	1	0	gen
10	117138075	117138219	MACS_peak_2876	989.9	144	0	1	0	gen
10	117357679	117357899	MACS_peak_2877	360.97	220	0	1	0	gen
10	117684734	117685085	MACS_peak_2878	415.73	351	0	0	0	intergen
10	118067262	118067549	MACS_peak_2880	62.8	287	0	0	1	other
10	118423820	118424145	MACS_peak_2881	428.92	325	0	0	0	intergen
10	118434000	118434368	MACS_peak_2882	180.31	368	0	0	0	intergen
10	118505924	118506176	MACS_peak_2883	470.06	252	0	0	0	intergen
10	118721107	118721385	MACS_peak_2884	455.81	278	0	1	0	gen
10	118913215	118913552	MACS_peak_2885	539.88	337	0	0	0	intergen
10	119183334	119183498	MACS_peak_2886	685.59	164	0	0	0	intergen
10	119206782	119207098	MACS_peak_2887	433.75	316	1	0	0	promoter
10	119209487	119209718	MACS_peak_2888	532.66	231	1	0	1	promoter
10	119819209	119819347	MACS_peak_2890	1406.54	138	0	1	0	gen
10	119846468	119846707	MACS_peak_2891	588.69	239	0	1	0	gen
10	120441241	120441519	MACS_peak_2892	143.68	278	0	0	0	intergen
10	120913781	120914201	MACS_peak_2894	82.18	420	0	0	0	intergen
10	120914413	120914787	MACS_peak_2895	104.91	374	0	0	0	intergen
10	120920192	120920534	MACS_peak_2896	59.66	342	0	0	0	intergen
10	121734597	121734831	MACS_peak_2897	532.66	234	0	0	0	intergen
10	122142855	122143067	MACS_peak_2898	763.02	212	0	1	0	gen
10	122612166	122612365	MACS_peak_2899	286.1	199	0	1	0	gen
10	122703826	122704168	MACS_peak_2900	659.14	342	0	0	0	intergen
10	122807323	122807683	MACS_peak_2901	147.82	360	0	0	1	other
10	122870523	122870891	MACS_peak_2903	60.54	368	0	1	0	gen
10	123532707	123532965	MACS_peak_2905	595.17	258	0	0	0	intergen
10	124389260	124389577	MACS_peak_2906	677.44	317	0	0	0	intergen
10	124471325	124471714	MACS_peak_2907	510.37	389	0	1	0	gen
10	124532108	124532439	MACS_peak_2908	543.58	331	0	1	0	gen
10	124745470	124745894	MACS_peak_2909	727.24	424	1	1	0	promoter
10	125048033	125048324	MACS_peak_2910	447.93	291	0	1	0	gen
10	125522225	125522544	MACS_peak_2911	548.03	319	0	0	0	intergen
10	125614280	125614615	MACS_peak_2912	139.67	335	0	1	0	gen
10	125700753	125700950	MACS_peak_2914	662.31	197	0	0	2	other
10	125947153	125947526	MACS_peak_2915	59.12	373	0	1	0	gen
10	126344013	126344284	MACS_peak_2916	202.56	271	0	1	0	gen
10	126489917	126490147	MACS_peak_2918	678.9	230	0	1	0	gen
10	126681363	126681678	MACS_peak_2920	118.28	315	0	0	0	intergen
10	126863812	126864155	MACS_peak_2921	93.07	343	0	0	0	intergen
10	126884620	126884990	MACS_peak_2923	54.51	370	0	0	0	intergen
10	126886622	126886992	MACS_peak_2924	103.45	370	0	0	0	intergen
10	126887078	126887368	MACS_peak_2925	274.79	290	0	0	0	intergen
10	127243571	127243798	MACS_peak_2926	424.5	227	0	1	0	gen
10	127252269	127252594	MACS_peak_2927	71.83	325	0	1	0	gen
10	127489059	127489335	MACS_peak_2928	862.33	276	0	0	0	intergen
10	127662047	127662484	MACS_peak_2929	238.7	437	0	0	0	intergen
10	127679648	127679956	MACS_peak_2930	438.15	308	0	0	0	intergen
10	127715814	127716058	MACS_peak_2931	780.06	244	0	0	0	intergen
10	127810176	127810527	MACS_peak_2932	242.25	351	0	0	0	intergen
10	128072555	128072691	MACS_peak_2933	912.05	136	0	1	0	gen
10	128571820	128572150	MACS_peak_2934	426.3	330	0	0	0	intergen
10	128586736	128587098	MACS_peak_2935	141.28	362	0	0	0	intergen
10	129011081	129011560	MACS_peak_2936	155.6	479	0	0	0	intergen
10	129296160	129296448	MACS_peak_2937	449.72	288	0	0	0	intergen
10	129577176	129577474	MACS_peak_2939	72.59	298	0	1	0	gen
10	129658808	129659036	MACS_peak_2940	548.55	228	0	1	0	gen
10	129734226	129734527	MACS_peak_2941	61.4	301	0	1	0	gen
10	130109789	130110034	MACS_peak_2942	629.38	245	0	1	0	gen
10	130316362	130316802	MACS_peak_2943	59.26	440	0	0	1	other
10	130980329	130980732	MACS_peak_2944	619.72	403	0	0	0	intergen
10	130980748	130981224	MACS_peak_2945	815.52	476	0	0	0	intergen
10	131454219	131454407	MACS_peak_2947	695.57	188	0	0	0	intergen
10	131537862	131538106	MACS_peak_2948	398.3	244	0	0	0	intergen
10	131704770	131705022	MACS_peak_2949	105.86	252	0	0	0	intergen
10	132052336	132052586	MACS_peak_2950	613.04	250	0	0	0	intergen
10	132080395	132080528	MACS_peak_2951	1087.62	133	0	0	0	intergen
10	132904212	132904538	MACS_peak_2952	670.69	326	0	1	0	gen
10	133143794	133144158	MACS_peak_2953	409.51	364	0	0	0	intergen
10	133240779	133241133	MACS_peak_2954	312.33	354	1	0	0	promoter
10	133304725	133304994	MACS_peak_2955	852.62	269	2	1	0	promoter
10	133330386	133330622	MACS_peak_2956	303.43	236	0	2	0	gen
10	133497456	133497669	MACS_peak_2957	451.43	213	0	1	0	gen
10	133647136	133647610	MACS_peak_2958	524.9	474	0	0	0	intergen
11	68087	68350	MACS_peak_2959	238.44	263	0	0	0	intergen
11	85440	85836	MACS_peak_2961	839.74	396	0	0	0	intergen
11	110945	111283	MACS_peak_2962	131.65	338	0	0	0	intergen
11	130593	130984	MACS_peak_2963	431.45	391	0	0	2	other
11	135290	135527	MACS_peak_2964	950.21	237	0	0	2	other
11	189731	190106	MACS_peak_2966	352.17	375	1	1	0	promoter
11	191875	192263	MACS_peak_2967	628.81	388	2	1	0	promoter
11	362016	362287	MACS_peak_2968	272.05	271	0	0	0	intergen
11	509403	509703	MACS_peak_2969	380.3	300	0	0	0	intergen
11	585244	585533	MACS_peak_2970	76.3	289	0	1	0	gen
11	1643847	1644229	MACS_peak_2971	331.44	382	0	0	0	intergen
11	1953661	1953866	MACS_peak_2972	797.18	205	0	1	0	gen
11	2286522	2286694	MACS_peak_2973	625.78	172	0	0	0	intergen
11	3417100	3417304	MACS_peak_2974	1171.45	204	0	0	1	other
11	3454867	3455254	MACS_peak_2975	629.43	387	0	0	1	other
11	3476343	3476743	MACS_peak_2976	721.05	400	0	0	2	other
11	3494645	3495068	MACS_peak_2977	126.08	423	0	0	3	other
11	3564346	3564755	MACS_peak_2978	1994.09	409	0	0	1	other
11	3581203	3581450	MACS_peak_2979	471.88	247	0	0	0	intergen
11	3609743	3610062	MACS_peak_2980	432.12	319	0	0	0	intergen
11	3899480	3899850	MACS_peak_2981	78.78	370	0	1	0	gen
11	4001919	4002238	MACS_peak_2982	132.43	319	0	1	0	gen
11	4171209	4171529	MACS_peak_2983	76.05	320	0	0	0	intergen
11	4172324	4172739	MACS_peak_2984	60.92	415	0	0	0	intergen
11	4173995	4174368	MACS_peak_2985	86.8	373	0	0	0	intergen
11	4299431	4299799	MACS_peak_2986	87.74	368	0	0	0	intergen
11	4301503	4301771	MACS_peak_2987	102.81	268	0	0	0	intergen
11	4620725	4621179	MACS_peak_2988	139.16	454	0	0	0	intergen
11	4781549	4781685	MACS_peak_2989	907.45	136	0	1	0	gen
11	4934561	4934969	MACS_peak_2990	81.72	408	0	1	0	gen
11	5009524	5009670	MACS_peak_2991	3100	146	0	0	0	intergen
11	5357959	5358305	MACS_peak_2992	103.3	346	0	4	0	gen
11	5360594	5360962	MACS_peak_2993	62.38	368	0	4	0	gen
11	5397228	5397660	MACS_peak_2994	249.04	432	0	4	0	gen
11	5414394	5414683	MACS_peak_2995	103.45	289	0	4	0	gen
11	5479357	5479706	MACS_peak_2996	59.61	349	0	4	0	gen
11	5712645	5712953	MACS_peak_2998	357.34	308	0	2	0	gen
11	5716421	5716712	MACS_peak_2999	192.56	291	0	2	0	gen
11	5844100	5844337	MACS_peak_3000	516.86	237	1	1	0	promoter
11	5920521	5920822	MACS_peak_3001	109.63	301	0	1	0	gen
11	6119785	6120070	MACS_peak_3002	158.35	285	0	0	1	other
11	6188788	6188980	MACS_peak_3003	163.16	192	0	0	0	intergen
11	6189665	6189998	MACS_peak_3004	148.05	333	0	0	0	intergen
11	6282117	6282285	MACS_peak_3005	1626.92	168	0	0	0	intergen
11	6353376	6353725	MACS_peak_3006	532.67	349	0	0	0	intergen
11	6531347	6531655	MACS_peak_3007	438.15	308	0	1	0	gen
11	6763206	6763351	MACS_peak_3008	452.67	145	1	0	0	promoter
11	6951331	6951579	MACS_peak_3009	100.52	248	0	1	0	gen
11	6983165	6983606	MACS_peak_3011	105.65	441	0	1	0	gen
11	7327118	7327481	MACS_peak_3012	120.06	363	0	1	0	gen
11	7571689	7572042	MACS_peak_3013	414.75	353	0	1	1	gen
11	7660203	7660533	MACS_peak_3014	111.17	330	1	0	0	promoter
11	7719760	7720199	MACS_peak_3015	103.47	439	0	0	1	other
11	7737153	7737500	MACS_peak_3016	95.38	347	0	0	1	other
11	7739598	7739943	MACS_peak_3017	80.32	345	0	0	1	other
11	8201099	8201434	MACS_peak_3018	331.06	335	0	0	0	intergen
11	8219180	8219565	MACS_peak_3019	753.71	385	0	0	0	intergen
11	8399739	8400105	MACS_peak_3020	55.75	366	0	1	0	gen
11	8447208	8447586	MACS_peak_3021	62.32	378	0	1	0	gen
11	8448376	8448790	MACS_peak_3022	121.3	414	0	1	0	gen
11	8536868	8537011	MACS_peak_3023	1959.39	143	0	1	0	gen
11	8566758	8567013	MACS_peak_3024	470.06	255	0	1	0	gen
11	9165970	9166177	MACS_peak_3025	613.04	207	0	1	0	gen
11	9506832	9507101	MACS_peak_3026	526.09	269	0	1	0	gen
11	9540530	9540896	MACS_peak_3027	116.31	366	0	0	0	intergen
11	9541074	9541494	MACS_peak_3028	98.56	420	0	0	0	intergen
11	9542740	9543177	MACS_peak_3029	52.48	437	0	0	0	intergen
11	9671071	9671547	MACS_peak_3030	439.97	476	0	1	0	gen
11	10226734	10227106	MACS_peak_3031	76.3	372	0	1	0	gen
11	10307863	10308089	MACS_peak_3032	1189.9	226	2	0	0	promoter
11	10406135	10406575	MACS_peak_3033	485.15	440	0	1	0	gen
11	10614733	10615087	MACS_peak_3034	110.89	354	0	1	0	gen
11	11715098	11715313	MACS_peak_3035	267.62	215	0	0	0	intergen
11	12288572	12288846	MACS_peak_3036	582.68	274	0	1	0	gen
11	12337101	12337540	MACS_peak_3037	61.03	439	0	1	0	gen
11	12719856	12720098	MACS_peak_3038	2598.34	242	0	1	0	gen
11	12776651	12776800	MACS_peak_3039	1208.41	149	0	1	0	gen
11	12964089	12964292	MACS_peak_3040	989.9	203	0	0	1	other
11	13152783	13153113	MACS_peak_3041	426.3	330	0	0	0	intergen
11	13239013	13239444	MACS_peak_3042	722.76	431	0	0	0	intergen
11	13396057	13396492	MACS_peak_3043	66.99	435	0	1	0	gen
11	13487131	13487446	MACS_peak_3044	343.45	315	1	0	0	promoter
11	13508882	13509297	MACS_peak_3045	147.82	415	0	0	0	intergen
11	13514160	13514456	MACS_peak_3046	349.84	296	0	0	0	intergen
11	13556054	13556433	MACS_peak_3047	170.04	379	0	0	0	intergen
11	13795221	13795520	MACS_peak_3049	67.99	299	0	0	1	other
11	13827774	13828245	MACS_peak_3050	387.43	471	0	0	2	other
11	13873104	13873481	MACS_peak_3051	403.51	377	0	0	1	other
11	13971036	13971260	MACS_peak_3053	866.35	224	0	1	0	gen
11	14041183	14041404	MACS_peak_3054	883.81	221	0	1	0	gen
11	14113466	14113796	MACS_peak_3055	484.79	330	0	1	0	gen
11	14400859	14401024	MACS_peak_3057	847.14	165	0	0	0	intergen
11	14455112	14455345	MACS_peak_3058	678.9	233	0	1	0	gen
11	14572408	14572730	MACS_peak_3059	136.91	322	0	1	0	gen
11	14597573	14598025	MACS_peak_3060	178.43	452	0	1	0	gen
11	14628974	14629438	MACS_peak_3061	53.31	464	0	1	0	gen
11	14664163	14664517	MACS_peak_3063	135.99	354	0	1	0	gen
11	14665051	14665425	MACS_peak_3064	150.41	374	0	1	0	gen
11	14666632	14667016	MACS_peak_3065	104.5	384	0	1	0	gen
11	14716477	14716795	MACS_peak_3066	50.5	318	0	1	0	gen
11	14757817	14758188	MACS_peak_3068	130.39	371	0	1	0	gen
11	14770074	14770262	MACS_peak_3069	695.57	188	0	1	0	gen
11	14789875	14790291	MACS_peak_3070	593.66	416	0	1	0	gen
11	14811236	14811494	MACS_peak_3071	78.59	258	0	1	0	gen
11	15074887	15075228	MACS_peak_3073	918.59	341	0	1	0	gen
11	15270677	15271122	MACS_peak_3074	54.97	445	0	0	0	intergen
11	15529975	15530186	MACS_peak_3075	95.46	211	0	0	0	intergen
11	15754182	15754386	MACS_peak_3076	797.18	204	0	0	1	other
11	16146153	16146428	MACS_peak_3077	164.87	275	0	1	0	gen
11	16273672	16274003	MACS_peak_3078	543.58	331	0	1	0	gen
11	16500381	16500737	MACS_peak_3079	95.16	356	0	1	0	gen
11	16501045	16501512	MACS_peak_3080	74.49	467	0	1	0	gen
11	16515256	16515569	MACS_peak_3081	127.15	313	0	1	0	gen
11	16526232	16526520	MACS_peak_3082	193.31	288	0	1	0	gen
11	16540263	16540556	MACS_peak_3083	171.27	293	0	1	0	gen
11	16565499	16565762	MACS_peak_3084	247.51	263	0	1	0	gen
11	16820370	16820709	MACS_peak_3085	538.66	339	0	1	0	gen
11	16946018	16946351	MACS_peak_3086	424.75	333	0	1	0	gen
11	17030571	17030815	MACS_peak_3087	129.76	244	0	0	1	other
11	17342326	17342659	MACS_peak_3088	64.79	333	0	1	0	gen
11	17354538	17354673	MACS_peak_3089	1079.97	135	1	0	0	promoter
11	17864469	17864819	MACS_peak_3090	532.08	350	0	1	0	gen
11	17963361	17963496	MACS_peak_3091	498.22	135	0	1	0	gen
11	17978762	17979026	MACS_peak_3092	464.74	264	0	1	0	gen
11	17979845	17980078	MACS_peak_3093	678.9	233	0	1	0	gen
11	17991772	17992102	MACS_peak_3094	488.85	330	0	1	0	gen
11	18053823	18054304	MACS_peak_3095	665.94	481	0	0	0	intergen
11	18120153	18120317	MACS_peak_3096	481.81	164	1	0	0	promoter
11	18171313	18171652	MACS_peak_3097	421.69	339	1	0	1	promoter
11	18486433	18486811	MACS_peak_3098	153.24	378	0	1	0	gen
11	18732073	18732262	MACS_peak_3099	695.57	189	1	0	1	promoter
11	18764377	18764567	MACS_peak_3100	568.54	190	0	1	0	gen
11	18916989	18917318	MACS_peak_3101	105.65	329	0	0	0	intergen
11	19137900	19138228	MACS_peak_3102	218.64	328	0	1	0	gen
11	19140001	19140448	MACS_peak_3103	122.09	447	0	1	0	gen
11	19259724	19260063	MACS_peak_3104	788.72	339	0	0	1	other
11	19836209	19836521	MACS_peak_3105	229.83	312	0	1	0	gen
11	19951494	19951827	MACS_peak_3106	542.34	333	0	1	0	gen
11	19953935	19954290	MACS_peak_3107	529.16	355	0	1	0	gen
11	20110925	20111256	MACS_peak_3108	425.78	331	0	1	0	gen
11	20576321	20576629	MACS_peak_3109	85.6	308	0	0	0	intergen
11	20577922	20578175	MACS_peak_3110	101.95	253	0	0	0	intergen
11	20689778	20690099	MACS_peak_3111	104.77	321	0	1	0	gen
11	20691210	20691564	MACS_peak_3112	95.86	354	0	1	0	gen
11	20705454	20705726	MACS_peak_3113	224.66	272	0	1	0	gen
11	20981863	20982096	MACS_peak_3114	532.66	233	0	1	0	gen
11	21219204	21219495	MACS_peak_3115	830.86	291	0	1	0	gen
11	21838980	21839187	MACS_peak_3116	414.19	207	0	1	0	gen
11	21997740	21998106	MACS_peak_3117	79.12	366	0	1	0	gen
11	21998358	21998823	MACS_peak_3118	69.28	465	0	1	0	gen
11	22000535	22000900	MACS_peak_3119	68.83	365	0	1	0	gen
11	22142903	22143226	MACS_peak_3121	429.98	323	0	1	0	gen
11	22288135	22288494	MACS_peak_3122	159.56	359	0	0	1	other
11	22523175	22523481	MACS_peak_3123	142.59	306	0	0	0	intergen
11	22525123	22525505	MACS_peak_3124	73.44	382	0	0	0	intergen
11	22697653	22698004	MACS_peak_3126	159.51	351	0	1	0	gen
11	22883333	22883693	MACS_peak_3127	726.91	360	0	0	1	other
11	22979782	22980050	MACS_peak_3128	853.65	268	0	0	0	intergen
11	23009293	23009765	MACS_peak_3129	127.15	472	0	0	0	intergen
11	23009905	23010113	MACS_peak_3130	276.43	208	0	0	0	intergen
11	23177194	23177537	MACS_peak_3132	101.53	343	0	0	1	other
11	23260849	23261251	MACS_peak_3133	94.62	402	0	0	0	intergen
11	23298154	23298582	MACS_peak_3134	93.78	428	0	0	0	intergen
11	23298664	23299065	MACS_peak_3135	52.71	401	0	0	0	intergen
11	23300020	23300349	MACS_peak_3136	52.22	329	0	0	0	intergen
11	23316653	23316994	MACS_peak_3137	62.07	341	0	0	0	intergen
11	23334109	23334465	MACS_peak_3138	649.49	356	0	0	0	intergen
11	23432321	23432623	MACS_peak_3139	167.22	302	0	0	0	intergen
11	23433239	23433594	MACS_peak_3140	69	355	0	0	0	intergen
11	23540099	23540349	MACS_peak_3141	485.56	250	0	0	0	intergen
11	23791279	23791652	MACS_peak_3142	126.54	373	0	0	2	other
11	24137129	24137550	MACS_peak_3143	1780.15	421	0	0	0	intergen
11	24152561	24152698	MACS_peak_3144	847.14	137	0	0	0	intergen
11	24402262	24402600	MACS_peak_3145	422.19	338	0	0	0	intergen
11	24487812	24488183	MACS_peak_3146	151.71	371	0	0	0	intergen
11	24658503	24658932	MACS_peak_3147	155.74	429	0	1	0	gen
11	24918038	24918232	MACS_peak_3149	177.59	194	0	1	0	gen
11	24918801	24919124	MACS_peak_3150	257.53	323	0	1	0	gen
11	25277981	25278373	MACS_peak_3151	172.39	392	0	0	0	intergen
11	25520155	25520374	MACS_peak_3153	443.84	219	0	0	0	intergen
11	25635890	25636324	MACS_peak_3154	87.6	434	0	0	0	intergen
11	25646933	25647370	MACS_peak_3155	151.18	437	0	0	0	intergen
11	25734669	25734953	MACS_peak_3156	1117.09	284	0	0	0	intergen
11	25747255	25747606	MACS_peak_3157	127.5	351	0	0	1	other
11	25836465	25836791	MACS_peak_3158	117.68	326	0	0	0	intergen
11	25971056	25971413	MACS_peak_3159	648.81	357	0	0	0	intergen
11	26057638	26057985	MACS_peak_3161	533.85	347	0	0	0	intergen
11	26116389	26116657	MACS_peak_3162	100.03	268	0	0	0	intergen
11	26118769	26119031	MACS_peak_3163	164.26	262	0	0	0	intergen
11	26297236	26297453	MACS_peak_3164	1245.57	217	0	0	0	intergen
11	26408125	26408523	MACS_peak_3165	156.32	398	0	1	0	gen
11	26454234	26454635	MACS_peak_3166	74.69	401	0	1	0	gen
11	26529036	26529364	MACS_peak_3167	439.97	328	0	1	0	gen
11	26965841	26966218	MACS_peak_3168	67.54	377	0	0	0	intergen
11	26970514	26970851	MACS_peak_3169	140	337	0	0	0	intergen
11	27158875	27159110	MACS_peak_3170	521.49	235	0	0	1	other
11	27176289	27176598	MACS_peak_3171	113.26	309	0	0	1	other
11	27220931	27221239	MACS_peak_3172	50.42	308	0	0	0	intergen
11	27268838	27269157	MACS_peak_3173	158.81	319	0	0	0	intergen
11	27485942	27486210	MACS_peak_3174	1587.43	268	0	0	0	intergen
11	27767905	27768210	MACS_peak_3175	265.34	305	0	0	1	other
11	27918474	27918616	MACS_peak_3176	1549.78	142	0	0	0	intergen
11	27943988	27944430	MACS_peak_3177	107.03	442	0	0	0	intergen
11	28029415	28029635	MACS_peak_3178	127.99	220	0	1	0	gen
11	28360990	28361373	MACS_peak_3179	218.92	383	0	1	0	gen
11	28776467	28776703	MACS_peak_3181	905.7	236	0	0	1	other
11	28978296	28978705	MACS_peak_3182	96.69	409	0	0	1	other
11	29145795	29145928	MACS_peak_3183	1396.21	133	0	0	0	intergen
11	29265281	29265530	MACS_peak_3184	485.56	249	0	0	1	other
11	29343784	29344054	MACS_peak_3185	716.24	270	0	0	1	other
11	29385795	29386163	MACS_peak_3186	56.19	368	0	0	1	other
11	29417446	29417732	MACS_peak_3187	138.76	286	0	0	1	other
11	29448647	29448879	MACS_peak_3189	532.66	232	0	0	2	other
11	29649290	29649651	MACS_peak_3190	56.38	361	0	0	0	intergen
11	29743829	29744200	MACS_peak_3191	115.17	371	0	0	1	other
11	29766197	29766530	MACS_peak_3192	145.71	333	0	0	1	other
11	29796562	29796884	MACS_peak_3193	137.17	322	0	0	1	other
11	29797707	29798060	MACS_peak_3194	181.92	353	0	0	1	other
11	29968284	29968644	MACS_peak_3195	201.59	360	0	0	0	intergen
11	30010179	30010391	MACS_peak_3196	596.79	212	1	0	0	promoter
11	30051491	30051786	MACS_peak_3197	164.92	295	0	0	1	other
11	30055909	30056221	MACS_peak_3199	56.38	312	0	0	1	other
11	30264962	30265338	MACS_peak_3200	105.65	376	0	0	0	intergen
11	30314678	30314909	MACS_peak_3201	532.66	231	0	0	0	intergen
11	30346194	30346402	MACS_peak_3202	1305.85	208	0	0	0	intergen
11	31160609	31160931	MACS_peak_3203	549.27	322	0	1	0	gen
11	31316781	31317055	MACS_peak_3204	54.36	274	0	1	0	gen
11	31356523	31356788	MACS_peak_3206	159.56	265	0	1	0	gen
11	31546099	31546393	MACS_peak_3208	170.9	294	0	1	0	gen
11	31546621	31546980	MACS_peak_3209	52.67	359	0	1	0	gen
11	31696407	31696678	MACS_peak_3210	142.94	271	0	1	1	gen
11	32232013	32232217	MACS_peak_3211	629.38	204	0	0	1	other
11	32265176	32265518	MACS_peak_3212	56.38	342	0	0	1	other
11	32323554	32323797	MACS_peak_3213	402.63	243	0	0	1	other
11	32606978	32607202	MACS_peak_3214	303.32	224	1	0	0	promoter
11	32749623	32749893	MACS_peak_3215	845.63	270	0	1	0	gen
11	32792968	32793332	MACS_peak_3216	520.85	364	0	1	0	gen
11	32884845	32885117	MACS_peak_3217	459.58	272	0	0	0	intergen
11	32943341	32943702	MACS_peak_3218	57.34	361	0	1	0	gen
11	33065697	33065951	MACS_peak_3219	666.39	254	0	1	0	gen
11	33157011	33157366	MACS_peak_3220	265.34	355	0	1	0	gen
11	33166220	33166507	MACS_peak_3221	488.85	287	0	0	1	other
11	33988084	33988363	MACS_peak_3222	438.47	279	0	0	0	intergen
11	34687557	34687866	MACS_peak_3223	120.84	309	0	0	0	intergen
11	34760610	34760871	MACS_peak_3225	73.3	261	0	0	0	intergen
11	34776261	34776493	MACS_peak_3226	483.43	232	0	0	0	intergen
11	34926165	34926357	MACS_peak_3227	833.66	192	0	1	0	gen
11	34951776	34952087	MACS_peak_3228	87.14	311	0	1	0	gen
11	34952537	34952822	MACS_peak_3229	84.69	285	0	1	0	gen
11	35238108	35238438	MACS_peak_3230	426.3	330	0	0	0	intergen
11	35698259	35698638	MACS_peak_3231	125.37	379	0	1	0	gen
11	35705472	35705823	MACS_peak_3232	130.39	351	0	1	0	gen
11	35742396	35742821	MACS_peak_3233	1519.94	425	0	1	0	gen
11	36266095	36266404	MACS_peak_3234	437.6	309	1	0	0	promoter
11	36350867	36351108	MACS_peak_3235	690.17	241	0	1	0	gen
11	36557160	36557515	MACS_peak_3237	115.71	355	0	1	0	gen
11	36652050	36652412	MACS_peak_3238	104.03	362	0	1	0	gen
11	36747164	36747502	MACS_peak_3239	1195.93	338	0	0	0	intergen
11	36893863	36894233	MACS_peak_3240	56.38	370	0	0	0	intergen
11	36939748	36939897	MACS_peak_3241	1437.45	149	0	0	0	intergen
11	37018154	37018365	MACS_peak_3242	292.77	211	0	0	0	intergen
11	37020934	37021294	MACS_peak_3243	50.92	360	0	0	0	intergen
11	37348462	37348765	MACS_peak_3244	385.83	303	0	0	0	intergen
11	37492609	37492961	MACS_peak_3245	127.5	352	0	0	0	intergen
11	38191150	38191305	MACS_peak_3247	541.16	155	0	0	0	intergen
11	38319231	38319511	MACS_peak_3248	972.38	280	0	0	0	intergen
11	38520428	38520710	MACS_peak_3249	121.76	282	0	0	0	intergen
11	38880058	38880282	MACS_peak_3250	564.54	224	0	0	0	intergen
11	38943112	38943404	MACS_peak_3251	59.19	292	0	0	0	intergen
11	38943571	38943980	MACS_peak_3252	144.43	409	0	0	0	intergen
11	38976017	38976278	MACS_peak_3253	603.02	261	0	0	0	intergen
11	39032514	39032870	MACS_peak_3254	91.78	356	0	0	1	other
11	39033494	39033949	MACS_peak_3255	165.06	455	0	0	1	other
11	39047756	39048133	MACS_peak_3256	78.62	377	0	0	1	other
11	39329550	39329906	MACS_peak_3257	98.68	356	0	0	0	intergen
11	39390067	39390417	MACS_peak_3258	227.5	350	0	0	0	intergen
11	39393421	39393760	MACS_peak_3259	56.38	339	0	0	0	intergen
11	39758907	39759224	MACS_peak_3260	63.65	317	0	0	0	intergen
11	39769234	39769472	MACS_peak_3261	516.86	238	0	0	0	intergen
11	39884788	39885044	MACS_peak_3262	174.85	256	0	0	0	intergen
11	39890846	39891225	MACS_peak_3263	176.39	379	0	0	0	intergen
11	40586421	40586719	MACS_peak_3264	93.4	298	0	1	0	gen
11	40587381	40587608	MACS_peak_3265	101.29	227	0	1	0	gen
11	40757592	40757745	MACS_peak_3266	918.92	153	0	1	0	gen
11	40944910	40945067	MACS_peak_3267	1396.66	157	0	1	0	gen
11	40948841	40949226	MACS_peak_3268	115.17	385	0	1	0	gen
11	41461021	41461421	MACS_peak_3269	504.65	400	0	0	0	intergen
11	41561623	41561964	MACS_peak_3270	420.68	341	0	0	1	other
11	41669982	41670287	MACS_peak_3271	817.88	305	0	0	1	other
11	41756924	41757348	MACS_peak_3272	109.53	424	0	0	1	other
11	41887285	41887624	MACS_peak_3273	219.32	339	0	0	0	intergen
11	41968416	41968665	MACS_peak_3274	448.74	249	0	0	0	intergen
11	42156790	42157196	MACS_peak_3275	70.6	406	0	0	1	other
11	42456771	42457229	MACS_peak_3276	93.78	458	0	0	0	intergen
11	42801121	42801430	MACS_peak_3278	602.01	309	0	0	0	intergen
11	42821314	42821697	MACS_peak_3279	387.67	383	0	0	0	intergen
11	43021587	43021825	MACS_peak_3280	516.86	238	0	0	0	intergen
11	43282948	43283225	MACS_peak_3281	1125.73	277	0	0	0	intergen
11	43503536	43503747	MACS_peak_3283	591.86	211	0	0	0	intergen
11	43653992	43654359	MACS_peak_3284	78.8	367	0	0	2	other
11	43714515	43714913	MACS_peak_3285	135.55	398	0	1	1	gen
11	43776683	43776932	MACS_peak_3286	111.42	249	0	1	1	gen
11	44392365	44392721	MACS_peak_3287	127.94	356	0	0	0	intergen
11	44550608	44550953	MACS_peak_3288	914.97	345	0	0	0	intergen
11	46006466	46006872	MACS_peak_3289	1126.43	406	0	1	0	gen
11	46122745	46122889	MACS_peak_3290	1805.04	144	0	0	0	intergen
11	46127116	46127424	MACS_peak_3291	438.15	308	0	0	1	other
11	46193284	46193418	MACS_peak_3292	1445.82	134	0	0	0	intergen
11	46235693	46235874	MACS_peak_3293	746.04	181	0	0	0	intergen
11	46239171	46239437	MACS_peak_3294	463.44	266	0	0	0	intergen
11	46247627	46247806	MACS_peak_3295	746.04	179	0	0	0	intergen
11	46507476	46507608	MACS_peak_3296	857.98	132	0	1	0	gen
11	46537755	46538137	MACS_peak_3297	401.26	382	0	1	0	gen
11	46573888	46574245	MACS_peak_3298	105.65	357	0	1	1	gen
11	46838689	46838825	MACS_peak_3299	1056.36	136	0	1	0	gen
11	46889525	46889909	MACS_peak_3300	631.3	384	0	1	0	gen
11	46919784	46920266	MACS_peak_3301	448.43	482	0	0	0	intergen
11	47259588	47259932	MACS_peak_3302	657.74	344	0	1	0	gen
11	47355278	47355448	MACS_peak_3303	797.18	170	1	0	0	promoter
11	47454260	47454504	MACS_peak_3304	1725.79	244	0	0	0	intergen
11	47558519	47558880	MACS_peak_3305	525.71	361	0	1	0	gen
11	47721993	47722149	MACS_peak_3306	784.03	156	0	1	0	gen
11	47853381	47853733	MACS_peak_3307	446.42	352	0	0	0	intergen
11	47934450	47934724	MACS_peak_3308	1275.79	274	0	0	0	intergen
11	48172920	48173241	MACS_peak_3310	690.23	321	0	0	0	intergen
11	48185985	48186324	MACS_peak_3311	93.4	339	0	0	0	intergen
11	48195647	48195949	MACS_peak_3312	1192.27	302	0	0	0	intergen
11	48295709	48295916	MACS_peak_3313	148.87	207	0	0	0	intergen
11	48302214	48302547	MACS_peak_3314	89.02	333	1	0	0	promoter
11	48450819	48451143	MACS_peak_3315	182.6	324	0	0	0	intergen
11	48580801	48581112	MACS_peak_3316	203.93	311	0	0	0	intergen
11	48641455	48641739	MACS_peak_3317	363.01	284	0	0	0	intergen
11	48657312	48657583	MACS_peak_3318	488.02	271	0	0	0	intergen
11	48700057	48700397	MACS_peak_3319	248.82	340	0	0	0	intergen
11	48701822	48702202	MACS_peak_3320	93.4	380	0	0	0	intergen
11	48753804	48754081	MACS_peak_3321	556.58	277	0	0	0	intergen
11	48788637	48788854	MACS_peak_3322	80.46	217	0	0	0	intergen
11	48793689	48793966	MACS_peak_3323	95.88	277	0	0	0	intergen
11	48812282	48812610	MACS_peak_3325	56.71	328	0	0	0	intergen
11	48822913	48823315	MACS_peak_3326	227.76	402	0	0	0	intergen
11	48833178	48833628	MACS_peak_3328	119.64	450	0	0	0	intergen
11	48837085	48837427	MACS_peak_3329	57.47	342	0	0	0	intergen
11	48844962	48845381	MACS_peak_3330	75.42	419	0	0	0	intergen
11	48853982	48854323	MACS_peak_3332	52.21	341	0	0	0	intergen
11	48860936	48861239	MACS_peak_3334	83.28	303	0	0	0	intergen
11	48864102	48864542	MACS_peak_3335	143.43	440	0	0	0	intergen
11	48871758	48871976	MACS_peak_3336	177.56	218	0	0	0	intergen
11	48874493	48874766	MACS_peak_3337	118	273	0	0	0	intergen
11	48876208	48876596	MACS_peak_3338	51.13	388	0	0	0	intergen
11	48878922	48879231	MACS_peak_3339	99.7	309	0	0	0	intergen
11	48910586	48910807	MACS_peak_3340	158.76	221	0	0	0	intergen
11	48911378	48911720	MACS_peak_3341	206.62	342	0	0	0	intergen
11	48914705	48915041	MACS_peak_3342	107.87	336	0	0	0	intergen
11	48920600	48920855	MACS_peak_3343	105.03	255	0	0	0	intergen
11	48927412	48927823	MACS_peak_3345	103.87	411	0	0	0	intergen
11	48931354	48931635	MACS_peak_3346	91.31	281	0	0	0	intergen
11	48939092	48939334	MACS_peak_3347	106.45	242	0	0	0	intergen
11	48942189	48942432	MACS_peak_3348	73.19	243	0	0	0	intergen
11	49401591	49401942	MACS_peak_3349	420.07	351	0	0	0	intergen
11	49491248	49491588	MACS_peak_3350	421.18	340	0	0	0	intergen
11	49536886	49537152	MACS_peak_3351	701.16	266	0	0	0	intergen
11	49545591	49545787	MACS_peak_3352	518.97	196	0	0	0	intergen
11	49727239	49727593	MACS_peak_3353	56.07	354	0	0	1	other
11	49776126	49776515	MACS_peak_3354	122.09	389	0	0	1	other
11	49779095	49779472	MACS_peak_3355	106.66	377	0	0	1	other
11	49824538	49824744	MACS_peak_3356	612.68	206	0	0	1	other
11	49868324	49868652	MACS_peak_3357	129.7	328	0	0	0	intergen
11	49870234	49870542	MACS_peak_3358	97	308	0	0	0	intergen
11	50717057	50717282	MACS_peak_3361	110.3	225	0	0	0	intergen
11	50730766	50731143	MACS_peak_3362	88.29	377	0	0	0	intergen
11	50740307	50740517	MACS_peak_3363	269.2	210	0	0	0	intergen
11	50741166	50741444	MACS_peak_3364	52.99	278	0	0	0	intergen
11	50746048	50746407	MACS_peak_3365	112.36	359	0	0	0	intergen
11	50752882	50753345	MACS_peak_3366	143.39	463	0	0	0	intergen
11	50767677	50768032	MACS_peak_3367	62.5	355	0	0	0	intergen
11	50771226	50771496	MACS_peak_3368	99.09	270	0	0	0	intergen
11	50787621	50788085	MACS_peak_3369	94.4	464	0	0	0	intergen
11	50797005	50797386	MACS_peak_3370	100.89	381	0	0	0	intergen
11	50799737	50800087	MACS_peak_3371	104.36	350	0	0	0	intergen
11	50803491	50803797	MACS_peak_3372	54.69	306	0	0	0	intergen
11	50817712	50818058	MACS_peak_3373	169.92	346	0	0	0	intergen
11	54986415	54986635	MACS_peak_3374	227.1	220	0	0	0	intergen
11	54950212	54950533	MACS_peak_3375	215.11	321	0	0	0	intergen
11	54947404	54947608	MACS_peak_3377	294.27	204	0	0	0	intergen
11	54855013	54855337	MACS_peak_3378	406.81	324	0	0	0	intergen
11	54787614	54787950	MACS_peak_3381	135.66	336	0	0	0	intergen
11	54744112	54744452	MACS_peak_3382	172.39	340	0	0	0	intergen
11	54553944	54554371	MACS_peak_3383	118.25	427	0	0	0	intergen
11	54550219	54550447	MACS_peak_3384	61.18	228	0	0	0	intergen
11	54543415	54543840	MACS_peak_3386	85.65	425	0	0	0	intergen
11	54540237	54540684	MACS_peak_3388	134.71	447	0	0	0	intergen
11	55110166	55110455	MACS_peak_3394	167.92	289	0	0	0	intergen
11	55225781	55226248	MACS_peak_3395	236.68	467	0	0	0	intergen
11	55227893	55228296	MACS_peak_3396	273.26	403	0	0	0	intergen
11	55229836	55230080	MACS_peak_3397	178.61	244	0	0	0	intergen
11	55233522	55233893	MACS_peak_3398	245.93	371	0	0	0	intergen
11	55234724	55235079	MACS_peak_3399	131.78	355	0	0	0	intergen
11	55241624	55242082	MACS_peak_3401	609.73	458	0	0	0	intergen
11	55252410	55252675	MACS_peak_3404	76.31	265	0	0	0	intergen
11	55254069	55254401	MACS_peak_3405	127.2	332	0	0	0	intergen
11	55273024	55273408	MACS_peak_3407	428.85	384	0	0	0	intergen
11	55519271	55519570	MACS_peak_3409	100.74	299	0	0	0	intergen
11	55688856	55689236	MACS_peak_3410	64.17	380	0	0	0	intergen
11	56101731	56102111	MACS_peak_3411	152.49	380	1	0	0	promoter
11	56224709	56225071	MACS_peak_3412	135.82	362	0	0	0	intergen
11	56277202	56277430	MACS_peak_3413	635.07	228	1	0	0	promoter
11	56497744	56497997	MACS_peak_3414	155.4	253	0	0	0	intergen
11	56551171	56551427	MACS_peak_3415	114.64	256	0	0	0	intergen
11	56590402	56590733	MACS_peak_3416	100.86	331	0	0	0	intergen
11	56683505	56683901	MACS_peak_3417	145.2	396	0	0	0	intergen
11	56789332	56789636	MACS_peak_3418	84.53	304	0	0	0	intergen
11	56806455	56806841	MACS_peak_3419	216.96	386	0	0	1	other
11	57025705	57026074	MACS_peak_3420	765.37	369	0	0	0	intergen
11	58052120	58052402	MACS_peak_3421	259.16	282	0	1	1	gen
11	58372185	58372595	MACS_peak_3423	105.65	410	0	0	0	intergen
11	58415597	58416039	MACS_peak_3424	214.87	442	0	0	0	intergen
11	58524206	58524413	MACS_peak_3425	613.04	207	1	0	0	promoter
11	58541460	58541827	MACS_peak_3426	128.75	367	0	1	0	gen
11	58817825	58818193	MACS_peak_3427	114.74	368	0	0	0	intergen
11	59018502	59018780	MACS_peak_3428	76.3	278	0	1	1	gen
11	59405989	59406288	MACS_peak_3429	254.93	299	0	0	0	intergen
11	59406767	59407113	MACS_peak_3430	72.05	346	0	0	0	intergen
11	59802662	59802951	MACS_peak_3431	571.63	289	1	1	0	promoter
11	60012513	60012740	MACS_peak_3432	152.23	227	0	1	0	gen
11	60158723	60159012	MACS_peak_3433	956.98	289	0	0	0	intergen
11	60193642	60193902	MACS_peak_3434	725.38	260	0	1	0	gen
11	60265716	60265920	MACS_peak_3435	797.18	204	0	1	0	gen
11	60330325	60330696	MACS_peak_3436	262.11	371	1	0	0	promoter
11	60343173	60343410	MACS_peak_3437	662.31	237	0	1	0	gen
11	60535944	60536265	MACS_peak_3439	55.71	321	0	1	0	gen
11	60547697	60548150	MACS_peak_3440	306.6	453	0	0	0	intergen
11	60575786	60576021	MACS_peak_3441	475.01	235	0	0	0	intergen
11	60604826	60605248	MACS_peak_3443	236.87	422	0	0	1	other
11	60660713	60660911	MACS_peak_3444	642.68	198	0	0	1	other
11	60886577	60886841	MACS_peak_3445	229.33	264	1	0	0	promoter
11	61086058	61086472	MACS_peak_3447	201.96	414	0	0	0	intergen
11	61129780	61130117	MACS_peak_3448	834.03	337	1	0	0	promoter
11	61181878	61182104	MACS_peak_3449	453.33	226	0	0	0	intergen
11	61446235	61446429	MACS_peak_3450	678.9	194	0	2	0	gen
11	61516977	61517229	MACS_peak_3451	1025.76	252	1	0	0	promoter
11	61671631	61671851	MACS_peak_3452	697.97	220	0	0	0	intergen
11	61989143	61989420	MACS_peak_3453	488.85	277	0	0	0	intergen
11	62016361	62016621	MACS_peak_3454	388.99	260	0	0	0	intergen
11	62061459	62061650	MACS_peak_3455	666.79	191	0	0	0	intergen
11	62082135	62082359	MACS_peak_3456	712.32	224	0	0	0	intergen
11	62153618	62153767	MACS_peak_3457	1187.29	149	0	0	0	intergen
11	62362497	62362937	MACS_peak_3458	1058.53	440	0	1	0	gen
11	62394033	62394390	MACS_peak_3459	774.47	357	0	0	0	intergen
11	62497167	62497326	MACS_peak_3460	866.35	159	0	1	0	gen
11	62542772	62543008	MACS_peak_3461	814.37	236	0	1	0	gen
11	62705565	62705960	MACS_peak_3462	507.23	395	1	2	0	promoter
11	62905950	62906283	MACS_peak_3463	542.34	333	1	0	0	promoter
11	62975199	62975428	MACS_peak_3464	548.55	229	0	1	0	gen
11	63024154	63024396	MACS_peak_3465	1079.97	242	0	0	0	intergen
11	63040000	63040375	MACS_peak_3466	120.92	375	0	0	0	intergen
11	63058620	63058951	MACS_peak_3467	142.05	331	0	0	0	intergen
11	63066078	63066460	MACS_peak_3468	68.69	382	0	0	0	intergen
11	63120129	63120498	MACS_peak_3469	180.31	369	0	1	0	gen
11	63188683	63189018	MACS_peak_3470	110.18	335	0	2	0	gen
11	63195395	63195730	MACS_peak_3471	89.68	335	0	2	0	gen
11	63231785	63232161	MACS_peak_3472	107.56	376	0	1	0	gen
11	63339255	63339500	MACS_peak_3473	152.07	245	0	1	0	gen
11	63347040	63347397	MACS_peak_3474	148.12	357	0	1	0	gen
11	63438461	63438716	MACS_peak_3475	108.7	255	0	0	0	intergen
11	63580901	63581113	MACS_peak_3476	426.95	212	0	1	0	gen
11	63593144	63593390	MACS_peak_3477	485.56	246	0	1	0	gen
11	63670744	63670963	MACS_peak_3478	580.62	219	0	1	0	gen
11	63738839	63739110	MACS_peak_3479	1737.7	271	0	1	0	gen
11	64553572	64553821	MACS_peak_3480	485.56	249	1	0	0	promoter
11	64787623	64787829	MACS_peak_3481	629.38	206	1	0	0	promoter
11	64887925	64888229	MACS_peak_3482	561.16	304	0	1	0	gen
11	65112544	65112792	MACS_peak_3483	485.56	248	2	0	0	promoter
11	65329950	65330315	MACS_peak_3484	495.65	365	1	0	0	promoter
11	65510835	65511079	MACS_peak_3485	629.38	244	0	0	0	intergen
11	65593873	65594079	MACS_peak_3486	797.18	206	2	0	0	promoter
11	65706054	65706514	MACS_peak_3487	1603.4	460	0	0	0	intergen
11	65711836	65712013	MACS_peak_3488	1844.9	177	2	0	0	promoter
11	65769760	65770055	MACS_peak_3489	445.58	295	0	0	1	other
11	65845028	65845334	MACS_peak_3490	336.45	306	0	2	0	gen
11	65884742	65884927	MACS_peak_3491	901.33	185	1	0	0	promoter
11	65989047	65989489	MACS_peak_3492	1065.16	442	0	0	0	intergen
11	66045164	66045468	MACS_peak_3493	561.16	304	1	0	0	promoter
11	66094186	66094665	MACS_peak_3494	127.93	479	0	1	0	gen
11	66095005	66095384	MACS_peak_3495	55.29	379	0	1	0	gen
11	66222710	66222921	MACS_peak_3496	596.79	211	0	1	0	gen
11	66282562	66282858	MACS_peak_3497	566.68	296	2	0	0	promoter
11	66678570	66678825	MACS_peak_3498	596.79	255	0	0	0	intergen
11	66694646	66694993	MACS_peak_3499	380.3	347	0	1	0	gen
11	67168339	67168537	MACS_peak_3500	831.63	198	0	1	0	gen
11	67345909	67346222	MACS_peak_3501	810.73	313	1	1	0	promoter
11	67356922	67357133	MACS_peak_3502	1301.7	211	0	2	0	gen
11	67371377	67371628	MACS_peak_3503	485.56	251	0	3	0	gen
11	67572682	67573000	MACS_peak_3504	551.85	318	0	0	0	intergen
11	67614294	67614514	MACS_peak_3505	729.14	220	0	0	1	other
11	67713911	67714246	MACS_peak_3506	796.34	335	0	0	1	other
11	67792357	67792566	MACS_peak_3507	1867.91	209	0	0	1	other
11	67799862	67800139	MACS_peak_3508	828.76	277	0	0	1	other
11	67848004	67848369	MACS_peak_3509	597.82	365	0	0	1	other
11	67938951	67939361	MACS_peak_3510	2161.52	410	0	0	1	other
11	68206195	68206412	MACS_peak_3511	580.62	217	0	1	0	gen
11	68409059	68409346	MACS_peak_3512	573.07	287	0	1	0	gen
11	68632904	68633230	MACS_peak_3513	775.47	326	0	0	0	intergen
11	68727905	68728087	MACS_peak_3514	729.14	182	0	1	0	gen
11	68950475	68950765	MACS_peak_3515	448.52	290	0	0	0	intergen
11	69000833	69001285	MACS_peak_3516	709.74	452	1	0	1	promoter
11	69101411	69101761	MACS_peak_3517	416.22	350	0	1	0	gen
11	69670302	69670556	MACS_peak_3518	470.06	254	0	1	0	gen
11	69801573	69801954	MACS_peak_3519	633.18	381	0	0	0	intergen
11	70045032	70045326	MACS_peak_3520	695.63	294	0	0	0	intergen
11	70177347	70177705	MACS_peak_3521	406.81	358	0	1	0	gen
11	70196104	70196428	MACS_peak_3522	806.6	324	0	0	0	intergen
11	70467499	70467879	MACS_peak_3523	633.81	380	1	0	0	promoter
11	70755551	70755814	MACS_peak_3524	722.6	263	0	1	0	gen
11	71343610	71343862	MACS_peak_3525	746.04	252	0	0	0	intergen
11	71512621	71513011	MACS_peak_3526	113.09	390	0	1	0	gen
11	71580118	71580506	MACS_peak_3527	510.89	388	1	0	0	promoter
11	71589225	71589671	MACS_peak_3528	611.86	446	0	1	0	gen
11	71605039	71605274	MACS_peak_3529	604.07	235	0	0	1	other
11	71656055	71656365	MACS_peak_3530	1472.63	310	0	0	0	intergen
11	71773042	71773269	MACS_peak_3532	808.3	227	0	0	1	other
11	71800311	71800787	MACS_peak_3533	815.52	476	0	1	1	gen
11	71813832	71814104	MACS_peak_3534	651.79	272	1	0	1	promoter
11	72025060	72025456	MACS_peak_3536	972.38	396	0	1	0	gen
11	72144036	72144341	MACS_peak_3537	796.56	305	0	0	0	intergen
11	72176144	72176454	MACS_peak_3538	265.34	310	0	0	2	other
11	72434154	72434408	MACS_peak_3540	1171.45	254	0	1	0	gen
11	72567825	72568093	MACS_peak_3541	380.3	268	0	0	0	intergen
11	72599041	72599398	MACS_peak_3542	648.81	357	0	1	0	gen
11	72683729	72684081	MACS_peak_3543	415.24	352	1	0	0	promoter
11	73072660	73073011	MACS_peak_3544	371.55	351	0	1	0	gen
11	73185220	73185519	MACS_peak_3545	443.26	299	0	0	0	intergen
11	73242692	73242956	MACS_peak_3546	464.74	264	0	0	0	intergen
11	73295494	73295816	MACS_peak_3548	549.27	322	0	1	0	gen
11	73351115	73351503	MACS_peak_3550	1102.85	388	0	1	0	gen
11	73393656	73393920	MACS_peak_3551	972.38	264	0	1	0	gen
11	73478776	73479053	MACS_peak_3552	456.44	277	0	1	0	gen
11	73544661	73545026	MACS_peak_3553	643.49	365	0	1	0	gen
11	73625627	73626003	MACS_peak_3554	636.35	376	0	0	0	intergen
11	73729893	73730197	MACS_peak_3555	529.34	304	0	1	0	gen
11	73812197	73812432	MACS_peak_3556	448.43	235	0	1	0	gen
11	73989260	73989510	MACS_peak_3557	561.71	250	0	0	0	intergen
11	74255764	74256123	MACS_peak_3558	526.85	359	0	1	0	gen
11	74281177	74281549	MACS_peak_3559	56.38	372	0	1	0	gen
11	74383888	74384166	MACS_peak_3560	579.67	278	0	1	0	gen
11	74402257	74402679	MACS_peak_3561	439.97	422	0	0	1	other
11	74443299	74443465	MACS_peak_3562	831.63	166	0	0	1	other
11	74453452	74453718	MACS_peak_3563	588.83	266	1	0	1	promoter
11	74621987	74622394	MACS_peak_3564	473.28	407	0	1	0	gen
11	74702403	74702629	MACS_peak_3565	548.55	226	0	1	0	gen
11	74757112	74757497	MACS_peak_3566	96.97	385	0	1	0	gen
11	74758221	74758585	MACS_peak_3567	76.89	364	0	1	0	gen
11	74799820	74800033	MACS_peak_3568	370.25	213	0	1	0	gen
11	74830785	74831115	MACS_peak_3569	1069.92	330	0	2	1	gen
11	74885403	74885620	MACS_peak_3570	239.29	217	0	1	1	gen
11	74890550	74890909	MACS_peak_3571	52.67	359	0	1	1	gen
11	74892535	74892793	MACS_peak_3572	190.62	258	0	1	1	gen
11	74929763	74930046	MACS_peak_3573	490.8	283	0	1	0	gen
11	75022975	75023197	MACS_peak_3574	564.54	222	0	0	0	intergen
11	75121950	75122341	MACS_peak_3575	83.36	391	0	1	1	gen
11	75124685	75124978	MACS_peak_3576	165.91	293	0	1	1	gen
11	75214176	75214308	MACS_peak_3577	950.58	132	0	0	1	other
11	75241507	75241937	MACS_peak_3578	974.06	430	1	0	0	promoter
11	75248681	75248970	MACS_peak_3579	2039.65	289	0	0	0	intergen
11	75371375	75371541	MACS_peak_3580	479.76	166	0	0	0	intergen
11	75407933	75408266	MACS_peak_3581	1345.06	333	0	1	0	gen
11	75532486	75532696	MACS_peak_3582	613.04	210	0	0	0	intergen
11	75597620	75597894	MACS_peak_3583	712.68	274	0	1	0	gen
11	75753612	75753969	MACS_peak_3584	76.35	357	0	0	0	intergen
11	75867237	75867458	MACS_peak_3585	432.48	221	0	1	0	gen
11	75915303	75915651	MACS_peak_3586	265.34	348	0	1	0	gen
11	75919908	75920145	MACS_peak_3587	479.39	237	0	1	0	gen
11	75987319	75987530	MACS_peak_3588	596.79	211	0	1	0	gen
11	76092375	76092784	MACS_peak_3589	85.59	409	0	1	0	gen
11	76207599	76207856	MACS_peak_3590	595.98	257	0	1	0	gen
11	76432964	76433124	MACS_peak_3591	955.37	160	0	0	0	intergen
11	76826746	76827116	MACS_peak_3592	77.85	370	0	0	0	intergen
11	76881535	76881748	MACS_peak_3593	511.33	213	0	1	0	gen
11	76908808	76909181	MACS_peak_3594	92.88	373	0	1	0	gen
11	76939804	76940076	MACS_peak_3595	584.2	272	0	1	0	gen
11	77046974	77047205	MACS_peak_3596	532.66	231	0	0	0	intergen
11	77047770	77048051	MACS_peak_3597	506.92	281	0	0	0	intergen
11	77091310	77091502	MACS_peak_3598	1061.85	192	0	1	0	gen
11	77277738	77278103	MACS_peak_3599	63.13	365	0	1	0	gen
11	77326944	77327354	MACS_peak_3600	82.65	410	0	1	0	gen
11	77329110	77329421	MACS_peak_3601	95.79	311	0	1	0	gen
11	77330156	77330498	MACS_peak_3602	111.37	342	0	1	0	gen
11	77484191	77484324	MACS_peak_3603	1011.74	133	0	0	0	intergen
11	77619641	77619864	MACS_peak_3604	564.54	223	0	1	0	gen
11	77758725	77758982	MACS_peak_3605	338.06	257	0	1	0	gen
11	77888606	77888994	MACS_peak_3606	172.39	388	0	2	0	gen
11	77949458	77949750	MACS_peak_3607	142.05	292	0	1	0	gen
11	78104837	78105134	MACS_peak_3608	512.48	297	1	0	0	promoter
11	78414155	78414545	MACS_peak_3609	679.18	390	0	1	1	gen
11	78420396	78420670	MACS_peak_3610	458.32	274	0	0	1	other
11	78586378	78586857	MACS_peak_3611	422.76	479	0	0	0	intergen
11	78695882	78696269	MACS_peak_3612	823.36	387	0	1	0	gen
11	78715777	78715959	MACS_peak_3613	1134.69	182	0	1	0	gen
11	79144167	79144353	MACS_peak_3615	676.7	186	0	1	0	gen
11	79461034	79461368	MACS_peak_3616	664.84	334	0	0	0	intergen
11	79493614	79493874	MACS_peak_3617	725.38	260	0	0	0	intergen
11	79555333	79555724	MACS_peak_3618	84.66	391	0	0	0	intergen
11	79556306	79556579	MACS_peak_3619	50.35	273	0	0	0	intergen
11	79557693	79558065	MACS_peak_3620	114.74	372	0	0	0	intergen
11	79598513	79598756	MACS_peak_3621	1079.97	243	0	0	0	intergen
11	79960977	79961355	MACS_peak_3622	93.4	378	0	0	0	intergen
11	80227727	80227983	MACS_peak_3623	611.86	256	0	0	0	intergen
11	80297329	80297589	MACS_peak_3624	706.68	260	0	0	0	intergen
11	80407306	80407548	MACS_peak_3625	936.57	242	0	0	0	intergen
11	80449258	80449581	MACS_peak_3626	672.92	323	0	0	0	intergen
11	80508941	80509268	MACS_peak_3627	121.38	327	0	0	0	intergen
11	80510094	80510457	MACS_peak_3628	158.81	363	0	0	0	intergen
11	81006944	81007341	MACS_peak_3630	724.11	397	0	0	0	intergen
11	81173716	81173992	MACS_peak_3631	457.06	276	0	0	0	intergen
11	81535460	81535824	MACS_peak_3632	129.87	364	0	0	0	intergen
11	81580450	81580654	MACS_peak_3633	629.38	204	0	0	0	intergen
11	81644270	81644584	MACS_peak_3634	1082.36	314	0	0	0	intergen
11	81677056	81677311	MACS_peak_3635	838	255	0	0	0	intergen
11	81681524	81681797	MACS_peak_3636	848.53	273	0	0	0	intergen
11	81901646	81902037	MACS_peak_3637	210.81	391	0	0	1	other
11	82122896	82123255	MACS_peak_3638	69	359	0	0	1	other
11	82160004	82160337	MACS_peak_3640	66.83	333	0	0	1	other
11	82182367	82182725	MACS_peak_3642	164.26	358	0	0	1	other
11	82280239	82280629	MACS_peak_3643	92.51	390	0	0	1	other
11	82282237	82282671	MACS_peak_3644	106.34	434	0	0	1	other
11	82315220	82315394	MACS_peak_3645	989.9	174	0	0	1	other
11	82503195	82503389	MACS_peak_3646	1043.77	194	0	0	1	other
11	82519136	82519360	MACS_peak_3647	158.76	224	0	0	1	other
11	82682205	82682685	MACS_peak_3648	936.36	480	0	0	1	other
11	82718178	82718477	MACS_peak_3649	443.26	299	0	0	0	intergen
11	82864293	82864528	MACS_peak_3650	972.07	235	0	1	0	gen
11	83324412	83324686	MACS_peak_3652	260.97	274	0	0	1	other
11	83604480	83604694	MACS_peak_3653	865.29	214	0	1	0	gen
11	83741480	83741723	MACS_peak_3654	697.55	243	0	1	0	gen
11	83836889	83837175	MACS_peak_3655	450.92	286	0	1	0	gen
11	83996149	83996389	MACS_peak_3656	936.57	240	0	1	0	gen
11	84184674	84184958	MACS_peak_3657	69	284	0	1	0	gen
11	84261823	84262066	MACS_peak_3658	501.16	243	0	1	0	gen
11	84477766	84477957	MACS_peak_3659	642.27	191	0	1	0	gen
11	84564730	84564980	MACS_peak_3660	485.56	250	0	1	0	gen
11	84800596	84800966	MACS_peak_3661	265.34	370	0	1	0	gen
11	84936115	84936395	MACS_peak_3662	707.43	280	0	1	0	gen
11	85009884	85010280	MACS_peak_3663	792.31	396	0	1	0	gen
11	85273546	85273932	MACS_peak_3664	200.88	386	0	1	0	gen
11	85326358	85326717	MACS_peak_3665	108.66	359	0	1	0	gen
11	85329276	85329689	MACS_peak_3667	57.22	413	0	1	0	gen
11	85352060	85352387	MACS_peak_3668	142.05	327	0	1	0	gen
11	85357457	85357660	MACS_peak_3669	549.71	203	0	1	0	gen
11	85411560	85411786	MACS_peak_3670	541.5	226	0	1	0	gen
11	85504173	85504438	MACS_peak_3671	232.87	265	0	1	0	gen
11	85694447	85694730	MACS_peak_3672	1236.43	283	1	0	0	promoter
11	85766572	85766770	MACS_peak_3673	642.68	198	0	1	0	gen
11	85848849	85849047	MACS_peak_3674	424	198	0	0	0	intergen
11	85850626	85850965	MACS_peak_3675	112.52	339	1	0	0	promoter
11	86041928	86042155	MACS_peak_3676	548.55	227	0	1	0	gen
11	86291879	86292075	MACS_peak_3677	662.31	196	0	0	0	intergen
11	86307891	86308288	MACS_peak_3678	391.67	397	0	1	0	gen
11	86351609	86351870	MACS_peak_3679	215.51	261	0	0	0	intergen
11	86408895	86409259	MACS_peak_3680	898.35	364	0	1	0	gen
11	86456017	86456498	MACS_peak_3681	671.72	481	0	1	1	gen
11	86571642	86571899	MACS_peak_3682	449.27	257	0	1	1	gen
11	86653304	86653590	MACS_peak_3683	112.91	286	0	1	0	gen
11	86655455	86655908	MACS_peak_3684	57.34	453	0	1	0	gen
11	86826330	86826694	MACS_peak_3685	61.7	364	0	1	0	gen
11	86828322	86828776	MACS_peak_3686	57.09	454	0	1	0	gen
11	87036159	87036305	MACS_peak_3687	1477.99	146	1	0	0	promoter
11	87047705	87048068	MACS_peak_3688	62	363	0	1	0	gen
11	87164274	87164708	MACS_peak_3689	67.45	434	0	1	0	gen
11	87244599	87244838	MACS_peak_3690	119.81	239	0	1	0	gen
11	87654850	87655216	MACS_peak_3691	85.18	366	0	0	0	intergen
11	87697930	87698235	MACS_peak_3692	243.85	305	0	0	0	intergen
11	87947209	87947589	MACS_peak_3693	140.2	380	0	0	1	other
11	88031883	88032266	MACS_peak_3695	95.04	383	0	0	1	other
11	88185284	88185505	MACS_peak_3696	159.84	221	0	0	0	intergen
11	88393774	88394177	MACS_peak_3697	94.28	403	0	0	0	intergen
11	88396466	88396839	MACS_peak_3698	76.51	373	0	0	0	intergen
11	88459813	88460054	MACS_peak_3699	93.41	241	0	0	0	intergen
11	88648045	88648415	MACS_peak_3701	97.48	370	0	1	0	gen
11	88802987	88803263	MACS_peak_3702	137.17	276	0	1	0	gen
11	89078729	89078921	MACS_peak_3704	548.67	192	0	0	0	intergen
11	89438712	89438988	MACS_peak_3705	845.51	276	0	1	0	gen
11	89791800	89792139	MACS_peak_3707	127.5	339	0	0	0	intergen
11	89792274	89792590	MACS_peak_3708	134.82	316	0	0	0	intergen
11	89840663	89840908	MACS_peak_3709	501.16	245	0	0	0	intergen
11	90003590	90003899	MACS_peak_3710	557.79	309	0	0	0	intergen
11	90047080	90047317	MACS_peak_3711	85.07	237	0	0	0	intergen
11	90093893	90094192	MACS_peak_3712	53.38	299	0	0	0	intergen
11	90095042	90095288	MACS_peak_3713	209.17	246	0	0	0	intergen
11	90148747	90149180	MACS_peak_3714	634.13	433	0	1	0	gen
11	90186799	90187182	MACS_peak_3715	114.74	383	0	1	0	gen
11	90400233	90400569	MACS_peak_3716	133.12	336	0	0	1	other
11	90400887	90401338	MACS_peak_3717	254.56	451	0	0	1	other
11	90535713	90535849	MACS_peak_3718	1061.85	136	0	0	1	other
11	90579387	90579778	MACS_peak_3719	272.12	391	0	0	1	other
11	90639747	90640002	MACS_peak_3720	698.99	255	0	0	1	other
11	90975615	90975992	MACS_peak_3721	94.17	377	0	0	0	intergen
11	90976334	90976579	MACS_peak_3722	160.58	245	0	0	0	intergen
11	91019417	91019777	MACS_peak_3723	136.58	360	0	0	0	intergen
11	91126392	91126622	MACS_peak_3724	532.66	230	0	0	0	intergen
11	91909186	91909592	MACS_peak_3725	349.84	406	0	0	0	intergen
11	92029106	92029442	MACS_peak_3726	120.81	336	0	0	0	intergen
11	92030437	92030908	MACS_peak_3727	94.74	471	0	0	0	intergen
11	92031083	92031412	MACS_peak_3728	133.94	329	0	0	0	intergen
11	92143184	92143383	MACS_peak_3729	1007.8	199	0	0	0	intergen
11	92174978	92175326	MACS_peak_3730	136.05	348	0	0	0	intergen
11	92564292	92564614	MACS_peak_3731	134.74	322	0	1	0	gen
11	92567249	92567476	MACS_peak_3732	374.2	227	0	1	0	gen
11	93243463	93243686	MACS_peak_3733	814.91	223	0	0	0	intergen
11	93427739	93428185	MACS_peak_3735	159.56	446	0	1	0	gen
11	94038731	94039074	MACS_peak_3736	87.67	343	0	1	0	gen
11	94041089	94041434	MACS_peak_3737	51.05	345	0	1	0	gen
11	94042075	94042461	MACS_peak_3738	100.37	386	0	1	0	gen
11	94189894	94190157	MACS_peak_3739	240.87	263	0	0	0	intergen
11	94239641	94239974	MACS_peak_3740	69	333	0	0	1	other
11	94318991	94319371	MACS_peak_3741	146.18	380	0	0	0	intergen
11	94350494	94350737	MACS_peak_3742	174.59	243	0	0	0	intergen
11	94375177	94375559	MACS_peak_3743	76.3	382	1	0	0	promoter
11	94922177	94922391	MACS_peak_3744	746.04	214	0	0	1	other
11	95324560	95324899	MACS_peak_3745	530.67	339	0	0	0	intergen
11	95436764	95437103	MACS_peak_3746	76.95	339	0	0	0	intergen
11	95626547	95626754	MACS_peak_3749	212.94	207	0	0	1	other
11	95874619	95875059	MACS_peak_3750	119.54	440	0	1	0	gen
11	96406383	96406650	MACS_peak_3751	67.03	267	0	1	0	gen
11	96936016	96936358	MACS_peak_3752	87.17	342	0	0	0	intergen
11	97557427	97557757	MACS_peak_3753	413.07	330	0	0	0	intergen
11	98327686	98327924	MACS_peak_3755	124.74	238	0	0	0	intergen
11	98345174	98345515	MACS_peak_3757	114.74	341	0	0	0	intergen
11	98434977	98435237	MACS_peak_3758	167.41	260	0	0	0	intergen
11	98918529	98918962	MACS_peak_3759	239.53	433	0	0	0	intergen
11	99603269	99603520	MACS_peak_3761	100.52	251	0	1	0	gen
11	99762198	99762531	MACS_peak_3762	159.48	333	0	1	0	gen
11	99999017	99999321	MACS_peak_3763	127.07	304	0	1	0	gen
11	100035302	100035593	MACS_peak_3764	229.35	291	0	1	0	gen
11	100037120	100037502	MACS_peak_3765	50.92	382	0	1	0	gen
11	100287308	100287609	MACS_peak_3766	78.25	301	0	1	0	gen
11	100287993	100288415	MACS_peak_3767	179.96	422	0	1	0	gen
11	100454746	100455094	MACS_peak_3770	53.89	348	0	0	0	intergen
11	100476116	100476419	MACS_peak_3771	136.82	303	0	0	0	intergen
11	100490658	100491021	MACS_peak_3772	84.4	363	0	0	0	intergen
11	100558896	100559032	MACS_peak_3773	1061.85	136	0	0	0	intergen
11	101046200	101046430	MACS_peak_3774	360.19	230	0	1	0	gen
11	101280770	101281113	MACS_peak_3775	260.74	343	0	0	0	intergen
11	101456795	101457086	MACS_peak_3776	570.2	291	0	1	0	gen
11	101679425	101679653	MACS_peak_3777	192	228	0	1	0	gen
11	101702969	101703355	MACS_peak_3778	667.43	386	0	1	0	gen
11	101841979	101842355	MACS_peak_3780	114.74	376	0	1	0	gen
11	101884152	101884409	MACS_peak_3781	595.98	257	0	0	0	intergen
11	102504198	102504508	MACS_peak_3782	62.07	310	0	0	0	intergen
11	102743540	102743806	MACS_peak_3783	96.77	266	0	0	0	intergen
11	103039077	103039381	MACS_peak_3784	60.35	304	0	0	0	intergen
11	103114190	103114488	MACS_peak_3785	692.37	298	0	0	0	intergen
11	103138769	103139188	MACS_peak_3786	77.02	419	0	1	0	gen
11	103325943	103326243	MACS_peak_3787	690.75	300	0	1	0	gen
11	103511776	103512119	MACS_peak_3788	148.87	343	0	0	0	intergen
11	103740681	103740987	MACS_peak_3789	57.84	306	0	0	1	other
11	103816495	103816867	MACS_peak_3790	86.43	372	0	0	1	other
11	104118735	104119148	MACS_peak_3791	722.05	413	0	1	0	gen
11	104119460	104119906	MACS_peak_3792	713.39	446	0	1	0	gen
11	104211569	104211927	MACS_peak_3793	158.81	358	0	0	0	intergen
11	104437954	104438285	MACS_peak_3794	296.13	331	0	0	0	intergen
11	105019044	105019451	MACS_peak_3795	76.41	407	0	1	0	gen
11	105349036	105349402	MACS_peak_3796	272.05	366	0	1	0	gen
11	105413721	105414178	MACS_peak_3797	124.51	457	0	1	0	gen
11	106154533	106154665	MACS_peak_3798	977.06	132	0	0	0	intergen
11	106272477	106272817	MACS_peak_3799	1480.36	340	0	0	0	intergen
11	106338311	106338619	MACS_peak_3800	50.42	308	0	0	0	intergen
11	107227918	107228053	MACS_peak_3801	1079.97	135	0	0	0	intergen
11	107364182	107364564	MACS_peak_3802	78.42	382	0	1	0	gen
11	107364700	107365154	MACS_peak_3803	50.57	454	0	1	0	gen
11	107367080	107367423	MACS_peak_3804	124.94	343	0	1	0	gen
11	107838376	107838752	MACS_peak_3805	265.34	376	0	1	0	gen
11	108136318	108136598	MACS_peak_3806	454.58	280	0	1	0	gen
11	108359256	108359728	MACS_peak_3807	272.09	472	0	2	0	gen
11	108359933	108360195	MACS_peak_3808	85.37	262	0	2	0	gen
11	108361919	108362382	MACS_peak_3809	100.2	463	0	2	0	gen
11	108374596	108374885	MACS_peak_3810	84.4	289	0	1	0	gen
11	108684420	108684765	MACS_peak_3811	95.66	345	0	1	0	gen
11	108697922	108698178	MACS_peak_3812	729.14	256	0	1	0	gen
11	108950469	108950657	MACS_peak_3813	362.76	188	0	0	0	intergen
11	109082494	109082882	MACS_peak_3814	81.3	388	0	0	0	intergen
11	109177797	109178166	MACS_peak_3815	71.77	369	0	0	0	intergen
11	109179600	109179809	MACS_peak_3816	96.18	209	0	0	0	intergen
11	109188362	109188652	MACS_peak_3817	219.32	290	0	0	0	intergen
11	109254830	109255034	MACS_peak_3818	629.38	204	0	0	0	intergen
11	109448215	109448591	MACS_peak_3820	94.54	376	0	0	1	other
11	109572188	109572494	MACS_peak_3821	144.03	306	0	0	1	other
11	109576239	109576471	MACS_peak_3822	200.47	232	0	0	1	other
11	109878313	109878505	MACS_peak_3823	552.8	192	0	1	0	gen
11	110649193	110649328	MACS_peak_3825	925.76	135	0	1	0	gen
11	110659218	110659478	MACS_peak_3826	167.41	260	0	1	0	gen
11	110701325	110701658	MACS_peak_3827	107.19	333	0	1	0	gen
11	111188706	111188927	MACS_peak_3828	1809.16	221	0	0	0	intergen
11	111446623	111446904	MACS_peak_3829	706.57	281	0	1	0	gen
11	112324461	112324792	MACS_peak_3830	84.4	331	0	0	1	other
11	112325649	112325935	MACS_peak_3831	77.29	286	0	0	1	other
11	112679117	112679368	MACS_peak_3832	117.38	251	0	0	1	other
11	112681699	112682159	MACS_peak_3833	132.89	460	0	0	1	other
11	113532811	113533014	MACS_peak_3834	629.38	203	0	0	0	intergen
11	113766664	113766986	MACS_peak_3835	229.83	322	0	1	0	gen
11	114124461	114124675	MACS_peak_3836	596.79	214	0	1	0	gen
11	114537764	114538134	MACS_peak_3837	83.89	370	0	1	0	gen
11	114553023	114553243	MACS_peak_3838	2334.02	220	0	1	0	gen
11	114629373	114629826	MACS_peak_3840	121.82	453	0	0	0	intergen
11	114632643	114632924	MACS_peak_3841	522.61	281	0	0	0	intergen
11	114634111	114634439	MACS_peak_3842	152.98	328	0	0	0	intergen
11	114637230	114637586	MACS_peak_3843	64.09	356	0	0	0	intergen
11	114639734	114640079	MACS_peak_3844	584.72	345	0	0	0	intergen
11	114809985	114810361	MACS_peak_3845	75.99	376	0	0	0	intergen
11	114843849	114844133	MACS_peak_3847	63.94	284	0	0	0	intergen
11	115857282	115857640	MACS_peak_3848	111.31	358	0	0	0	intergen
11	115878663	115879052	MACS_peak_3849	78.63	389	0	0	0	intergen
11	115879597	115879908	MACS_peak_3850	64.4	311	0	0	0	intergen
11	115972113	115972422	MACS_peak_3851	310.92	309	0	0	0	intergen
11	116006346	116006694	MACS_peak_3852	121.69	348	0	0	0	intergen
11	116196432	116196619	MACS_peak_3853	677.98	187	0	0	0	intergen
11	116572157	116572471	MACS_peak_3854	84.09	314	0	0	0	intergen
11	116574532	116574985	MACS_peak_3856	59.66	453	0	0	0	intergen
11	117637214	117637395	MACS_peak_3858	1426.21	181	0	1	0	gen
11	117817660	117818030	MACS_peak_3860	520.65	370	1	1	0	promoter
11	117822066	117822285	MACS_peak_3861	1061.85	219	1	1	0	promoter
11	117844066	117844319	MACS_peak_3862	596.79	253	0	2	0	gen
11	117904696	117904891	MACS_peak_3863	2712.67	195	1	0	0	promoter
11	117950302	117950557	MACS_peak_3864	379.63	255	0	0	0	intergen
11	118053498	118053727	MACS_peak_3865	548.55	229	0	1	0	gen
11	118145281	118145513	MACS_peak_3866	678.9	232	0	1	0	gen
11	118198336	118198578	MACS_peak_3867	645.81	242	1	0	0	promoter
11	118295902	118296125	MACS_peak_3868	1377.21	223	0	0	0	intergen
11	118353046	118353396	MACS_peak_3869	416.22	350	0	1	0	gen
11	118488535	118488951	MACS_peak_3870	455.81	416	0	1	0	gen
11	118565803	118566217	MACS_peak_3871	497.6	414	0	1	0	gen
11	118659531	118659793	MACS_peak_3872	1000.58	262	1	0	0	promoter
11	118689848	118690118	MACS_peak_3873	851.59	270	0	0	1	other
11	118690199	118690436	MACS_peak_3874	662.31	237	0	0	1	other
11	118772253	118772469	MACS_peak_3875	577.49	216	0	1	0	gen
11	119004064	119004268	MACS_peak_3876	573.39	204	0	1	1	gen
11	119479747	119480049	MACS_peak_3877	562.53	302	0	0	1	other
11	119743932	119744184	MACS_peak_3878	309.73	252	0	0	0	intergen
11	121324251	121324468	MACS_peak_3879	146.53	217	0	0	0	intergen
11	121486480	121486754	MACS_peak_3880	582.68	274	0	1	0	gen
11	121656055	121656247	MACS_peak_3881	678.9	192	0	0	0	intergen
11	121752404	121752817	MACS_peak_3882	110.98	413	0	0	0	intergen
11	121752930	121753305	MACS_peak_3883	89.02	375	0	0	0	intergen
11	121823525	121823897	MACS_peak_3885	101.68	372	0	0	0	intergen
11	121852169	121852425	MACS_peak_3886	372.1	256	0	0	0	intergen
11	121860640	121860963	MACS_peak_3887	235.04	323	0	0	0	intergen
11	121871412	121871622	MACS_peak_3888	1144.4	210	0	0	0	intergen
11	122016485	122016623	MACS_peak_3889	1320.51	138	0	0	0	intergen
11	122477630	122477918	MACS_peak_3890	170.9	288	0	0	1	other
11	122826554	122826810	MACS_peak_3891	69	256	0	0	1	other
11	122828210	122828575	MACS_peak_3892	82.42	365	0	0	1	other
11	123261553	123261867	MACS_peak_3893	434.84	314	0	0	0	intergen
11	123470490	123470637	MACS_peak_3894	893.54	147	0	1	0	gen
11	124236602	124236931	MACS_peak_3895	105.65	329	1	0	0	promoter
11	124415413	124415703	MACS_peak_3896	1671.3	290	0	0	0	intergen
11	124505921	124506276	MACS_peak_3897	59.3	355	0	0	0	intergen
11	124580837	124580976	MACS_peak_3898	560.85	139	0	1	0	gen
11	124586123	124586448	MACS_peak_3899	671.43	325	0	0	0	intergen
11	124913118	124913541	MACS_peak_3900	1155.88	423	0	0	0	intergen
11	125131503	125131950	MACS_peak_3901	159.56	447	0	0	0	intergen
11	125345813	125346008	MACS_peak_3902	848.95	195	0	1	0	gen
11	125383451	125383767	MACS_peak_3903	678.2	316	0	1	0	gen
11	125784068	125784413	MACS_peak_3904	142.52	345	1	0	0	promoter
11	126237657	126237887	MACS_peak_3905	762.11	230	0	1	0	gen
11	126310565	126310774	MACS_peak_3906	613.04	209	0	1	0	gen
11	127375398	127375826	MACS_peak_3907	724.67	428	0	0	0	intergen
11	127729034	127729188	MACS_peak_3908	517.6	154	0	0	0	intergen
11	128378181	128378607	MACS_peak_3909	134.69	426	0	0	0	intergen
11	129175073	129175519	MACS_peak_3910	54.32	446	0	1	0	gen
11	129193435	129193835	MACS_peak_3911	889.09	400	0	1	0	gen
11	129245099	129245472	MACS_peak_3912	148.81	373	0	1	0	gen
11	129339089	129339361	MACS_peak_3913	123.03	272	0	0	0	intergen
11	129340904	129341313	MACS_peak_3914	96.4	409	0	0	0	intergen
11	129342154	129342436	MACS_peak_3915	68.48	282	0	0	0	intergen
11	129713213	129713616	MACS_peak_3917	160.65	403	0	0	0	intergen
11	129912632	129912948	MACS_peak_3918	420.49	316	0	1	0	gen
11	130942854	130943183	MACS_peak_3919	146.47	329	0	0	0	intergen
11	131064416	131064743	MACS_peak_3920	546.09	327	0	0	0	intergen
11	131173620	131173928	MACS_peak_3921	148.07	308	0	0	0	intergen
11	131174491	131174799	MACS_peak_3922	88.31	308	0	0	0	intergen
11	131440811	131440961	MACS_peak_3923	435.93	150	0	1	0	gen
11	133330327	133330617	MACS_peak_3925	56.38	290	0	1	0	gen
11	133420256	133420513	MACS_peak_3926	469.39	257	0	1	0	gen
11	133494556	133494896	MACS_peak_3927	262.15	340	0	1	0	gen
11	133641201	133641468	MACS_peak_3928	136.81	267	0	0	0	intergen
11	133642023	133642384	MACS_peak_3929	62.59	361	0	0	0	intergen
11	133645852	133646223	MACS_peak_3930	59.69	371	0	0	0	intergen
11	134104618	134104859	MACS_peak_3931	118.15	241	0	1	0	gen
11	134106167	134106481	MACS_peak_3932	169.25	314	0	1	0	gen
11	134262103	134262310	MACS_peak_3933	613.04	207	0	1	0	gen
11	69912816	69913173	MACS_peak_3934	410.92	357	0	0	0	intergen
12	27818	28258	MACS_peak_3935	594.49	440	0	0	1	other
12	11279	11730	MACS_peak_3936	2807.74	451	0	0	0	intergen
12	576173	576377	MACS_peak_3939	797.18	204	0	1	0	gen
12	1000313	1000509	MACS_peak_3941	662.31	196	0	1	0	gen
12	1117949	1118285	MACS_peak_3942	1340.5	336	0	1	0	gen
12	1652902	1653085	MACS_peak_3943	729.14	183	0	0	0	intergen
12	1734110	1734491	MACS_peak_3944	103.45	381	0	1	0	gen
12	1851716	1851975	MACS_peak_3945	594.37	259	0	1	0	gen
12	2131362	2131793	MACS_peak_3946	50.57	431	0	1	0	gen
12	2135056	2135321	MACS_peak_3947	132.1	265	0	1	0	gen
12	2565295	2565610	MACS_peak_3948	265.34	315	0	1	0	gen
12	2682883	2683226	MACS_peak_3949	536.24	343	0	1	1	gen
12	2885365	2885586	MACS_peak_3950	1043.77	221	0	2	0	gen
12	3299989	3300267	MACS_peak_3951	579.67	278	0	0	1	other
12	3395944	3396263	MACS_peak_3952	51.86	319	0	1	0	gen
12	3499986	3500354	MACS_peak_3954	71.19	368	0	1	0	gen
12	3502528	3502924	MACS_peak_3955	54.21	396	0	1	0	gen
12	3777375	3777568	MACS_peak_3957	678.9	193	0	0	0	intergen
12	3803963	3804244	MACS_peak_3958	453.96	281	0	1	0	gen
12	3995873	3996136	MACS_peak_3959	591.18	263	0	0	0	intergen
12	4022466	4022831	MACS_peak_3960	134.68	365	0	0	1	other
12	4180414	4180752	MACS_peak_3961	79.97	338	0	0	0	intergen
12	4511092	4511528	MACS_peak_3962	81.42	436	0	1	0	gen
12	4512658	4513004	MACS_peak_3963	50.76	346	0	1	0	gen
12	4571515	4571688	MACS_peak_3964	723.41	173	0	1	0	gen
12	4707934	4708122	MACS_peak_3965	883.81	188	0	1	1	gen
12	4849105	4849287	MACS_peak_3966	936.57	182	0	1	0	gen
12	5003099	5003479	MACS_peak_3967	757.3	380	0	0	1	other
12	5084324	5084698	MACS_peak_3968	637.63	374	0	0	0	intergen
12	5118397	5118845	MACS_peak_3970	122.09	448	0	0	0	intergen
12	5171824	5172085	MACS_peak_3971	592.77	261	0	0	0	intergen
12	5290152	5290518	MACS_peak_3972	163.46	366	0	0	0	intergen
12	5745121	5745531	MACS_peak_3973	615.59	410	0	1	0	gen
12	5837811	5838280	MACS_peak_3974	101.68	469	0	1	0	gen
12	5928532	5928963	MACS_peak_3975	204.25	431	0	1	0	gen
12	5929490	5929917	MACS_peak_3976	223.03	427	0	1	0	gen
12	5932326	5932692	MACS_peak_3977	148.8	366	0	1	0	gen
12	5988618	5988841	MACS_peak_3978	564.54	223	0	1	0	gen
12	6423520	6423862	MACS_peak_3979	420.18	342	0	0	0	intergen
12	6938000	6938332	MACS_peak_3981	542.96	332	1	1	0	promoter
12	7162635	7163008	MACS_peak_3982	405.33	373	0	0	0	intergen
12	7319557	7319717	MACS_peak_3983	1472.89	160	0	1	0	gen
12	7506456	7506792	MACS_peak_3984	59.47	336	0	0	0	intergen
12	7543212	7543398	MACS_peak_3985	712.32	186	0	0	0	intergen
12	7631634	7631975	MACS_peak_3986	641.27	341	0	0	0	intergen
12	8108854	8109102	MACS_peak_3988	485.56	248	0	0	1	other
12	8231746	8232116	MACS_peak_3989	764.63	370	0	0	0	intergen
12	8285084	8285515	MACS_peak_3990	1069.92	431	0	0	1	other
12	8537669	8538016	MACS_peak_3991	260.52	347	1	0	0	promoter
12	8954764	8954958	MACS_peak_3992	584.47	194	1	0	0	promoter
12	9197514	9197994	MACS_peak_3993	1325.89	480	0	1	0	gen
12	9524216	9524620	MACS_peak_3994	62.49	404	0	0	2	other
12	9743106	9743392	MACS_peak_3995	702.3	286	0	0	0	intergen
12	9748520	9748983	MACS_peak_3996	1076.78	463	1	0	0	promoter
12	9851216	9851371	MACS_peak_3997	783.55	155	1	0	0	promoter
12	9923323	9923642	MACS_peak_3998	142.05	319	0	1	0	gen
12	10033852	10034103	MACS_peak_3999	369	251	1	0	0	promoter
12	10087318	10087504	MACS_peak_4000	901.33	186	0	1	0	gen
12	10148318	10148584	MACS_peak_4001	450.1	266	0	0	0	intergen
12	10337178	10337473	MACS_peak_4002	93.4	295	0	0	1	other
12	10347741	10348122	MACS_peak_4003	158.5	381	0	0	0	intergen
12	10366989	10367169	MACS_peak_4004	701.06	180	0	0	1	other
12	10518781	10519134	MACS_peak_4005	119.78	353	0	1	0	gen
12	10562340	10562659	MACS_peak_4007	371.6	319	0	0	0	intergen
12	10674190	10674506	MACS_peak_4008	433.75	316	0	0	0	intergen
12	10693778	10694015	MACS_peak_4009	814.37	237	0	0	0	intergen
12	10771237	10771471	MACS_peak_4010	814.37	234	0	0	1	other
12	10912133	10912338	MACS_peak_4011	629.38	205	1	2	0	promoter
12	11203998	11204166	MACS_peak_4012	814.37	168	0	0	0	intergen
12	11384718	11384951	MACS_peak_4015	314.13	233	0	1	0	gen
12	11892024	11892251	MACS_peak_4016	1706.07	227	0	1	0	gen
12	11937854	11938239	MACS_peak_4018	84.5	385	0	0	0	intergen
12	12036137	12036385	MACS_peak_4019	763.02	248	0	0	0	intergen
12	12049721	12049856	MACS_peak_4020	1666.76	135	1	0	0	promoter
12	12409153	12409392	MACS_peak_4021	253.88	239	0	1	0	gen
12	12409864	12410249	MACS_peak_4022	187.51	385	0	1	0	gen
12	12779619	12779924	MACS_peak_4023	686.76	305	0	1	0	gen
12	13077898	13078249	MACS_peak_4024	114.74	351	0	1	0	gen
12	13098448	13098595	MACS_peak_4025	1087.19	147	0	2	0	gen
12	13255752	13256003	MACS_peak_4026	1189.9	251	0	0	0	intergen
12	13391777	13392195	MACS_peak_4027	128.6	418	0	0	0	intergen
12	13393621	13394017	MACS_peak_4028	55.91	396	0	0	0	intergen
12	13397661	13397931	MACS_peak_4029	80.69	270	0	0	0	intergen
12	13399122	13399417	MACS_peak_4030	56.41	295	0	0	0	intergen
12	13607121	13607478	MACS_peak_4031	528	357	0	1	0	gen
12	14630162	14630343	MACS_peak_4032	936.57	181	0	1	0	gen
12	14723765	14724025	MACS_peak_4033	593.56	260	0	0	1	other
12	14863592	14863940	MACS_peak_4034	127.5	348	0	1	0	gen
12	14986497	14986727	MACS_peak_4035	831.63	230	0	0	0	intergen
12	14995949	14996081	MACS_peak_4036	1116.4	132	0	0	0	intergen
12	15070674	15070855	MACS_peak_4037	371.32	181	0	0	0	intergen
12	15590307	15590648	MACS_peak_4038	537.45	341	0	1	0	gen
12	15856484	15856670	MACS_peak_4039	1965.34	186	0	1	0	gen
12	15944700	15945006	MACS_peak_4040	172.39	306	0	1	0	gen
12	16372722	16373024	MACS_peak_4041	441.54	302	0	1	0	gen
12	16380135	16380451	MACS_peak_4042	68.19	316	0	1	0	gen
12	16708110	16708495	MACS_peak_4043	91.72	385	0	0	1	other
12	17175737	17176087	MACS_peak_4045	178.37	350	0	0	0	intergen
12	17435561	17435781	MACS_peak_4046	729.14	220	0	0	0	intergen
12	17703186	17703456	MACS_peak_4047	195.04	270	0	0	0	intergen
12	17768947	17769322	MACS_peak_4048	79.24	375	0	0	0	intergen
12	17859602	17859946	MACS_peak_4050	89.53	344	0	0	0	intergen
12	18224892	18225096	MACS_peak_4051	729.92	204	0	1	0	gen
12	18788661	18789038	MACS_peak_4052	59.82	377	0	0	0	intergen
12	18872242	18872549	MACS_peak_4053	438.71	307	0	0	0	intergen
12	19568563	19568807	MACS_peak_4054	184.88	244	0	1	0	gen
12	19729117	19729489	MACS_peak_4056	64.04	372	0	0	0	intergen
12	19816168	19816431	MACS_peak_4057	97.04	263	0	0	1	other
12	20385994	20386284	MACS_peak_4058	790.81	290	0	1	0	gen
12	20694592	20694724	MACS_peak_4060	1116.4	132	1	0	0	promoter
12	20771427	20771780	MACS_peak_4061	89.55	353	0	0	0	intergen
12	20773757	20774119	MACS_peak_4062	64.61	362	0	0	0	intergen
12	21012985	21013118	MACS_peak_4063	1396.21	133	0	2	0	gen
12	21085304	21085726	MACS_peak_4064	61.22	422	0	3	0	gen
12	21136162	21136491	MACS_peak_4065	70.45	329	0	1	0	gen
12	21419773	21420145	MACS_peak_4066	77.23	372	0	0	0	intergen
12	21423424	21423872	MACS_peak_4067	119.63	448	0	0	0	intergen
12	22033490	22033859	MACS_peak_4069	380.3	369	0	0	0	intergen
12	22083087	22083480	MACS_peak_4070	1868.18	393	0	1	0	gen
12	22139924	22140184	MACS_peak_4071	106.93	260	0	1	0	gen
12	22709314	22709591	MACS_peak_4072	456.44	277	0	0	1	other
12	23016216	23016550	MACS_peak_4074	406.81	334	0	0	1	other
12	23158414	23158736	MACS_peak_4075	415.98	322	0	0	2	other
12	23265873	23266203	MACS_peak_4076	97.88	330	0	0	0	intergen
12	23506367	23506584	MACS_peak_4077	362.51	217	0	0	0	intergen
12	23837194	23837659	MACS_peak_4078	947.23	465	0	1	0	gen
12	24353692	24354051	MACS_peak_4079	265.34	359	0	1	0	gen
12	24598498	24598697	MACS_peak_4080	627.67	199	0	0	0	intergen
12	24604354	24604658	MACS_peak_4081	114.74	304	0	0	0	intergen
12	25436275	25436663	MACS_peak_4082	1143.6	388	0	1	0	gen
12	25516953	25517269	MACS_peak_4084	172.81	316	0	1	0	gen
12	25561071	25561411	MACS_peak_4085	63.13	340	0	1	0	gen
12	25728608	25728962	MACS_peak_4086	76.3	354	0	0	0	intergen
12	25728985	25729325	MACS_peak_4087	248.82	340	0	0	0	intergen
12	26029273	26029573	MACS_peak_4088	958.39	300	0	1	0	gen
12	26216511	26216811	MACS_peak_4089	69.69	300	0	1	1	gen
12	26304399	26304603	MACS_peak_4090	629.38	204	0	0	2	other
12	26701657	26701887	MACS_peak_4091	831.63	230	0	1	0	gen
12	26845117	26845322	MACS_peak_4092	629.38	205	0	0	0	intergen
12	26863776	26864137	MACS_peak_4093	488.85	361	0	0	0	intergen
12	27014441	27014644	MACS_peak_4094	629.38	203	0	0	0	intergen
12	27039504	27039721	MACS_peak_4095	423.76	217	0	1	0	gen
12	27116142	27116506	MACS_peak_4096	196.89	364	0	0	1	other
12	27167939	27168322	MACS_peak_4097	218.92	383	0	0	0	intergen
12	27384132	27384463	MACS_peak_4098	667.02	331	0	1	0	gen
12	27409420	27409785	MACS_peak_4099	92.75	365	0	1	1	gen
12	27652277	27652458	MACS_peak_4100	936.57	181	0	1	0	gen
12	28003609	28003794	MACS_peak_4102	300.04	185	0	0	0	intergen
12	28004028	28004288	MACS_peak_4103	183.57	260	0	0	0	intergen
12	28004583	28004986	MACS_peak_4104	112.08	403	0	0	0	intergen
12	28006711	28007141	MACS_peak_4105	70.99	430	0	0	0	intergen
12	28007233	28007517	MACS_peak_4106	85.58	284	0	0	0	intergen
12	28267592	28267965	MACS_peak_4107	762.41	373	0	1	0	gen
12	28523362	28523680	MACS_peak_4108	133.95	318	0	1	0	gen
12	28695693	28696021	MACS_peak_4109	69	328	0	0	0	intergen
12	28764429	28764843	MACS_peak_4110	105.25	414	0	0	0	intergen
12	29408414	29408840	MACS_peak_4111	50.33	426	1	0	1	promoter
12	29585969	29586271	MACS_peak_4112	66.89	302	0	1	0	gen
12	29813832	29814160	MACS_peak_4114	62.03	328	0	0	0	intergen
12	29871157	29871350	MACS_peak_4115	619.53	193	0	0	0	intergen
12	30354472	30354753	MACS_peak_4116	180.31	281	0	0	0	intergen
12	30435122	30435403	MACS_peak_4117	93.4	281	0	0	0	intergen
12	30521415	30521693	MACS_peak_4118	101.01	278	0	0	0	intergen
12	30593153	30593428	MACS_peak_4119	103.45	275	0	0	0	intergen
12	30775880	30776014	MACS_peak_4120	1098.16	134	0	0	2	other
12	30807568	30807802	MACS_peak_4121	532.66	234	0	0	1	other
12	31168560	31168876	MACS_peak_4122	93.82	316	0	0	1	other
12	31190897	31191279	MACS_peak_4123	105.15	382	0	0	1	other
12	31551147	31551450	MACS_peak_4124	114.6	303	0	1	0	gen
12	32231924	32232271	MACS_peak_4125	85.43	347	0	1	0	gen
12	32251994	32252236	MACS_peak_4126	936.57	242	0	1	0	gen
12	32717144	32717468	MACS_peak_4127	801.19	324	0	1	0	gen
12	32919106	32919477	MACS_peak_4128	1585.55	371	0	0	0	intergen
12	33166687	33167020	MACS_peak_4129	232.19	333	0	0	0	intergen
12	33230190	33230489	MACS_peak_4130	114.74	299	0	0	0	intergen
12	33244291	33244679	MACS_peak_4131	180.31	388	0	0	0	intergen
12	33334446	33334810	MACS_peak_4133	60.09	364	0	0	0	intergen
12	33337335	33337714	MACS_peak_4134	219.51	379	0	0	0	intergen
12	33529527	33529754	MACS_peak_4135	866.27	227	0	0	0	intergen
12	33851128	33851500	MACS_peak_4136	86.43	372	0	0	0	intergen
12	33874627	33874849	MACS_peak_4137	564.54	222	0	0	0	intergen
12	33932852	33933215	MACS_peak_4138	125.3	363	0	0	0	intergen
12	34022114	34022289	MACS_peak_4139	452.54	175	1	0	0	promoter
12	34033882	34034224	MACS_peak_4140	420.18	342	0	0	1	other
12	34067330	34067591	MACS_peak_4141	109.11	261	0	0	0	intergen
12	34123068	34123512	MACS_peak_4142	813.17	444	0	0	0	intergen
12	34293286	34293507	MACS_peak_4143	729.14	221	0	0	0	intergen
12	34611442	34611636	MACS_peak_4144	231.56	194	0	0	0	intergen
12	34668709	34669124	MACS_peak_4145	67.86	415	0	0	0	intergen
12	34680368	34680788	MACS_peak_4146	58.55	420	0	0	0	intergen
12	34691277	34691514	MACS_peak_4148	50.44	237	0	0	0	intergen
12	34693297	34693627	MACS_peak_4149	86.56	330	0	0	0	intergen
12	34695747	34695995	MACS_peak_4151	85.34	248	0	0	0	intergen
12	34702289	34702608	MACS_peak_4154	68.51	319	0	0	0	intergen
12	37603199	37603420	MACS_peak_4156	56.08	221	0	0	0	intergen
12	37606891	37607278	MACS_peak_4157	96.73	387	0	0	0	intergen
12	37616230	37616433	MACS_peak_4160	117.95	203	0	0	0	intergen
12	37617171	37617576	MACS_peak_4161	132.22	405	0	0	0	intergen
12	37626881	37627195	MACS_peak_4162	89.89	314	0	0	0	intergen
12	37635080	37635536	MACS_peak_4163	57.41	456	0	0	0	intergen
12	37640357	37640585	MACS_peak_4164	139.81	228	0	0	0	intergen
12	37660322	37660773	MACS_peak_4165	145.2	451	0	0	0	intergen
12	37668349	37668579	MACS_peak_4166	237.8	230	0	0	0	intergen
12	37676787	37677240	MACS_peak_4167	134.87	453	0	0	0	intergen
12	37714706	37715049	MACS_peak_4168	105.65	343	0	0	0	intergen
12	37723042	37723266	MACS_peak_4169	358.49	224	0	0	0	intergen
12	37801241	37801558	MACS_peak_4171	159.56	317	0	0	0	intergen
12	37853805	37854133	MACS_peak_4172	212.85	328	0	0	0	intergen
12	37964046	37964256	MACS_peak_4173	1163.51	210	0	0	0	intergen
12	38328412	38328622	MACS_peak_4175	607.01	210	0	1	0	gen
12	38422876	38423241	MACS_peak_4176	312.33	365	0	0	0	intergen
12	38800601	38800957	MACS_peak_4177	64.79	356	0	1	0	gen
12	38806235	38806649	MACS_peak_4178	65.76	414	0	1	0	gen
12	38807042	38807367	MACS_peak_4179	93.4	325	0	1	0	gen
12	38923513	38923679	MACS_peak_4180	761.04	166	0	0	0	intergen
12	38963930	38964282	MACS_peak_4181	151	352	0	0	0	intergen
12	38990336	38990680	MACS_peak_4182	55.06	344	0	0	0	intergen
12	38990931	38991205	MACS_peak_4183	75.77	274	0	0	0	intergen
12	39016193	39016385	MACS_peak_4184	866.35	192	0	0	0	intergen
12	39308486	39308680	MACS_peak_4185	1009.27	194	0	1	0	gen
12	39318256	39318569	MACS_peak_4186	680.5	313	0	1	0	gen
12	39357910	39358293	MACS_peak_4187	280.21	383	0	1	0	gen
12	39480523	39480704	MACS_peak_4188	746.04	181	0	0	0	intergen
12	39696544	39696680	MACS_peak_4189	664.91	136	0	1	0	gen
12	39800266	39800695	MACS_peak_4191	115.17	429	0	2	0	gen
12	39800813	39801142	MACS_peak_4192	188.36	329	0	2	0	gen
12	39803094	39803467	MACS_peak_4193	367	373	0	2	0	gen
12	39901407	39901780	MACS_peak_4194	192.32	373	0	2	0	gen
12	39981207	39981630	MACS_peak_4195	126.84	423	0	1	0	gen
12	40152866	40153232	MACS_peak_4197	896.66	366	0	0	0	intergen
12	40244122	40244336	MACS_peak_4198	1264.23	214	0	1	0	gen
12	40265898	40266253	MACS_peak_4199	138.53	355	0	1	0	gen
12	40290968	40291293	MACS_peak_4200	103.45	325	0	1	0	gen
12	40336483	40336842	MACS_peak_4201	411.87	359	0	1	0	gen
12	40539174	40539524	MACS_peak_4202	244.72	350	0	1	0	gen
12	40622249	40622588	MACS_peak_4203	421.69	339	0	0	0	intergen
12	40721844	40722054	MACS_peak_4204	302.47	210	0	1	0	gen
12	40734958	40735245	MACS_peak_4205	570.12	287	0	1	0	gen
12	40886472	40886909	MACS_peak_4206	105.65	437	0	1	0	gen
12	40921689	40921868	MACS_peak_4207	746.04	179	0	1	0	gen
12	40946616	40946886	MACS_peak_4208	460.86	270	0	1	0	gen
12	41040710	41041041	MACS_peak_4209	69.78	331	0	1	0	gen
12	41043111	41043544	MACS_peak_4210	178.01	433	0	1	0	gen
12	41117319	41117651	MACS_peak_4211	111.35	332	0	0	0	intergen
12	41383891	41384069	MACS_peak_4213	574.79	178	0	1	0	gen
12	41640260	41640559	MACS_peak_4214	71.45	299	0	0	0	intergen
12	41667700	41668015	MACS_peak_4215	62.86	315	0	0	0	intergen
12	42024233	42024544	MACS_peak_4216	603.02	311	0	0	0	intergen
12	42047184	42047492	MACS_peak_4217	69	308	0	0	0	intergen
12	42104172	42104440	MACS_peak_4218	718.04	268	0	1	0	gen
12	42129684	42129976	MACS_peak_4219	829.92	292	0	1	0	gen
12	42228860	42229199	MACS_peak_4220	103.45	339	0	1	0	gen
12	42332334	42332680	MACS_peak_4221	418.18	346	0	1	0	gen
12	42569320	42569604	MACS_peak_4222	1117.09	284	0	1	0	gen
12	43231425	43231771	MACS_peak_4223	51.97	346	0	0	0	intergen
12	43339054	43339264	MACS_peak_4224	780.06	210	0	0	0	intergen
12	43444881	43445202	MACS_peak_4225	549.92	321	0	1	0	gen
12	43476248	43476678	MACS_peak_4226	88.56	430	0	1	0	gen
12	43501761	43501979	MACS_peak_4227	580.62	218	0	1	0	gen
12	43533165	43533539	MACS_peak_4228	160.98	374	0	1	0	gen
12	43622925	43623244	MACS_peak_4229	78.85	319	0	0	0	intergen
12	43776613	43776836	MACS_peak_4230	564.54	223	0	1	0	gen
12	43911537	43911843	MACS_peak_4231	91.91	306	0	1	0	gen
12	44582456	44582693	MACS_peak_4233	516.86	237	0	1	0	gen
12	44935182	44935647	MACS_peak_4235	139.96	465	0	0	0	intergen
12	44936768	44937135	MACS_peak_4236	63.13	367	0	0	0	intergen
12	44948862	44949045	MACS_peak_4237	519.04	183	0	0	0	intergen
12	44952933	44953244	MACS_peak_4238	61.01	311	0	0	0	intergen
12	45085055	45085461	MACS_peak_4239	78.38	406	0	0	1	other
12	45130825	45131174	MACS_peak_4240	359	349	0	0	0	intergen
12	45170495	45170784	MACS_peak_4241	449.12	289	0	0	0	intergen
12	45240242	45240472	MACS_peak_4242	263.33	230	0	1	0	gen
12	45725767	45726011	MACS_peak_4243	918.92	244	1	0	1	promoter
12	45762525	45762877	MACS_peak_4244	530.91	352	0	1	0	gen
12	45990680	45990848	MACS_peak_4245	1025.76	168	0	1	0	gen
12	46056196	46056561	MACS_peak_4246	124.55	365	0	0	0	intergen
12	46072093	46072474	MACS_peak_4247	1015.65	381	0	0	0	intergen
12	46153320	46153629	MACS_peak_4248	541.84	309	0	0	0	intergen
12	46161910	46162089	MACS_peak_4249	746.04	179	0	0	0	intergen
12	46307912	46308226	MACS_peak_4250	164.26	314	0	0	0	intergen
12	46318641	46319073	MACS_peak_4251	1857.04	432	0	0	0	intergen
12	46421145	46421441	MACS_peak_4252	200.84	296	0	0	1	other
12	46510692	46511032	MACS_peak_4253	380.3	340	0	0	1	other
12	46661497	46661718	MACS_peak_4254	729.14	221	0	0	1	other
12	46741776	46742100	MACS_peak_4255	182.6	324	0	0	1	other
12	47010306	47010598	MACS_peak_4256	62.38	292	0	0	0	intergen
12	47717479	47717774	MACS_peak_4257	445.58	295	0	1	1	gen
12	47837670	47837872	MACS_peak_4258	645.81	202	1	0	1	promoter
12	47870558	47870712	MACS_peak_4259	902.38	154	0	1	0	gen
12	48165171	48165461	MACS_peak_4261	435.23	290	0	1	0	gen
12	48189612	48189875	MACS_peak_4262	837.49	263	0	0	1	other
12	48209689	48210026	MACS_peak_4263	113.3	337	0	0	1	other
12	48251014	48251332	MACS_peak_4264	432.66	318	0	0	1	other
12	48322771	48323092	MACS_peak_4265	194.11	321	0	0	0	intergen
12	48369502	48369834	MACS_peak_4266	926.89	332	0	0	1	other
12	48478636	48478926	MACS_peak_4267	204.43	290	1	0	0	promoter
12	48499717	48500167	MACS_peak_4268	149.97	450	0	0	1	other
12	48542375	48542678	MACS_peak_4269	1102.85	303	0	0	0	intergen
12	48577853	48578195	MACS_peak_4270	129.22	342	0	0	0	intergen
12	48959716	48960060	MACS_peak_4271	406.81	344	0	0	0	intergen
12	49150128	49150290	MACS_peak_4272	1501.05	162	0	0	0	intergen
12	49234482	49234844	MACS_peak_4273	770.64	362	0	1	1	gen
12	49235269	49235580	MACS_peak_4274	582.79	311	0	1	1	gen
12	49262747	49263133	MACS_peak_4275	496.13	386	0	1	1	gen
12	49288300	49288678	MACS_peak_4276	758.75	378	1	0	0	promoter
12	49358719	49358964	MACS_peak_4277	629.38	245	0	0	0	intergen
12	49513987	49514438	MACS_peak_4278	598.13	451	0	1	0	gen
12	49553552	49553805	MACS_peak_4279	596.79	253	1	1	0	promoter
12	49636988	49637187	MACS_peak_4280	831.63	199	1	1	0	promoter
12	49720233	49720541	MACS_peak_4281	402.47	308	0	1	0	gen
12	49778155	49778543	MACS_peak_4282	1280.92	388	0	0	0	intergen
12	49867181	49867396	MACS_peak_4283	746.04	215	1	0	0	promoter
12	50055951	50056241	MACS_peak_4284	831.82	290	1	0	0	promoter
12	50070565	50070987	MACS_peak_4285	728.53	422	0	1	0	gen
12	50132596	50132878	MACS_peak_4286	576.71	282	1	0	1	promoter
12	50504733	50505013	MACS_peak_4287	465.75	280	1	0	0	promoter
12	50593392	50593586	MACS_peak_4288	527.71	194	0	1	0	gen
12	50924428	50924665	MACS_peak_4289	689	237	1	0	0	promoter
12	50973784	50974220	MACS_peak_4290	81.3	436	0	0	0	intergen
12	50976872	50977240	MACS_peak_4292	101.93	368	1	0	0	promoter
12	51292183	51292446	MACS_peak_4293	420.71	263	0	1	0	gen
12	51341428	51341735	MACS_peak_4294	1232.49	307	0	1	0	gen
12	51421324	51421647	MACS_peak_4295	429.98	323	0	1	0	gen
12	51562262	51562664	MACS_peak_4296	68.92	402	0	0	0	intergen
12	51564083	51564391	MACS_peak_4297	84.54	308	0	0	0	intergen
12	51624344	51624640	MACS_peak_4298	62.38	296	0	1	0	gen
12	51678138	51678420	MACS_peak_4299	450.7	282	0	1	0	gen
12	51823996	51824266	MACS_peak_4300	460.86	270	0	1	1	gen
12	51894954	51895192	MACS_peak_4301	502.51	238	0	0	0	intergen
12	51926784	51927023	MACS_peak_4302	516.86	239	0	0	0	intergen
12	52083459	52083797	MACS_peak_4303	539.27	338	1	0	0	promoter
12	52084023	52084390	MACS_peak_4304	312.33	367	1	0	0	promoter
12	52116493	52116934	MACS_peak_4305	634.13	441	0	0	0	intergen
12	52121911	52122155	MACS_peak_4306	501.16	244	0	0	0	intergen
12	52139572	52139800	MACS_peak_4307	548.55	228	0	0	0	intergen
12	52156658	52156998	MACS_peak_4308	787.9	340	0	0	0	intergen
12	52213416	52213777	MACS_peak_4309	646.13	361	0	0	1	other
12	52327556	52327841	MACS_peak_4310	451.52	285	0	0	0	intergen
12	52372636	52372989	MACS_peak_4311	651.52	353	0	0	0	intergen
12	52380174	52380442	MACS_peak_4312	587.27	268	1	0	0	promoter
12	52507021	52507391	MACS_peak_4313	520.65	370	0	0	0	intergen
12	52667551	52667763	MACS_peak_4314	763.02	212	0	0	0	intergen
12	52692361	52692578	MACS_peak_4315	580.62	217	1	0	0	promoter
12	52865462	52865740	MACS_peak_4316	411.21	278	0	0	0	intergen
12	52879784	52880263	MACS_peak_4317	1211.29	479	0	0	0	intergen
12	52884821	52885078	MACS_peak_4318	506.92	257	0	0	0	intergen
12	52894544	52894680	MACS_peak_4319	664.91	136	1	0	0	promoter
12	53053668	53053937	MACS_peak_4321	717.14	269	0	1	1	gen
12	53061796	53062031	MACS_peak_4322	972.07	235	1	1	0	promoter
12	53099445	53099820	MACS_peak_4323	1156.51	375	2	0	0	promoter
12	53421346	53421634	MACS_peak_4324	378.95	288	1	0	0	promoter
12	53451767	53451969	MACS_peak_4325	989.9	202	1	0	1	promoter
12	53655229	53655450	MACS_peak_4326	564.54	221	0	1	0	gen
12	53676110	53676481	MACS_peak_4327	520.09	371	0	1	0	gen
12	53746672	53746985	MACS_peak_4328	435.38	313	0	0	0	intergen
12	53791585	53791943	MACS_peak_4329	527.43	358	0	0	0	intergen
12	54032585	54032854	MACS_peak_4330	852.62	269	1	2	1	promoter
12	54220087	54220430	MACS_peak_4331	1015.34	343	0	0	0	intergen
12	54399248	54399540	MACS_peak_4333	697.28	292	1	0	2	promoter
12	54579795	54580062	MACS_peak_4334	588.05	267	1	0	0	promoter
12	54603173	54603491	MACS_peak_4335	940.27	318	0	0	0	intergen
12	54622851	54623160	MACS_peak_4336	437.6	309	0	0	0	intergen
12	54623941	54624158	MACS_peak_4337	580.62	217	0	0	0	intergen
12	54723620	54723917	MACS_peak_4338	845.32	297	0	0	0	intergen
12	54749213	54749492	MACS_peak_4339	578.93	279	0	0	0	intergen
12	54790138	54790406	MACS_peak_4340	52.18	268	0	0	0	intergen
12	54851296	54851678	MACS_peak_4341	133.81	382	0	1	0	gen
12	54854040	54854360	MACS_peak_4342	404.16	320	0	1	0	gen
12	55072240	55072533	MACS_peak_4343	696.46	293	0	0	0	intergen
12	55073238	55073463	MACS_peak_4344	712.32	225	0	0	0	intergen
12	55085188	55085489	MACS_peak_4346	63.29	301	0	0	0	intergen
12	55099537	55099939	MACS_peak_4347	141.38	402	0	0	0	intergen
12	55163640	55163935	MACS_peak_4349	81.3	295	0	0	0	intergen
12	55213995	55214311	MACS_peak_4350	90.85	316	0	0	0	intergen
12	55214862	55215194	MACS_peak_4351	115.17	332	0	0	0	intergen
12	55301298	55301514	MACS_peak_4352	241.38	216	0	0	0	intergen
12	55486216	55486510	MACS_peak_4355	63.92	294	0	0	1	other
12	55488463	55488770	MACS_peak_4356	65.09	307	1	0	1	promoter
12	55564795	55565092	MACS_peak_4357	122.27	297	0	0	1	other
12	55656332	55656700	MACS_peak_4358	407.64	368	0	0	1	other
12	55737207	55737476	MACS_peak_4359	842.54	269	0	0	0	intergen
12	55928417	55928713	MACS_peak_4360	603.02	296	1	1	0	promoter
12	55996154	55996384	MACS_peak_4361	532.66	230	1	1	0	promoter
12	56052156	56052459	MACS_peak_4362	363.26	303	0	0	0	intergen
12	56126130	56126433	MACS_peak_4363	561.84	303	0	2	1	gen
12	56148897	56149030	MACS_peak_4364	843.09	133	1	0	0	promoter
12	56192934	56193259	MACS_peak_4365	1030.29	325	0	0	0	intergen
12	56271096	56271453	MACS_peak_4366	528	357	2	0	0	promoter
12	56302337	56302688	MACS_peak_4367	345.59	351	0	1	1	gen
12	56464390	56464578	MACS_peak_4368	810.91	188	1	2	0	promoter
12	56496626	56496927	MACS_peak_4369	678.21	301	0	0	0	intergen
12	56501207	56501571	MACS_peak_4370	737.12	364	0	0	0	intergen
12	56513768	56514037	MACS_peak_4371	550.78	269	0	0	0	intergen
12	56573350	56573687	MACS_peak_4372	608.91	337	0	1	0	gen
12	56594184	56594437	MACS_peak_4373	470.06	253	1	1	0	promoter
12	56636801	56637183	MACS_peak_4374	312.33	382	1	0	0	promoter
12	56757517	56757851	MACS_peak_4375	1102.09	334	0	1	0	gen
12	56822038	56822287	MACS_peak_4376	388.7	249	0	0	0	intergen
12	56970176	56970573	MACS_peak_4377	168.52	397	0	0	0	intergen
12	56971449	56971778	MACS_peak_4378	149.22	329	0	0	0	intergen
12	56973099	56973398	MACS_peak_4379	147.3	299	0	0	0	intergen
12	57102760	57103015	MACS_peak_4380	283.13	255	0	1	0	gen
12	57124316	57124539	MACS_peak_4381	564.54	223	1	1	0	promoter
12	57213235	57213685	MACS_peak_4382	2233.18	450	1	0	0	promoter
12	57239078	57239388	MACS_peak_4383	557.12	310	2	0	0	promoter
12	57650754	57651104	MACS_peak_4385	133.58	350	0	0	0	intergen
12	57735954	57736157	MACS_peak_4386	629.38	203	1	1	0	promoter
12	57803248	57803594	MACS_peak_4387	637.77	346	0	2	0	gen
12	57831414	57831744	MACS_peak_4388	426.3	330	0	1	0	gen
12	57905414	57905800	MACS_peak_4389	630.05	386	1	0	0	promoter
12	57983255	57983423	MACS_peak_4390	1228.09	168	0	0	0	intergen
12	58060861	58061277	MACS_peak_4391	107.41	416	0	0	0	intergen
12	58105865	58106095	MACS_peak_4392	587.86	230	0	0	0	intergen
12	58189807	58190040	MACS_peak_4393	532.66	233	0	0	0	intergen
12	58334978	58335193	MACS_peak_4395	444.56	215	0	0	0	intergen
12	58346012	58346375	MACS_peak_4396	899.21	363	0	0	0	intergen
12	58683329	58683645	MACS_peak_4397	433.75	316	0	0	2	other
12	58705381	58705660	MACS_peak_4398	137.17	279	0	0	2	other
12	59150132	59150346	MACS_peak_4399	730.51	214	0	0	0	intergen
12	59226196	59226524	MACS_peak_4401	75.63	328	0	0	0	intergen
12	59233618	59233949	MACS_peak_4402	488.85	331	0	0	0	intergen
12	59479540	59479960	MACS_peak_4404	61.72	420	0	0	0	intergen
12	59764628	59765061	MACS_peak_4405	118	433	0	1	0	gen
12	59808324	59808739	MACS_peak_4406	612.69	415	0	0	0	intergen
12	59872653	59872866	MACS_peak_4407	596.79	213	0	0	0	intergen
12	60009193	60009590	MACS_peak_4408	110.46	397	0	0	0	intergen
12	60117442	60117767	MACS_peak_4409	650.55	325	0	0	0	intergen
12	60434025	60434244	MACS_peak_4410	309.28	219	0	0	0	intergen
12	60728017	60728399	MACS_peak_4412	133.81	382	0	0	0	intergen
12	60764355	60764783	MACS_peak_4414	101.68	428	0	0	0	intergen
12	60810538	60810840	MACS_peak_4415	238.69	302	0	0	0	intergen
12	61046967	61047189	MACS_peak_4416	348.8	222	0	0	0	intergen
12	61134915	61135287	MACS_peak_4417	62.38	372	0	0	0	intergen
12	61297465	61297841	MACS_peak_4418	81.98	376	0	0	0	intergen
12	61322088	61322384	MACS_peak_4419	184.32	296	0	0	0	intergen
12	61415940	61416216	MACS_peak_4420	117.61	276	0	0	0	intergen
12	61471714	61472077	MACS_peak_4421	314.6	363	0	0	0	intergen
12	61475014	61475425	MACS_peak_4422	60	411	0	0	0	intergen
12	61510228	61510469	MACS_peak_4423	765.62	241	0	0	0	intergen
12	61672362	61672699	MACS_peak_4424	103.45	337	0	0	0	intergen
12	61672742	61672980	MACS_peak_4425	223.38	238	0	0	0	intergen
12	61747397	61747726	MACS_peak_4426	154.82	329	0	1	0	gen
12	61943655	61944079	MACS_peak_4427	76.2	424	0	1	0	gen
12	61946401	61946845	MACS_peak_4428	167.72	444	0	1	0	gen
12	61979838	61980104	MACS_peak_4429	476.19	266	0	1	0	gen
12	62112497	62112811	MACS_peak_4430	265.34	314	0	1	0	gen
12	62195700	62195930	MACS_peak_4431	762.11	230	0	1	0	gen
12	62202717	62203097	MACS_peak_4432	402.16	380	0	1	0	gen
12	62288764	62288969	MACS_peak_4433	797.18	205	0	1	0	gen
12	62435756	62435988	MACS_peak_4434	831.63	232	0	0	0	intergen
12	62438168	62438388	MACS_peak_4435	541.39	220	0	0	0	intergen
12	62581832	62582063	MACS_peak_4436	678.9	231	0	1	0	gen
12	62616300	62616562	MACS_peak_4437	466.05	262	0	0	1	other
12	62794078	62794373	MACS_peak_4438	567.38	295	0	1	0	gen
12	62799218	62799519	MACS_peak_4439	1386.14	301	0	1	0	gen
12	62817106	62817268	MACS_peak_4440	782.87	162	0	1	0	gen
12	63103567	63103939	MACS_peak_4441	519.54	372	0	0	0	intergen
12	63319353	63319659	MACS_peak_4442	439.28	306	0	0	1	other
12	63503225	63503523	MACS_peak_4443	380.3	298	0	0	0	intergen
12	63517418	63517720	MACS_peak_4444	428.26	302	0	0	0	intergen
12	63577759	63578033	MACS_peak_4445	603.02	274	0	1	0	gen
12	63672588	63672888	MACS_peak_4446	1069.92	300	0	0	1	other
12	63710872	63711099	MACS_peak_4447	295.59	227	0	0	2	other
12	63753827	63754085	MACS_peak_4448	397.64	258	0	0	1	other
12	63825975	63826339	MACS_peak_4449	506.92	364	0	0	0	intergen
12	63855338	63855600	MACS_peak_4450	372.35	262	0	1	0	gen
12	63867898	63868203	MACS_peak_4451	592.77	305	0	1	0	gen
12	63947494	63947850	MACS_peak_4452	512.71	356	0	1	0	gen
12	63956465	63956663	MACS_peak_4453	808.21	198	0	1	0	gen
12	64032991	64033351	MACS_peak_4454	510.42	360	0	1	0	gen
12	64140751	64141186	MACS_peak_4455	100.95	435	0	1	0	gen
12	64192042	64192175	MACS_peak_4456	846.38	133	0	1	0	gen
12	64273802	64274107	MACS_peak_4457	439.84	305	0	1	1	gen
12	64289436	64289849	MACS_peak_4459	69.92	413	0	1	1	gen
12	64291507	64291969	MACS_peak_4460	55.68	462	0	1	1	gen
12	64367111	64367379	MACS_peak_4462	377.04	268	0	1	1	gen
12	64499027	64499167	MACS_peak_4463	1752.27	140	0	1	0	gen
12	64608187	64608470	MACS_peak_4464	575.98	283	0	1	1	gen
12	64698071	64698301	MACS_peak_4465	989.9	230	0	0	0	intergen
12	64796301	64796569	MACS_peak_4466	462.14	268	0	1	0	gen
12	65107057	65107276	MACS_peak_4467	710.43	219	0	1	0	gen
12	65123356	65123783	MACS_peak_4468	605.87	427	0	0	0	intergen
12	65306603	65306809	MACS_peak_4469	629.38	206	0	1	0	gen
12	65351305	65351656	MACS_peak_4470	87.12	351	0	1	0	gen
12	65352473	65352755	MACS_peak_4471	103.45	282	0	1	0	gen
12	65551484	65551814	MACS_peak_4473	70.12	330	0	0	1	other
12	65553844	65554276	MACS_peak_4474	91.19	432	0	0	1	other
12	65685428	65685863	MACS_peak_4475	583.01	435	0	0	0	intergen
12	65705705	65706015	MACS_peak_4476	437.04	310	0	0	0	intergen
12	66057474	66057687	MACS_peak_4477	2551.88	213	0	0	0	intergen
12	66087404	66087662	MACS_peak_4478	627.45	258	0	0	0	intergen
12	66096985	66097414	MACS_peak_4479	63.8	429	0	0	0	intergen
12	66222425	66222665	MACS_peak_4480	468.75	240	0	1	0	gen
12	66269906	66270122	MACS_peak_4481	746.04	216	0	0	0	intergen
12	66279239	66279534	MACS_peak_4482	488.85	295	0	0	0	intergen
12	66523872	66524232	MACS_peak_4483	52.4	360	0	1	0	gen
12	66580581	66580952	MACS_peak_4484	115.17	371	0	1	0	gen
12	66736250	66736493	MACS_peak_4485	119.29	243	0	1	0	gen
12	66856341	66856714	MACS_peak_4486	82.93	373	0	1	0	gen
12	66861280	66861435	MACS_peak_4487	827.31	155	0	1	0	gen
12	67415607	67415894	MACS_peak_4488	573.07	287	0	0	0	intergen
12	67432616	67432849	MACS_peak_4489	678.9	233	0	0	0	intergen
12	67441883	67442082	MACS_peak_4490	831.63	199	0	0	1	other
12	67844237	67844549	MACS_peak_4491	78.93	312	0	0	0	intergen
12	67849992	67850177	MACS_peak_4492	321.76	185	0	0	0	intergen
12	67857985	67858282	MACS_peak_4493	444.41	297	0	0	0	intergen
12	67904293	67904708	MACS_peak_4494	130.43	415	0	0	0	intergen
12	67943398	67943691	MACS_peak_4495	696.46	293	0	0	1	other
12	68001470	68001852	MACS_peak_4497	1428.08	382	0	0	1	other
12	68040561	68040875	MACS_peak_4498	809.85	314	0	0	1	other
12	68085439	68085635	MACS_peak_4499	662.31	196	0	0	1	other
12	68158503	68158756	MACS_peak_4500	596.79	253	1	0	1	promoter
12	68195658	68195822	MACS_peak_4501	972.46	164	0	0	1	other
12	68334157	68334401	MACS_peak_4502	1054.55	244	0	0	1	other
12	68398587	68398970	MACS_peak_4503	133.45	383	0	0	1	other
12	68711530	68711663	MACS_peak_4504	811.9	133	0	1	0	gen
12	68766482	68766614	MACS_peak_4505	977.06	132	0	1	0	gen
12	68830324	68830614	MACS_peak_4506	418.87	290	0	1	0	gen
12	68833044	68833394	MACS_peak_4507	304.28	350	0	1	0	gen
12	68989559	68989884	MACS_peak_4508	358.75	325	0	0	0	intergen
12	68993062	68993425	MACS_peak_4509	66.71	363	0	0	0	intergen
12	68996181	68996458	MACS_peak_4510	95.88	277	0	0	0	intergen
12	69154671	69155016	MACS_peak_4511	535.04	345	0	0	0	intergen
12	69282504	69282877	MACS_peak_4514	510.43	373	0	0	0	intergen
12	69291065	69291324	MACS_peak_4515	594.37	259	0	0	0	intergen
12	69541203	69541379	MACS_peak_4517	972.07	176	0	1	0	gen
12	69570887	69571140	MACS_peak_4518	746.04	253	0	1	0	gen
12	69604166	69604548	MACS_peak_4519	198.77	382	1	0	0	promoter
12	69639532	69639808	MACS_peak_4520	457.06	276	1	0	0	promoter
12	69664965	69665401	MACS_peak_4521	1099.47	436	0	1	0	gen
12	69798391	69798768	MACS_peak_4522	88.13	377	1	1	0	promoter
12	69846664	69846982	MACS_peak_4523	93.4	318	0	2	0	gen
12	69862241	69862540	MACS_peak_4524	74.8	299	0	1	0	gen
12	69943272	69943594	MACS_peak_4525	88.56	322	0	1	1	gen
12	70018126	70018568	MACS_peak_4527	126.47	442	0	0	1	other
12	70023053	70023267	MACS_peak_4528	561.02	214	0	0	1	other
12	70590028	70590322	MACS_peak_4529	625.23	294	0	1	0	gen
12	70630868	70631244	MACS_peak_4530	115.9	376	0	1	0	gen
12	70692790	70693091	MACS_peak_4531	442.11	301	0	1	0	gen
12	70719900	70720139	MACS_peak_4532	793.19	239	0	1	0	gen
12	70733462	70733713	MACS_peak_4533	1189.9	251	0	1	0	gen
12	71098763	71099137	MACS_peak_4535	62.77	374	0	0	2	other
12	71121945	71122309	MACS_peak_4539	96.08	364	1	0	0	promoter
12	71123156	71123440	MACS_peak_4540	92.79	284	1	0	0	promoter
12	71217055	71217379	MACS_peak_4541	672.17	324	0	1	0	gen
12	71392661	71392840	MACS_peak_4542	954.29	179	0	1	0	gen
12	71508054	71508187	MACS_peak_4543	1229.93	133	0	1	0	gen
12	71551612	71551910	MACS_peak_4544	960.47	298	0	1	0	gen
12	71636707	71637023	MACS_peak_4545	553.16	316	0	1	0	gen
12	71747109	71747375	MACS_peak_4546	463.44	266	0	0	0	intergen
12	71780232	71780486	MACS_peak_4547	596.79	254	0	1	0	gen
12	71992708	71993023	MACS_peak_4548	634.13	315	0	1	0	gen
12	72017177	72017521	MACS_peak_4549	348.97	344	0	1	0	gen
12	72372303	72372750	MACS_peak_4550	100.69	447	0	1	0	gen
12	72446504	72446876	MACS_peak_4551	117.31	372	0	1	0	gen
12	72515284	72515614	MACS_peak_4552	70.12	330	0	1	0	gen
12	72517641	72518024	MACS_peak_4553	56.37	383	0	1	0	gen
12	72771609	72772003	MACS_peak_4554	625.13	394	0	0	0	intergen
12	72966257	72966506	MACS_peak_4555	319.1	249	0	0	0	intergen
12	73148569	73148966	MACS_peak_4556	57.73	397	0	0	0	intergen
12	73149764	73150070	MACS_peak_4557	93.37	306	0	0	0	intergen
12	73151429	73151702	MACS_peak_4558	161.37	273	0	0	0	intergen
12	73197035	73197375	MACS_peak_4559	91.49	340	0	0	1	other
12	73400375	73400648	MACS_peak_4562	150.28	273	0	0	0	intergen
12	73608865	73609167	MACS_peak_4563	198.49	302	0	0	0	intergen
12	73706380	73706566	MACS_peak_4564	858.56	186	0	0	0	intergen
12	73821626	73821994	MACS_peak_4565	407.64	368	0	0	0	intergen
12	73853174	73853498	MACS_peak_4566	202.06	324	0	0	0	intergen
12	73935030	73935259	MACS_peak_4567	668.89	229	0	0	0	intergen
12	73982409	73982756	MACS_peak_4568	81.13	347	0	0	0	intergen
12	73983194	73983648	MACS_peak_4569	153.28	454	0	0	0	intergen
12	74021186	74021429	MACS_peak_4570	634	243	0	0	0	intergen
12	74085324	74085552	MACS_peak_4571	635.07	228	0	0	0	intergen
12	74415732	74415944	MACS_peak_4573	698.01	212	0	0	0	intergen
12	74621071	74621278	MACS_peak_4575	596.67	207	0	0	0	intergen
12	74803338	74803760	MACS_peak_4576	772.82	422	0	0	0	intergen
12	74947752	74947998	MACS_peak_4577	977.68	246	0	0	0	intergen
12	75201163	75201389	MACS_peak_4578	423.66	226	0	1	0	gen
12	75390885	75391277	MACS_peak_4579	626.35	392	1	0	0	promoter
12	75402170	75402448	MACS_peak_4580	579.67	278	0	1	0	gen
12	75485229	75485683	MACS_peak_4581	637.93	454	0	0	1	other
12	75505870	75506085	MACS_peak_4582	1079.97	215	0	1	0	gen
12	75520283	75520506	MACS_peak_4583	122.15	223	0	0	0	intergen
12	75567386	75567672	MACS_peak_4584	835.66	286	0	0	1	other
12	76231337	76231555	MACS_peak_4587	879.27	218	0	0	0	intergen
12	76300005	76300255	MACS_peak_4588	485.56	250	0	0	1	other
12	76322410	76322879	MACS_peak_4589	94.4	469	0	0	0	intergen
12	76325332	76325709	MACS_peak_4590	125.1	377	0	0	0	intergen
12	76455759	76456028	MACS_peak_4591	461.5	269	0	1	0	gen
12	76472971	76473257	MACS_peak_4592	229.83	286	0	1	0	gen
12	76586890	76587100	MACS_peak_4593	613.04	210	0	0	1	other
12	76621518	76621789	MACS_peak_4594	850.57	271	0	0	0	intergen
12	76760533	76760803	MACS_peak_4596	488.89	270	1	0	0	promoter
12	76790944	76791350	MACS_peak_4597	668.24	406	0	1	0	gen
12	76821022	76821174	MACS_peak_4598	918.92	152	0	1	0	gen
12	76978662	76978893	MACS_peak_4599	532.66	231	0	0	0	intergen
12	77049658	77050030	MACS_peak_4600	519.54	372	0	1	0	gen
12	77669920	77670196	MACS_peak_4603	710.92	276	0	1	0	gen
12	77708307	77708723	MACS_peak_4604	116.81	416	0	1	0	gen
12	77720414	77720703	MACS_peak_4605	449.12	289	0	1	0	gen
12	77724396	77724753	MACS_peak_4606	904.37	357	0	1	0	gen
12	77925660	77926027	MACS_peak_4607	766.87	367	0	1	0	gen
12	78181472	78181863	MACS_peak_4608	509.31	391	0	1	0	gen
12	78319913	78320205	MACS_peak_4609	406.81	292	0	0	0	intergen
12	78470673	78470829	MACS_peak_4610	901.33	156	0	0	2	other
12	78671997	78672371	MACS_peak_4611	502.59	374	0	0	0	intergen
12	78841428	78841594	MACS_peak_4612	402.49	166	0	0	0	intergen
12	78876614	78877042	MACS_peak_4613	950.42	428	0	1	0	gen
12	78929306	78929532	MACS_peak_4614	696.63	226	0	1	0	gen
12	79039852	79040230	MACS_peak_4615	95.55	378	0	1	1	gen
12	79042829	79043253	MACS_peak_4616	73.72	424	0	1	1	gen
12	79044210	79044609	MACS_peak_4617	81.67	399	0	1	1	gen
12	79105773	79105916	MACS_peak_4619	1061.17	143	0	1	0	gen
12	79230847	79231093	MACS_peak_4620	763.02	246	0	1	0	gen
12	79320542	79320915	MACS_peak_4621	638.28	373	0	1	0	gen
12	79373954	79374218	MACS_peak_4622	393.73	264	0	1	1	gen
12	79541007	79541372	MACS_peak_4623	127.5	365	0	0	1	other
12	79547877	79548153	MACS_peak_4624	351.38	276	0	0	1	other
12	79555587	79555835	MACS_peak_4625	763.02	248	0	0	0	intergen
12	79814375	79814617	MACS_peak_4626	276.36	242	0	1	0	gen
12	79874436	79874818	MACS_peak_4627	401.26	382	0	1	0	gen
12	79886978	79887174	MACS_peak_4628	848.95	196	0	1	0	gen
12	80110056	80110319	MACS_peak_4629	265.34	263	0	1	0	gen
12	80125107	80125442	MACS_peak_4630	75.73	335	0	1	0	gen
12	80148274	80148621	MACS_peak_4632	152.22	347	0	1	0	gen
12	80195130	80195557	MACS_peak_4633	439.97	427	0	1	0	gen
12	80244799	80245180	MACS_peak_4634	105.63	381	0	1	0	gen
12	80245527	80245894	MACS_peak_4635	65.51	367	0	1	0	gen
12	80247599	80247975	MACS_peak_4636	55.72	376	0	1	0	gen
12	80248748	80249068	MACS_peak_4637	50.07	320	0	1	0	gen
12	80330279	80330702	MACS_peak_4638	603.02	423	0	1	0	gen
12	80412435	80412697	MACS_peak_4639	859.93	262	0	1	0	gen
12	80451062	80451392	MACS_peak_4640	105.65	330	0	1	0	gen
12	80478943	80479406	MACS_peak_4642	91.83	463	0	1	0	gen
12	80540218	80540441	MACS_peak_4643	1208.41	223	0	1	0	gen
12	80561636	80561863	MACS_peak_4644	848.95	227	0	1	0	gen
12	80607891	80608255	MACS_peak_4645	644.14	364	0	1	0	gen
12	80632935	80633181	MACS_peak_4646	485.56	246	0	1	0	gen
12	80691547	80691795	MACS_peak_4647	613.04	248	0	0	0	intergen
12	80837457	80837650	MACS_peak_4648	1043.77	193	0	1	0	gen
12	80877112	80877245	MACS_peak_4649	1011.74	133	0	1	0	gen
12	80946702	80946888	MACS_peak_4650	712.32	186	0	1	0	gen
12	81048177	81048477	MACS_peak_4651	246.48	300	0	1	0	gen
12	81087885	81088076	MACS_peak_4652	752.16	191	0	1	0	gen
12	81129016	81129318	MACS_peak_4653	778.75	302	0	1	0	gen
12	81135129	81135348	MACS_peak_4654	420.03	219	0	1	0	gen
12	81241463	81241839	MACS_peak_4655	91.55	376	0	1	0	gen
12	81257965	81258307	MACS_peak_4656	536.84	342	1	1	0	promoter
12	81268136	81268496	MACS_peak_4657	201.59	360	0	1	0	gen
12	81268605	81269006	MACS_peak_4658	811.34	401	0	1	0	gen
12	81477352	81477668	MACS_peak_4659	538.57	316	0	1	0	gen
12	81494158	81494526	MACS_peak_4660	78.48	368	0	1	0	gen
12	81497521	81497674	MACS_peak_4661	1467.3	153	0	1	0	gen
12	81584757	81585108	MACS_peak_4662	1043.91	351	0	1	0	gen
12	81672844	81673145	MACS_peak_4664	689.95	301	0	1	0	gen
12	81707323	81707762	MACS_peak_4665	160.34	439	0	1	0	gen
12	81906802	81907184	MACS_peak_4666	471.51	382	0	0	0	intergen
12	82304683	82305055	MACS_peak_4667	96.04	372	0	1	0	gen
12	82313470	82313806	MACS_peak_4668	180.31	336	0	1	0	gen
12	82358633	82359018	MACS_peak_4669	1284.13	385	1	0	0	promoter
12	82423231	82423555	MACS_peak_4670	126.91	324	0	1	0	gen
12	82493421	82493852	MACS_peak_4671	164.06	431	0	0	1	other
12	82527185	82527446	MACS_peak_4672	453.37	261	0	0	0	intergen
12	82627986	82628206	MACS_peak_4673	738.35	220	0	0	0	intergen
12	82670761	82671087	MACS_peak_4675	799.5	326	0	0	0	intergen
12	82959831	82960116	MACS_peak_4676	893.74	285	0	1	0	gen
12	83004623	83004856	MACS_peak_4677	267.95	233	0	1	0	gen
12	83059002	83059225	MACS_peak_4678	564.54	223	0	1	0	gen
12	83402743	83403014	MACS_peak_4679	130.87	271	0	0	0	intergen
12	83551665	83551990	MACS_peak_4680	99.8	325	0	0	0	intergen
12	83588425	83588772	MACS_peak_4681	85.43	347	0	0	0	intergen
12	83594700	83594993	MACS_peak_4682	114.74	293	0	0	0	intergen
12	83777077	83777376	MACS_peak_4683	243.49	299	0	0	0	intergen
12	83823656	83824022	MACS_peak_4684	488.85	366	0	0	0	intergen
12	83830719	83831176	MACS_peak_4685	289.99	457	0	0	0	intergen
12	83831766	83832040	MACS_peak_4686	159.79	274	0	0	0	intergen
12	84006228	84006521	MACS_peak_4687	165.91	293	0	0	0	intergen
12	84044553	84044917	MACS_peak_4688	409.51	364	0	0	0	intergen
12	84100964	84101379	MACS_peak_4689	188.29	415	0	0	0	intergen
12	84334285	84334548	MACS_peak_4690	722.6	263	0	0	0	intergen
12	84397390	84397599	MACS_peak_4691	460.69	209	0	0	0	intergen
12	84400622	84401049	MACS_peak_4692	1078.18	427	0	0	0	intergen
12	84521521	84521731	MACS_peak_4693	613.04	210	0	0	0	intergen
12	84842499	84842884	MACS_peak_4694	512.49	385	0	0	0	intergen
12	84874548	84874858	MACS_peak_4695	437.04	310	0	1	0	gen
12	85176334	85176641	MACS_peak_4696	194.47	307	0	1	0	gen
12	85192418	85192641	MACS_peak_4697	433.85	223	0	1	0	gen
12	85192837	85193073	MACS_peak_4698	307.16	236	0	1	0	gen
12	85197832	85198134	MACS_peak_4699	459.57	302	0	1	0	gen
12	85227034	85227390	MACS_peak_4700	174.89	356	0	1	0	gen
12	85250786	85251024	MACS_peak_4701	1116.4	238	0	1	0	gen
12	85310611	85310820	MACS_peak_4702	301.54	209	0	0	0	intergen
12	85313332	85313650	MACS_peak_4703	61.31	318	0	0	0	intergen
12	85433539	85433808	MACS_peak_4705	127.5	269	0	0	0	intergen
12	85450444	85450736	MACS_peak_4706	447.34	292	0	0	0	intergen
12	85788416	85788789	MACS_peak_4707	52.77	373	0	0	0	intergen
12	85903359	85903491	MACS_peak_4708	1116.4	132	0	0	0	intergen
12	85951934	85952288	MACS_peak_4709	906.99	354	1	0	0	promoter
12	85978173	85978390	MACS_peak_4710	746.04	217	0	1	0	gen
12	86167760	86168010	MACS_peak_4711	854.58	250	0	1	0	gen
12	86230452	86230731	MACS_peak_4712	455.19	279	0	1	0	gen
12	86345729	86346067	MACS_peak_4713	93.4	338	0	1	0	gen
12	86539182	86539527	MACS_peak_4714	174.47	345	0	1	0	gen
12	86586536	86586897	MACS_peak_4715	90.07	361	0	1	0	gen
12	86640452	86640792	MACS_peak_4716	164.26	340	0	1	1	gen
12	86859344	86859541	MACS_peak_4718	124.81	197	0	0	0	intergen
12	86947553	86947776	MACS_peak_4719	731.53	223	0	0	0	intergen
12	86990869	86991179	MACS_peak_4720	437.04	310	0	0	0	intergen
12	87101512	87101786	MACS_peak_4721	118.58	274	0	0	0	intergen
12	87103192	87103585	MACS_peak_4722	142.26	393	0	0	0	intergen
12	87266237	87266535	MACS_peak_4723	443.84	298	0	0	0	intergen
12	87315525	87315773	MACS_peak_4724	85.32	248	0	0	0	intergen
12	87398280	87398639	MACS_peak_4725	103.45	359	0	0	0	intergen
12	87582895	87583324	MACS_peak_4726	76.74	429	0	0	0	intergen
12	87632470	87632828	MACS_peak_4727	74.7	358	0	0	0	intergen
12	87634413	87634674	MACS_peak_4728	464.99	261	0	0	0	intergen
12	87683072	87683340	MACS_peak_4729	105.69	268	0	0	0	intergen
12	87699301	87699613	MACS_peak_4730	127.5	312	0	0	0	intergen
12	87751482	87751819	MACS_peak_4731	57.18	337	0	0	0	intergen
12	87913448	87913796	MACS_peak_4732	113.12	348	0	0	0	intergen
12	87972611	87972993	MACS_peak_4733	94.4	382	0	0	0	intergen
12	87973609	87974053	MACS_peak_4734	54.21	444	0	0	0	intergen
12	87995564	87996016	MACS_peak_4735	479.66	452	0	1	0	gen
12	88215334	88215558	MACS_peak_4736	555.36	224	0	0	0	intergen
12	88403193	88403491	MACS_peak_4737	172.31	298	0	0	0	intergen
12	88404886	88405230	MACS_peak_4738	92.72	344	0	0	0	intergen
12	88405386	88405613	MACS_peak_4739	164.16	227	0	0	0	intergen
12	88429260	88429555	MACS_peak_4740	611.86	295	0	0	0	intergen
12	88633366	88633590	MACS_peak_4742	866.35	224	0	0	0	intergen
12	88712723	88713079	MACS_peak_4743	77.76	356	0	0	0	intergen
12	88713438	88713685	MACS_peak_4744	74.17	247	0	0	0	intergen
12	88851587	88851938	MACS_peak_4745	96.93	351	0	0	0	intergen
12	88852092	88852457	MACS_peak_4746	84.4	365	0	0	0	intergen
12	88852503	88852819	MACS_peak_4747	204	316	0	0	0	intergen
12	88926036	88926351	MACS_peak_4748	1991.53	315	0	0	0	intergen
12	88939536	88939768	MACS_peak_4749	230.05	232	0	0	0	intergen
12	89459403	89459687	MACS_peak_4750	600.96	284	0	1	0	gen
12	89521999	89522280	MACS_peak_4751	1120.76	281	2	1	0	promoter
12	89529686	89530080	MACS_peak_4752	747.36	394	0	0	1	other
12	89697557	89697689	MACS_peak_4753	1116.4	132	0	1	0	gen
12	90092477	90092785	MACS_peak_4755	438.15	308	0	0	0	intergen
12	90093695	90094072	MACS_peak_4756	403.51	377	0	0	0	intergen
12	90452667	90452876	MACS_peak_4757	214.68	209	0	0	0	intergen
12	90541233	90541513	MACS_peak_4758	87.51	280	0	0	0	intergen
12	90909068	90909445	MACS_peak_4759	403.51	377	1	0	0	promoter
12	90944998	90945361	MACS_peak_4760	524.58	363	0	1	1	gen
12	90978254	90978455	MACS_peak_4761	1377.21	201	0	1	0	gen
12	91234997	91235304	MACS_peak_4762	158.81	307	0	0	0	intergen
12	91326504	91326782	MACS_peak_4763	455.81	278	0	0	0	intergen
12	91463410	91463577	MACS_peak_4764	793.98	167	0	0	0	intergen
12	91520130	91520390	MACS_peak_4765	157.73	260	0	0	0	intergen
12	91550059	91550432	MACS_peak_4766	405.33	373	0	0	0	intergen
12	92016070	92016415	MACS_peak_4767	102.66	345	0	0	1	other
12	92017047	92017216	MACS_peak_4768	296.3	169	0	0	1	other
12	92314774	92315074	MACS_peak_4769	54.69	300	0	0	1	other
12	92678807	92679023	MACS_peak_4771	153.92	216	0	0	0	intergen
12	92827815	92828125	MACS_peak_4772	437.04	310	0	1	0	gen
12	92921269	92921499	MACS_peak_4773	148.51	230	0	1	0	gen
12	93182489	93182716	MACS_peak_4774	434.37	227	0	0	1	other
12	93396868	93397086	MACS_peak_4775	691.82	218	0	1	0	gen
12	93399264	93399572	MACS_peak_4776	307.98	308	0	1	0	gen
12	93410040	93410315	MACS_peak_4777	581.92	275	1	0	0	promoter
12	93569592	93569860	MACS_peak_4778	603.02	268	1	0	1	promoter
12	93735237	93735599	MACS_peak_4779	488.85	362	0	1	1	gen
12	93953153	93953603	MACS_peak_4780	689.87	450	0	0	0	intergen
12	94145609	94145919	MACS_peak_4781	541.17	310	1	0	0	promoter
12	94392313	94392729	MACS_peak_4782	107.41	416	0	1	0	gen
12	94485151	94485500	MACS_peak_4783	84.74	349	0	0	0	intergen
12	94508623	94508758	MACS_peak_4784	1079.97	135	0	0	0	intergen
12	94546134	94546536	MACS_peak_4785	720.68	402	0	0	0	intergen
12	94725835	94726103	MACS_peak_4786	587.27	268	0	0	0	intergen
12	94764300	94764587	MACS_peak_4787	601.95	287	0	0	0	intergen
12	95024059	95024330	MACS_peak_4788	460.22	271	1	0	0	promoter
12	95073652	95073958	MACS_peak_4789	685.97	306	1	0	0	promoter
12	95534444	95534709	MACS_peak_4791	464.09	265	0	1	0	gen
12	95543960	95544173	MACS_peak_4792	386.13	213	0	1	0	gen
12	95651910	95652128	MACS_peak_4793	710.43	218	0	0	1	other
12	95815693	95815931	MACS_peak_4794	516.86	238	0	0	2	other
12	95820168	95820500	MACS_peak_4795	620.49	332	0	0	2	other
12	95926419	95926788	MACS_peak_4796	109	369	0	1	0	gen
12	96152567	96152887	MACS_peak_4797	172.39	320	0	0	0	intergen
12	96215032	96215477	MACS_peak_4798	482.85	445	0	1	0	gen
12	96318354	96318759	MACS_peak_4799	101.23	405	0	1	0	gen
12	96321444	96321825	MACS_peak_4800	145.91	381	0	1	0	gen
12	96440834	96441032	MACS_peak_4801	214.05	198	0	0	1	other
12	96516731	96517066	MACS_peak_4802	421.09	335	0	1	0	gen
12	96578533	96578873	MACS_peak_4803	421.18	340	0	1	0	gen
12	96640842	96641181	MACS_peak_4804	79.62	339	0	1	0	gen
12	96641403	96641660	MACS_peak_4805	174.28	257	0	1	0	gen
12	96658148	96658428	MACS_peak_4806	454.58	280	0	1	0	gen
12	96826449	96826869	MACS_peak_4807	729.84	420	0	1	0	gen
12	96827697	96828024	MACS_peak_4808	427.87	327	0	1	0	gen
12	96916222	96916601	MACS_peak_4809	93.4	379	0	1	0	gen
12	96987067	96987213	MACS_peak_4810	1343.35	146	0	0	1	other
12	97089701	97090055	MACS_peak_4811	414.27	354	0	0	1	other
12	97192807	97192946	MACS_peak_4812	737.33	139	0	0	0	intergen
12	97319941	97320387	MACS_peak_4813	713.39	446	0	0	0	intergen
12	97404650	97405080	MACS_peak_4814	723.39	430	0	0	0	intergen
12	97604186	97604650	MACS_peak_4815	103.5	464	0	0	0	intergen
12	97652729	97653010	MACS_peak_4816	100.53	281	0	0	0	intergen
12	97723572	97723891	MACS_peak_4817	84.09	319	0	0	1	other
12	97729243	97729584	MACS_peak_4818	111.75	341	0	0	1	other
12	97879761	97880198	MACS_peak_4819	166.04	437	0	0	0	intergen
12	98516431	98516786	MACS_peak_4821	529.16	355	1	0	0	promoter
12	98572080	98572334	MACS_peak_4822	466.91	254	0	0	0	intergen
12	98630195	98630403	MACS_peak_4823	544.59	208	0	1	0	gen
12	98653934	98654221	MACS_peak_4824	379.53	287	0	1	0	gen
12	98743378	98743654	MACS_peak_4825	581.17	276	0	1	0	gen
12	98813135	98813395	MACS_peak_4826	467.38	260	0	1	0	gen
12	98998699	98999054	MACS_peak_4827	529.16	355	0	1	0	gen
12	99087722	99087958	MACS_peak_4828	814.37	236	0	1	0	gen
12	99326993	99327421	MACS_peak_4829	605.31	428	0	1	0	gen
12	99395758	99395943	MACS_peak_4830	712.32	185	0	1	0	gen
12	99465979	99466397	MACS_peak_4831	77.32	418	0	1	0	gen
12	99468052	99468308	MACS_peak_4832	209.62	256	0	1	0	gen
12	99473953	99474210	MACS_peak_4833	459.53	257	0	1	0	gen
12	99673084	99673330	MACS_peak_4834	523.04	246	0	1	0	gen
12	99929380	99929723	MACS_peak_4835	150.34	343	0	1	0	gen
12	99930427	99930862	MACS_peak_4836	83.81	435	0	1	0	gen
12	99970196	99970560	MACS_peak_4837	545.41	364	0	1	0	gen
12	100058526	100058846	MACS_peak_4838	431.58	320	0	1	0	gen
12	100322039	100322334	MACS_peak_4839	243.49	295	0	1	0	gen
12	100669005	100669237	MACS_peak_4840	831.63	232	0	0	0	intergen
12	100827962	100828206	MACS_peak_4841	780.06	244	0	1	0	gen
12	100877836	100878224	MACS_peak_4842	1280.92	388	0	1	0	gen
12	100889488	100889797	MACS_peak_4843	265.34	309	0	1	0	gen
12	101112796	101112996	MACS_peak_4844	628.77	200	0	1	0	gen
12	101264141	101264470	MACS_peak_4846	50.49	329	0	0	0	intergen
12	101413585	101413942	MACS_peak_4848	113.94	357	0	0	0	intergen
12	101490372	101490638	MACS_peak_4849	855.73	266	0	0	0	intergen
12	101601668	101601956	MACS_peak_4852	700.62	288	0	1	0	gen
12	101670119	101670301	MACS_peak_4853	729.14	182	0	1	0	gen
12	101759510	101759735	MACS_peak_4854	784.07	225	0	1	0	gen
12	101904317	101904691	MACS_peak_4855	272.05	374	0	1	0	gen
12	101999414	101999626	MACS_peak_4856	758.25	212	0	1	0	gen
12	102091392	102091527	MACS_peak_4857	702.09	135	0	1	0	gen
12	102095706	102095940	MACS_peak_4858	644.94	234	0	1	0	gen
12	102169977	102170234	MACS_peak_4859	595.98	257	0	1	0	gen
12	102175894	102176158	MACS_peak_4860	371.07	264	0	1	0	gen
12	102301152	102301341	MACS_peak_4861	695.57	189	0	0	1	other
12	102434283	102434715	MACS_peak_4862	249.17	432	0	1	1	gen
12	102484579	102484834	MACS_peak_4863	1611.03	255	0	0	0	intergen
12	102491885	102492229	MACS_peak_4864	127.5	344	0	0	0	intergen
12	102702590	102702830	MACS_peak_4865	516.86	240	0	0	0	intergen
12	102818957	102819261	MACS_peak_4866	395.95	304	0	0	1	other
12	102831009	102831300	MACS_peak_4867	122.82	291	0	0	0	intergen
12	102859562	102859928	MACS_peak_4869	61.12	366	0	1	0	gen
12	103022958	103023294	MACS_peak_4870	1198.18	336	0	0	0	intergen
12	103254907	103255067	MACS_peak_4871	794.58	160	0	1	0	gen
12	103326246	103326537	MACS_peak_4872	447.93	291	0	1	0	gen
12	103401543	103401766	MACS_peak_4873	556.17	223	0	1	0	gen
12	103437340	103437752	MACS_peak_4874	64.79	412	0	1	0	gen
12	103446124	103446317	MACS_peak_4875	619.53	193	0	1	0	gen
12	103548653	103548910	MACS_peak_4877	469.39	257	0	0	1	other
12	103575314	103575563	MACS_peak_4878	613.04	249	0	0	0	intergen
12	103632650	103632978	MACS_peak_4879	930.66	328	0	1	0	gen
12	103749335	103749710	MACS_peak_4880	538.37	375	0	1	1	gen
12	103759796	103760062	MACS_peak_4881	588.83	266	0	1	1	gen
12	103771343	103771686	MACS_peak_4882	419.68	343	1	0	0	promoter
12	103870546	103870779	MACS_peak_4883	532.66	233	0	0	1	other
12	104057726	104057974	MACS_peak_4884	485.56	248	0	1	0	gen
12	104294289	104294544	MACS_peak_4885	794.58	255	0	1	0	gen
12	104358434	104358700	MACS_peak_4886	450.1	266	0	0	0	intergen
12	104637293	104637484	MACS_peak_4887	305.19	191	0	1	0	gen
12	104900326	104900569	MACS_peak_4888	397.57	243	0	1	0	gen
12	105053089	105053389	MACS_peak_4889	442.68	300	0	2	0	gen
12	105248330	105248725	MACS_peak_4890	50.74	395	0	1	0	gen
12	105249936	105250301	MACS_peak_4891	108.46	365	0	1	0	gen
12	105250512	105250893	MACS_peak_4892	84.4	381	0	1	0	gen
12	105275153	105275479	MACS_peak_4893	102.79	326	0	1	0	gen
12	105515181	105515488	MACS_peak_4894	88.7	307	0	0	0	intergen
12	105629808	105630134	MACS_peak_4895	102.96	326	0	0	0	intergen
12	105630471	105630763	MACS_peak_4896	51.02	292	0	0	0	intergen
12	105694350	105694546	MACS_peak_4898	848.95	196	0	0	0	intergen
12	105772724	105772858	MACS_peak_4899	870.46	134	0	0	0	intergen
12	105778888	105779217	MACS_peak_4901	81.15	329	0	0	0	intergen
12	105779344	105779808	MACS_peak_4902	52.57	464	0	0	0	intergen
12	106261573	106261828	MACS_peak_4903	866.35	255	0	1	0	gen
12	106357387	106357752	MACS_peak_4904	409.04	365	1	0	0	promoter
12	106472038	106472302	MACS_peak_4905	125.63	264	0	1	0	gen
12	106473360	106473777	MACS_peak_4906	82.72	417	0	1	0	gen
12	106778355	106778590	MACS_peak_4908	847.1	235	1	0	0	promoter
12	107048403	107048661	MACS_peak_4909	1005.37	258	0	1	0	gen
12	107062734	107062942	MACS_peak_4910	737.48	208	0	1	0	gen
12	107079281	107079462	MACS_peak_4911	746.04	181	0	1	0	gen
12	107186311	107186729	MACS_peak_4912	110.62	418	0	0	0	intergen
12	107370656	107370894	MACS_peak_4913	406.99	238	0	1	0	gen
12	107405063	107405301	MACS_peak_4914	662.31	238	0	1	0	gen
12	107607579	107607897	MACS_peak_4915	676.68	318	0	1	0	gen
12	107676199	107676515	MACS_peak_4916	1478.55	316	0	0	0	intergen
12	107720177	107720438	MACS_peak_4917	430.8	261	0	0	0	intergen
12	107825358	107825709	MACS_peak_4918	415.73	351	0	0	0	intergen
12	107921812	107922025	MACS_peak_4919	586.96	213	0	0	0	intergen
12	107998794	107999068	MACS_peak_4920	566.68	274	0	0	0	intergen
12	108511978	108512270	MACS_peak_4921	829.92	292	1	0	0	promoter
12	108755317	108755538	MACS_peak_4922	300.83	221	0	0	0	intergen
12	108761364	108761741	MACS_peak_4923	349.84	377	0	0	0	intergen
12	108803578	108803828	MACS_peak_4924	485.56	250	0	1	0	gen
12	108998851	108999126	MACS_peak_4925	119.49	275	0	1	0	gen
12	109000423	109000871	MACS_peak_4926	80.14	448	0	1	0	gen
12	109002072	109002384	MACS_peak_4927	180.46	312	0	1	0	gen
12	109428037	109428361	MACS_peak_4929	729.82	324	0	1	0	gen
12	109431837	109432050	MACS_peak_4930	457.51	213	0	1	0	gen
12	109432860	109433050	MACS_peak_4931	767.82	190	0	1	0	gen
12	109845337	109845603	MACS_peak_4932	463.44	266	0	0	0	intergen
12	109880439	109880697	MACS_peak_4933	727.26	258	0	0	0	intergen
12	110224390	110224751	MACS_peak_4934	410.92	361	0	0	0	intergen
12	110430831	110431064	MACS_peak_4935	302.6	233	1	0	1	promoter
12	110431204	110431671	MACS_peak_4936	1204.42	467	1	0	1	promoter
12	110577164	110577299	MACS_peak_4937	1924.49	135	0	1	0	gen
12	110866474	110866804	MACS_peak_4938	166.45	330	0	1	0	gen
12	110888044	110888321	MACS_peak_4939	456.44	277	0	1	0	gen
12	110894428	110894736	MACS_peak_4940	815.17	308	0	1	0	gen
12	111268840	111269056	MACS_peak_4941	580.62	216	0	1	0	gen
12	111274955	111275155	MACS_peak_4942	645.81	200	0	1	0	gen
12	111529320	111529705	MACS_peak_4943	630.67	385	0	1	0	gen
12	111553484	111553709	MACS_peak_4944	181.09	225	0	1	0	gen
12	111831182	111831615	MACS_peak_4945	55.46	433	0	0	0	intergen
12	111939449	111939686	MACS_peak_4946	375.48	237	0	1	0	gen
12	111945301	111945589	MACS_peak_4947	378.95	288	0	1	0	gen
12	112058889	112059208	MACS_peak_4948	114.74	319	0	1	0	gen
12	112138736	112138996	MACS_peak_4949	440.77	260	0	1	0	gen
12	112198219	112198476	MACS_peak_4950	469.39	257	0	1	0	gen
12	112411614	112411839	MACS_peak_4951	839.47	225	0	1	0	gen
12	112622021	112622293	MACS_peak_4952	50.71	272	0	1	0	gen
12	112628569	112628711	MACS_peak_4954	527.36	142	0	1	0	gen
12	113005822	113006253	MACS_peak_4956	285.42	431	0	1	1	gen
12	113030943	113031209	MACS_peak_4957	855.73	266	0	0	0	intergen
12	113048675	113048928	MACS_peak_4958	470.06	253	0	0	0	intergen
12	113098454	113098734	MACS_peak_4959	454.58	280	1	0	0	promoter
12	113174467	113174636	MACS_peak_4960	1025.76	169	0	1	0	gen
12	113952899	113953114	MACS_peak_4961	453.32	215	0	1	0	gen
12	113980506	113980916	MACS_peak_4962	1122.72	410	0	0	0	intergen
12	114085219	114085568	MACS_peak_4963	59.61	349	0	0	1	other
12	114281918	114282302	MACS_peak_4964	631.3	384	0	0	0	intergen
12	114576286	114576712	MACS_peak_4965	1379.24	426	0	0	0	intergen
12	115274061	115274435	MACS_peak_4967	404.88	374	0	0	0	intergen
12	115288836	115289251	MACS_peak_4968	50.57	415	0	0	0	intergen
12	115289845	115290184	MACS_peak_4969	81.83	339	0	0	0	intergen
12	115922967	115923263	MACS_peak_4970	445	296	0	0	0	intergen
12	115947239	115947441	MACS_peak_4971	814.37	202	0	0	0	intergen
12	115998051	115998378	MACS_peak_4972	488.85	327	0	1	0	gen
12	116066313	116066539	MACS_peak_4973	423.66	226	0	1	0	gen
12	116287247	116287456	MACS_peak_4974	198.95	209	0	0	0	intergen
12	116617804	116617938	MACS_peak_4975	1212.73	134	0	0	0	intergen
12	117212612	117212852	MACS_peak_4976	936.57	240	1	0	0	promoter
12	117587744	117587962	MACS_peak_4977	729.14	218	0	1	0	gen
12	117671579	117671942	MACS_peak_4978	769.88	363	0	1	0	gen
12	117763062	117763370	MACS_peak_4979	158.81	308	0	1	0	gen
12	118078926	118079072	MACS_peak_4980	1103.27	146	0	1	0	gen
12	118128728	118128964	MACS_peak_4981	235.3	236	0	1	0	gen
12	118181605	118181986	MACS_peak_4982	346.86	381	0	1	0	gen
12	118201827	118202128	MACS_peak_4983	1386.14	301	0	1	0	gen
12	118377927	118378199	MACS_peak_4984	2566.34	272	1	0	0	promoter
12	118564434	118564682	MACS_peak_4985	613.04	248	0	0	0	intergen
12	118622609	118622903	MACS_peak_4986	483.01	294	0	0	0	intergen
12	118670063	118670431	MACS_peak_4987	114.26	368	0	0	0	intergen
12	119108113	119108447	MACS_peak_4988	87.05	334	0	1	1	gen
12	119115282	119115574	MACS_peak_4989	447.34	292	0	1	1	gen
12	119219341	119219611	MACS_peak_4990	312.33	270	0	1	0	gen
12	119335863	119336243	MACS_peak_4991	138.14	380	1	0	0	promoter
12	119418306	119418509	MACS_peak_4992	81.95	203	0	1	1	gen
12	119567601	119567873	MACS_peak_4993	471.65	272	0	0	1	other
12	119649333	119649552	MACS_peak_4994	577.49	219	0	0	1	other
12	119659383	119659622	MACS_peak_4995	1098.16	239	0	0	1	other
12	119744715	119744848	MACS_peak_4996	1396.21	133	0	1	0	gen
12	119780900	119781199	MACS_peak_4997	672.91	299	0	1	0	gen
12	119917741	119918055	MACS_peak_4998	202.59	314	0	0	0	intergen
12	119938145	119938374	MACS_peak_4999	695.57	229	0	0	0	intergen
12	120201291	120201461	MACS_peak_5000	777.13	170	1	0	1	promoter
12	120302023	120302363	MACS_peak_5001	360.83	340	1	0	0	promoter
12	120325361	120325803	MACS_peak_5002	349.84	442	1	0	0	promoter
12	120430464	120430796	MACS_peak_5003	350.2	332	0	0	0	intergen
12	120552950	120553102	MACS_peak_5004	2041.47	152	0	1	0	gen
12	120583450	120583752	MACS_peak_5005	441.54	302	1	0	0	promoter
12	120647003	120647264	MACS_peak_5006	724.45	261	0	1	0	gen
12	120714050	120714392	MACS_peak_5007	536.84	342	1	0	0	promoter
12	120898213	120898421	MACS_peak_5008	760.34	208	0	1	0	gen
12	120926805	120927080	MACS_peak_5009	488.85	275	0	0	0	intergen
12	121060576	121060915	MACS_peak_5011	896.47	339	0	0	0	intergen
12	121061854	121062163	MACS_peak_5012	683.61	309	0	0	0	intergen
12	121255162	121255391	MACS_peak_5013	848.95	229	0	1	0	gen
12	121479018	121479396	MACS_peak_5014	831.33	378	0	1	0	gen
12	121499943	121500214	MACS_peak_5015	1279.99	271	0	1	0	gen
12	121539225	121539366	MACS_peak_5016	1588.16	141	0	1	0	gen
12	121681963	121682369	MACS_peak_5017	1734.82	406	0	0	0	intergen
12	121794872	121795125	MACS_peak_5018	470.06	253	0	1	0	gen
12	121862540	121862717	MACS_peak_5019	939.42	177	0	1	0	gen
12	122054373	122054610	MACS_peak_5020	793.98	237	0	1	0	gen
12	122131093	122131310	MACS_peak_5021	580.62	217	0	1	0	gen
12	122289695	122289828	MACS_peak_5022	1341.63	133	0	1	0	gen
12	122336105	122336442	MACS_peak_5023	922.25	337	0	1	0	gen
12	122471666	122471992	MACS_peak_5024	997.64	326	1	0	0	promoter
12	122578936	122579306	MACS_peak_5025	103.45	370	0	1	0	gen
12	122637891	122638074	MACS_peak_5026	729.14	183	0	0	0	intergen
12	122710294	122710457	MACS_peak_5027	987.39	163	1	0	1	promoter
12	122793571	122793926	MACS_peak_5028	413.79	355	0	1	0	gen
12	123264081	123264492	MACS_peak_5029	834.03	411	1	0	0	promoter
12	123322892	123323130	MACS_peak_5030	690.17	238	0	1	0	gen
12	123365765	123365995	MACS_peak_5031	532.66	230	0	0	1	other
12	123582202	123582392	MACS_peak_5033	1167.67	190	1	0	1	promoter
12	123801660	123801833	MACS_peak_5034	1208.41	173	0	1	0	gen
12	123810267	123810639	MACS_peak_5035	312.33	372	0	1	0	gen
12	124022516	124022659	MACS_peak_5036	667.47	143	0	2	0	gen
12	124036601	124036912	MACS_peak_5037	947.19	311	0	2	0	gen
12	124288886	124289227	MACS_peak_5038	537.45	341	0	1	0	gen
12	124728050	124728182	MACS_peak_5039	1116.4	132	0	0	0	intergen
12	124767059	124767316	MACS_peak_5040	579.95	257	0	0	0	intergen
12	124771919	124772118	MACS_peak_5041	831.63	199	1	0	0	promoter
12	124898524	124898795	MACS_peak_5042	584.96	271	0	0	0	intergen
12	124906789	124907132	MACS_peak_5043	1051.86	343	1	0	0	promoter
12	125183193	125183438	MACS_peak_5044	501.16	245	1	0	0	promoter
12	125330990	125331176	MACS_peak_5045	901.33	186	0	1	0	gen
12	125541918	125542056	MACS_peak_5046	831.96	138	0	1	0	gen
12	125589208	125589452	MACS_peak_5047	210.91	244	0	1	0	gen
12	125612819	125613281	MACS_peak_5048	3070.54	462	0	1	0	gen
12	125729614	125729976	MACS_peak_5049	55.81	362	0	0	0	intergen
12	125731257	125731724	MACS_peak_5050	136.25	467	0	0	0	intergen
12	125889341	125889569	MACS_peak_5051	567.88	228	0	0	0	intergen
12	125929863	125930104	MACS_peak_5052	501.16	241	0	0	0	intergen
12	125941418	125941619	MACS_peak_5053	989.9	201	0	0	0	intergen
12	126151678	126152066	MACS_peak_5054	124.92	388	0	0	1	other
12	126321503	126321969	MACS_peak_5056	255.84	466	0	0	1	other
12	126857667	126857893	MACS_peak_5057	488.41	226	0	0	0	intergen
12	126874509	126874750	MACS_peak_5058	797.18	241	0	0	0	intergen
12	126981404	126981603	MACS_peak_5059	1208.41	199	0	0	1	other
12	127026690	127026937	MACS_peak_5060	1036.76	247	0	0	1	other
12	127099043	127099490	MACS_peak_5061	65.24	447	0	0	0	intergen
12	127246862	127247147	MACS_peak_5062	406.96	285	0	0	0	intergen
12	127802066	127802340	MACS_peak_5064	748.68	274	0	0	1	other
12	127814803	127815022	MACS_peak_5065	564.92	219	0	0	1	other
12	127866301	127866692	MACS_peak_5066	105.65	391	0	0	0	intergen
12	127871381	127871652	MACS_peak_5067	79.17	271	0	0	0	intergen
12	128069537	128069767	MACS_peak_5068	532.66	230	0	0	0	intergen
12	128105003	128105401	MACS_peak_5070	1511.93	398	0	0	1	other
12	128357511	128357829	MACS_peak_5071	265.34	318	0	1	0	gen
12	128436307	128436680	MACS_peak_5072	74.1	373	0	1	0	gen
12	128456060	128456424	MACS_peak_5073	251.22	364	0	1	0	gen
12	128492800	128493146	MACS_peak_5074	92	346	0	1	0	gen
12	129040574	129040920	MACS_peak_5075	131.32	346	0	0	0	intergen
12	129059552	129059871	MACS_peak_5076	84.4	319	0	0	0	intergen
12	129444245	129444483	MACS_peak_5077	662.31	238	0	1	0	gen
12	129456894	129457257	MACS_peak_5078	149.97	363	0	1	0	gen
12	129513761	129514111	MACS_peak_5079	306.6	350	0	1	0	gen
12	129803094	129803526	MACS_peak_5080	82.78	432	0	1	0	gen
12	129805643	129806089	MACS_peak_5081	245.93	446	0	1	0	gen
12	129998909	129999170	MACS_peak_5082	367.62	261	0	0	0	intergen
12	130026679	130026935	MACS_peak_5083	470.06	256	0	0	1	other
12	130031705	130031940	MACS_peak_5084	972.07	235	0	0	1	other
12	130335583	130335943	MACS_peak_5085	411.4	360	1	0	0	promoter
12	130445492	130445858	MACS_peak_5086	408.57	366	0	1	0	gen
12	130818987	130819247	MACS_peak_5088	467.38	260	0	1	0	gen
12	131503168	131503504	MACS_peak_5089	162.94	336	0	0	0	intergen
12	131503684	131504102	MACS_peak_5090	100.2	418	0	0	0	intergen
12	131588359	131588826	MACS_peak_5091	169.67	467	0	0	0	intergen
12	132809461	132809828	MACS_peak_5093	1310.99	367	0	1	0	gen
12	132962075	132962441	MACS_peak_21897	408.57	366	0	0	0	intergen
13	18663306	18663642	MACS_peak_5094	1317.25	336	0	0	0	intergen
13	18667026	18667228	MACS_peak_5095	479.82	202	0	0	0	intergen
13	19106862	19107309	MACS_peak_5096	90.78	447	0	0	0	intergen
13	19444301	19444434	MACS_peak_5098	581.31	133	0	1	0	gen
13	19455172	19455382	MACS_peak_5099	607.01	210	0	1	0	gen
13	19478680	19478962	MACS_peak_5100	152.1	282	0	1	0	gen
13	19540033	19540317	MACS_peak_5101	338.97	284	0	0	0	intergen
13	19576707	19576941	MACS_peak_5102	170.22	234	0	0	1	other
13	19577677	19578028	MACS_peak_5103	107.53	351	0	0	1	other
13	19612863	19613135	MACS_peak_5104	116.19	272	0	0	0	intergen
13	19642444	19642712	MACS_peak_5105	718.04	268	0	1	0	gen
13	19718145	19718437	MACS_peak_5106	447.34	292	0	1	0	gen
13	19927176	19927557	MACS_peak_5107	1092.16	381	0	0	0	intergen
13	20163481	20163745	MACS_peak_5108	998.2	264	0	0	0	intergen
13	20197313	20197724	MACS_peak_5109	615.01	411	0	0	0	intergen
13	20229046	20229255	MACS_peak_5110	318.29	209	0	1	0	gen
13	20828636	20828916	MACS_peak_5112	578.19	280	0	1	0	gen
13	20829194	20829483	MACS_peak_5113	449.12	289	0	1	0	gen
13	21134879	21135127	MACS_peak_5114	350.87	248	0	0	0	intergen
13	21251516	21251763	MACS_peak_5115	204.19	247	0	0	0	intergen
13	21279874	21280112	MACS_peak_5116	116.87	238	0	0	1	other
13	21477096	21477280	MACS_peak_5117	729.14	184	0	0	0	intergen
13	21551741	21552117	MACS_peak_5118	91.89	376	0	1	0	gen
13	21856421	21856705	MACS_peak_5119	162.43	284	0	0	0	intergen
13	21900563	21900945	MACS_peak_5120	84.4	382	0	0	0	intergen
13	22019590	22019957	MACS_peak_5121	522.32	367	0	0	0	intergen
13	22021968	22022348	MACS_peak_5123	757.3	380	0	0	0	intergen
13	22022903	22023338	MACS_peak_5124	1811.69	435	0	0	0	intergen
13	22256316	22256471	MACS_peak_5125	806.69	155	0	0	1	other
13	22313609	22313967	MACS_peak_5126	175.02	358	0	0	0	intergen
13	22349203	22349552	MACS_peak_5127	51.73	349	0	0	0	intergen
13	22528575	22528815	MACS_peak_5128	137.07	240	0	0	0	intergen
13	22566725	22567001	MACS_peak_5129	363.56	276	0	0	0	intergen
13	22577107	22577492	MACS_peak_5130	59.32	385	0	0	0	intergen
13	22580298	22580678	MACS_peak_5131	109.2	380	0	0	0	intergen
13	22673827	22674283	MACS_peak_5132	834.03	456	0	0	0	intergen
13	22701358	22701517	MACS_peak_5133	306.95	159	0	0	0	intergen
13	22868631	22868931	MACS_peak_5134	2338.57	300	0	0	0	intergen
13	23781176	23781474	MACS_peak_5136	69	298	0	1	0	gen
13	23890305	23890498	MACS_peak_5137	866.35	193	1	0	1	promoter
13	24053511	24053715	MACS_peak_5138	629.38	204	0	2	0	gen
13	24189793	24190056	MACS_peak_5139	1291.41	263	0	2	0	gen
13	24555156	24555485	MACS_peak_5140	314.21	329	0	0	1	other
13	24580395	24580692	MACS_peak_5141	444.41	297	0	0	2	other
13	24737658	24738049	MACS_peak_5142	603.02	391	0	0	1	other
13	24994893	24995129	MACS_peak_5143	972.07	236	0	0	0	intergen
13	25823174	25823353	MACS_peak_5145	531.2	179	0	1	0	gen
13	25888918	25889313	MACS_peak_5146	763.89	395	0	1	0	gen
13	25896743	25897217	MACS_peak_5147	116.59	474	0	1	0	gen
13	26072386	26072787	MACS_peak_5148	1131.12	401	0	0	0	intergen
13	26091934	26092249	MACS_peak_5149	553.81	315	0	0	0	intergen
13	26112876	26113161	MACS_peak_5150	765.03	285	0	0	1	other
13	26361679	26361818	MACS_peak_5151	911.62	139	0	1	0	gen
13	26482538	26482878	MACS_peak_5152	1054.89	340	0	0	0	intergen
13	26930208	26930549	MACS_peak_5153	420.68	341	0	0	0	intergen
13	26946980	26947273	MACS_peak_5154	488.85	293	0	0	0	intergen
13	27198666	27198948	MACS_peak_5155	453.35	282	0	0	1	other
13	27339308	27339627	MACS_peak_5156	361.66	319	0	0	0	intergen
13	27580119	27580389	MACS_peak_5157	3100	270	0	1	0	gen
13	27696428	27696713	MACS_peak_5158	703.15	285	0	1	1	gen
13	27829891	27830229	MACS_peak_5159	422.19	338	0	0	1	other
13	27869119	27869447	MACS_peak_5160	427.34	328	0	0	1	other
13	27935216	27935533	MACS_peak_5161	433.2	317	0	0	0	intergen
13	27998002	27998207	MACS_peak_5162	629.38	205	0	0	0	intergen
13	28293380	28293512	MACS_peak_5164	981.89	132	0	1	0	gen
13	28324299	28324487	MACS_peak_5165	695.57	188	0	1	0	gen
13	28679661	28679892	MACS_peak_5166	532.66	231	0	0	0	intergen
13	29362997	29363330	MACS_peak_5167	1201.59	333	0	1	0	gen
13	29472351	29472697	MACS_peak_5168	1187.05	346	0	1	0	gen
13	29508247	29508448	MACS_peak_5169	645.81	201	1	0	0	promoter
13	29642765	29643194	MACS_peak_5170	78.83	429	0	0	0	intergen
13	29649774	29650102	MACS_peak_5171	191.88	328	0	0	0	intergen
13	29776862	29777004	MACS_peak_5172	381.74	142	0	1	0	gen
13	30112933	30113259	MACS_peak_5173	546.72	326	0	0	0	intergen
13	30115124	30115379	MACS_peak_5174	1171.45	255	0	0	0	intergen
13	30213742	30214078	MACS_peak_5175	72.88	336	0	1	0	gen
13	30246185	30246554	MACS_peak_5176	249.05	369	0	1	0	gen
13	30948378	30948754	MACS_peak_5177	165.72	376	0	1	0	gen
13	30993772	30994125	MACS_peak_5178	295.66	353	0	0	0	intergen
13	31307800	31308168	MACS_peak_5180	116.5	368	0	1	0	gen
13	31996610	31996976	MACS_peak_5181	338.58	366	0	1	0	gen
13	32145439	32145751	MACS_peak_5182	229.83	312	0	1	0	gen
13	32564608	32565032	MACS_peak_5184	1069.92	424	0	0	0	intergen
13	32581166	32581508	MACS_peak_5185	672.97	342	0	0	0	intergen
13	32604510	32604969	MACS_peak_5186	134.63	459	0	1	0	gen
13	32650778	32651076	MACS_peak_5187	960.47	298	0	1	0	gen
13	32668941	32669331	MACS_peak_5188	722.05	390	0	1	0	gen
13	32713416	32713610	MACS_peak_5189	873.21	194	0	1	0	gen
13	33077754	33078016	MACS_peak_5190	395.02	262	0	0	0	intergen
13	33372336	33372554	MACS_peak_5192	729.14	218	0	0	1	other
13	33551476	33551624	MACS_peak_5193	588.53	148	0	0	1	other
13	33723936	33724223	MACS_peak_5194	573.07	287	0	0	0	intergen
13	33855777	33856126	MACS_peak_5195	416.71	349	0	1	0	gen
13	33987609	33988004	MACS_peak_5196	258.21	395	0	0	0	intergen
13	33989139	33989593	MACS_peak_5197	65.86	454	0	0	0	intergen
13	34033480	34033627	MACS_peak_5198	597.85	147	0	0	0	intergen
13	34139452	34139600	MACS_peak_5199	1208.41	148	0	0	0	intergen
13	34918543	34918676	MACS_peak_5200	1686.4	133	0	0	0	intergen
13	35134933	35135240	MACS_peak_5201	559.13	307	0	1	0	gen
13	35403425	35403699	MACS_peak_5202	114.74	274	0	1	0	gen
13	35404277	35404595	MACS_peak_5203	148.69	318	0	1	0	gen
13	35412377	35412656	MACS_peak_5204	348.98	279	0	1	0	gen
13	35721028	35721286	MACS_peak_5205	468.72	258	0	0	0	intergen
13	35789346	35789642	MACS_peak_5206	566.68	296	0	1	0	gen
13	36072957	36073166	MACS_peak_5207	460.69	209	0	1	0	gen
13	36282883	36283243	MACS_peak_5208	1171.99	360	0	2	0	gen
13	36346671	36346928	MACS_peak_5209	1006.59	257	0	1	1	gen
13	36485791	36486013	MACS_peak_5210	996.07	222	0	0	0	intergen
13	36707803	36708071	MACS_peak_5211	97.32	268	0	0	0	intergen
13	36736180	36736411	MACS_peak_5212	532.66	231	0	0	0	intergen
13	37069098	37069319	MACS_peak_5213	564.54	221	0	0	0	intergen
13	37154334	37154722	MACS_peak_5215	96.37	388	0	0	0	intergen
13	37608824	37609040	MACS_peak_5216	817.99	216	0	0	0	intergen
13	37874452	37874684	MACS_peak_5217	678.9	232	0	0	0	intergen
13	37960519	37960699	MACS_peak_5218	746.04	180	0	0	1	other
13	38045941	38046306	MACS_peak_5219	409.04	365	0	0	1	other
13	38114018	38114290	MACS_peak_5220	81.44	272	0	0	1	other
13	38115122	38115416	MACS_peak_5221	88.56	294	0	0	1	other
13	38116763	38117149	MACS_peak_5222	140.39	386	0	0	1	other
13	38117180	38117551	MACS_peak_5223	104.82	371	0	0	1	other
13	38145491	38145789	MACS_peak_5224	159.56	298	0	0	0	intergen
13	38291906	38292285	MACS_peak_5225	99.7	379	0	0	0	intergen
13	38328972	38329241	MACS_peak_5226	992.36	269	0	0	0	intergen
13	38582244	38582519	MACS_peak_5227	457.69	275	0	0	0	intergen
13	38836069	38836260	MACS_peak_5228	373.92	191	0	1	0	gen
13	39001454	39001837	MACS_peak_5230	92.9	383	0	0	0	intergen
13	39004761	39005171	MACS_peak_5231	59.86	410	0	0	0	intergen
13	39612113	39612381	MACS_peak_5232	993.52	268	0	0	0	intergen
13	39742198	39742448	MACS_peak_5233	157.99	250	0	1	0	gen
13	39796302	39796524	MACS_peak_5234	774.26	222	0	0	0	intergen
13	40005906	40006321	MACS_peak_5236	81.72	415	0	0	0	intergen
13	40361345	40361813	MACS_peak_5238	71.29	468	0	0	1	other
13	40361957	40362332	MACS_peak_5239	101.09	375	0	0	1	other
13	40737301	40737561	MACS_peak_5240	79.76	260	0	1	0	gen
13	40738050	40738307	MACS_peak_5241	52.18	257	0	1	0	gen
13	40740404	40740783	MACS_peak_5242	108.26	379	0	1	0	gen
13	40830348	40830722	MACS_peak_5243	56.65	374	0	0	1	other
13	40834333	40834615	MACS_peak_5244	130.86	282	0	0	1	other
13	40865336	40865739	MACS_peak_5245	104.85	403	0	0	1	other
13	41075154	41075352	MACS_peak_5246	808.21	198	0	1	0	gen
13	41196706	41196966	MACS_peak_5247	725.38	260	0	0	1	other
13	41222273	41222497	MACS_peak_5248	564.54	224	0	1	1	gen
13	41353123	41353305	MACS_peak_5249	710.43	182	0	1	0	gen
13	41400352	41400713	MACS_peak_5250	410.92	361	0	0	0	intergen
13	41400910	41401236	MACS_peak_5251	799.5	326	0	0	0	intergen
13	42030958	42031331	MACS_peak_5252	66.19	373	0	0	0	intergen
13	42141892	42142163	MACS_peak_5253	124.62	271	0	1	0	gen
13	42216072	42216420	MACS_peak_5254	417.2	348	0	1	0	gen
13	42426807	42427153	MACS_peak_5255	56.42	346	0	0	1	other
13	42429888	42430281	MACS_peak_5256	137.25	393	0	0	1	other
13	42967011	42967371	MACS_peak_5257	164.26	360	0	1	0	gen
13	43018260	43018395	MACS_peak_5258	643.95	135	1	0	0	promoter
13	43143296	43143531	MACS_peak_5259	516.86	235	0	0	0	intergen
13	43478228	43478503	MACS_peak_5260	3100	275	0	1	0	gen
13	43486911	43487169	MACS_peak_5261	380.3	258	0	1	0	gen
13	43506180	43506561	MACS_peak_5262	76.3	381	0	1	0	gen
13	43531532	43531833	MACS_peak_5263	127.15	301	0	1	0	gen
13	43882001	43882233	MACS_peak_5265	532.66	232	2	0	0	promoter
13	43972919	43973304	MACS_peak_5266	59.32	385	0	1	1	gen
13	44036954	44037341	MACS_peak_5267	209.59	387	0	0	0	intergen
13	44050508	44050790	MACS_peak_5268	574.3	282	0	0	0	intergen
13	44082519	44082852	MACS_peak_5269	118.95	333	0	0	0	intergen
13	44169764	44170005	MACS_peak_5270	645.81	241	0	0	1	other
13	44483678	44483969	MACS_peak_5271	674.68	291	0	1	0	gen
13	45047231	45047682	MACS_peak_5272	592.81	451	0	0	1	other
13	45309515	45309730	MACS_peak_5273	596.79	215	0	0	0	intergen
13	45393963	45394308	MACS_peak_5274	535.04	345	1	0	0	promoter
13	45511633	45511851	MACS_peak_5276	577.49	218	0	1	0	gen
13	45515955	45516307	MACS_peak_5277	415.24	352	0	1	0	gen
13	45618436	45618667	MACS_peak_5278	504.09	231	0	0	0	intergen
13	45664175	45664507	MACS_peak_5279	67.16	332	0	0	0	intergen
13	45669452	45669862	MACS_peak_5280	234.46	410	0	0	0	intergen
13	45879803	45880159	MACS_peak_5281	528.58	356	0	0	0	intergen
13	46126629	46126896	MACS_peak_5282	854.69	267	1	0	0	promoter
13	46184475	46184678	MACS_peak_5283	629.38	203	0	1	0	gen
13	46275533	46275754	MACS_peak_5284	564.54	221	0	1	0	gen
13	46354923	46355306	MACS_peak_5285	356.83	383	0	1	0	gen
13	46420913	46421228	MACS_peak_5286	434.56	315	0	1	0	gen
13	46551568	46551936	MACS_peak_5287	407.64	368	1	0	0	promoter
13	46603395	46603614	MACS_peak_5288	580.62	219	0	1	0	gen
13	46705325	46705504	MACS_peak_5289	742.25	179	0	1	0	gen
13	46721162	46721469	MACS_peak_5290	603.02	307	0	1	0	gen
13	46831639	46831914	MACS_peak_5291	611.86	275	1	0	0	promoter
13	46906469	46906719	MACS_peak_5292	389.4	250	0	0	0	intergen
13	46973964	46974225	MACS_peak_5293	824.44	261	0	0	0	intergen
13	47018276	47018726	MACS_peak_5294	67.95	450	0	0	0	intergen
13	47083977	47084204	MACS_peak_5295	736.56	227	0	0	0	intergen
13	47222249	47222632	MACS_peak_5296	54.22	383	0	0	0	intergen
13	47297443	47297858	MACS_peak_5297	514.48	415	0	0	0	intergen
13	47382336	47382557	MACS_peak_5299	154.93	221	0	0	0	intergen
13	47401419	47401664	MACS_peak_5300	825.15	245	0	0	0	intergen
13	47429782	47430079	MACS_peak_5301	580.52	297	0	0	0	intergen
13	47538812	47539000	MACS_peak_5302	651.83	188	0	0	0	intergen
13	47717799	47718109	MACS_peak_5304	149.97	310	0	0	0	intergen
13	47784177	47784602	MACS_peak_5306	119.11	425	0	1	0	gen
13	47784823	47785284	MACS_peak_5307	62.5	461	0	1	0	gen
13	47785935	47786316	MACS_peak_5308	54.79	381	0	1	0	gen
13	48015860	48016301	MACS_peak_5310	91.01	441	0	1	0	gen
13	48016404	48016755	MACS_peak_5311	68.83	351	0	1	0	gen
13	48037967	48038229	MACS_peak_5312	838.54	262	1	0	0	promoter
13	48095107	48095341	MACS_peak_5313	623.55	234	0	0	0	intergen
13	48336418	48336690	MACS_peak_5314	62.38	272	0	1	0	gen
13	48337396	48337760	MACS_peak_5315	140.37	364	0	1	0	gen
13	49281151	49281363	MACS_peak_5317	596.79	212	0	1	0	gen
13	49483508	49483650	MACS_peak_5318	847.53	142	0	1	0	gen
13	49846969	49847335	MACS_peak_5319	408.57	366	0	0	0	intergen
13	50100938	50101145	MACS_peak_5320	780.06	207	0	0	2	other
13	50184361	50184735	MACS_peak_5322	75.09	374	0	0	1	other
13	50504895	50505261	MACS_peak_5323	134.3	366	0	0	1	other
13	50985036	50985321	MACS_peak_5324	96.14	285	0	1	0	gen
13	50987641	50987962	MACS_peak_5325	141.24	321	0	1	0	gen
13	51074840	51075243	MACS_peak_5326	233.98	403	0	0	1	other
13	51435011	51435366	MACS_peak_5327	776.01	355	0	1	0	gen
13	51514148	51514414	MACS_peak_5328	122.54	266	0	0	1	other
13	51733803	51733999	MACS_peak_5329	662.31	196	0	1	0	gen
13	51787690	51788006	MACS_peak_5330	433.75	316	0	2	0	gen
13	51845176	51845409	MACS_peak_5331	972.07	233	0	0	0	intergen
13	52055961	52056310	MACS_peak_5332	76.25	349	0	1	0	gen
13	52236298	52236614	MACS_peak_5334	506.92	316	0	0	2	other
13	52246195	52246534	MACS_peak_5335	112.52	339	0	0	2	other
13	52269848	52270203	MACS_peak_5336	128.53	355	0	0	2	other
13	52591874	52592231	MACS_peak_5337	229.9	357	0	0	0	intergen
13	52665410	52665632	MACS_peak_5338	712.32	222	0	1	0	gen
13	52730003	52730445	MACS_peak_5339	137.17	442	0	1	0	gen
13	52862501	52862881	MACS_peak_5340	402.16	380	0	0	0	intergen
13	53094354	53094731	MACS_peak_5341	94.17	377	0	0	0	intergen
13	53095653	53096012	MACS_peak_5342	51.1	359	0	0	0	intergen
13	53151880	53152107	MACS_peak_5343	548.55	227	0	0	0	intergen
13	53250335	53250695	MACS_peak_5344	772.16	360	0	0	0	intergen
13	53297241	53297572	MACS_peak_5345	137.96	331	0	0	0	intergen
13	53326072	53326281	MACS_peak_5346	520.1	209	0	0	0	intergen
13	54185847	54186163	MACS_peak_5347	678.2	316	0	0	0	intergen
13	54410314	54410555	MACS_peak_5348	501.16	241	0	0	0	intergen
13	54740937	54741318	MACS_peak_5349	83.57	381	0	0	0	intergen
13	55659172	55659519	MACS_peak_5350	158.81	347	0	0	0	intergen
13	55774601	55774902	MACS_peak_5351	671.3	301	0	0	0	intergen
13	55812554	55812809	MACS_peak_5352	106.82	255	0	0	0	intergen
13	56474632	56474764	MACS_peak_5353	1116.4	132	0	0	0	intergen
13	56665181	56665406	MACS_peak_5354	464.49	225	0	0	0	intergen
13	56982588	56982879	MACS_peak_5355	144.54	291	0	0	0	intergen
13	57220077	57220534	MACS_peak_5356	101.68	457	0	0	0	intergen
13	57357906	57358279	MACS_peak_5358	105.3	373	0	0	0	intergen
13	57411199	57411541	MACS_peak_5359	164.26	342	0	0	0	intergen
13	58024396	58024547	MACS_peak_5360	630.94	151	0	0	0	intergen
13	58266826	58267034	MACS_peak_5362	613.04	208	0	0	0	intergen
13	58512696	58512921	MACS_peak_5363	98.95	225	0	0	0	intergen
13	58960970	58961277	MACS_peak_5366	438.71	307	0	0	0	intergen
13	59027278	59027648	MACS_peak_5367	124.97	370	0	0	0	intergen
13	59027726	59028080	MACS_peak_5368	80.91	354	0	0	0	intergen
13	59029371	59029825	MACS_peak_5369	88.02	454	0	0	0	intergen
13	59030216	59030641	MACS_peak_5370	169.55	425	0	0	0	intergen
13	59678139	59678503	MACS_peak_5371	409.51	364	0	1	0	gen
13	59680498	59680823	MACS_peak_5372	1236.43	325	0	1	0	gen
13	59771336	59771594	MACS_peak_5373	595.17	258	0	1	0	gen
13	59906471	59906776	MACS_peak_5375	560.48	305	0	1	0	gen
13	60248853	60249096	MACS_peak_5376	52.57	243	0	0	0	intergen
13	60335662	60335986	MACS_peak_5377	429.45	324	0	0	0	intergen
13	60473620	60473855	MACS_peak_5378	662.31	235	0	1	0	gen
13	60712509	60712863	MACS_peak_5379	468.22	354	0	0	0	intergen
13	60713322	60713671	MACS_peak_5380	66.25	349	0	0	0	intergen
13	60715323	60715645	MACS_peak_5381	152.28	322	0	0	0	intergen
13	60804556	60804928	MACS_peak_5383	55.09	372	0	0	0	intergen
13	60827633	60828081	MACS_peak_5384	175.96	448	0	0	0	intergen
13	60977887	60978135	MACS_peak_5385	485.56	248	0	0	0	intergen
13	61234766	61235047	MACS_peak_5386	577.45	281	0	0	0	intergen
13	61329043	61329403	MACS_peak_5387	108.7	360	0	0	0	intergen
13	61961406	61961707	MACS_peak_5388	689.95	301	0	0	0	intergen
13	62019555	62019867	MACS_peak_5389	1084.56	312	0	0	1	other
13	62061022	62061426	MACS_peak_5390	603.02	404	0	0	0	intergen
13	63121765	63121916	MACS_peak_5392	696.62	151	0	0	0	intergen
13	64231350	64231694	MACS_peak_5394	127.83	344	0	0	0	intergen
13	64268035	64268259	MACS_peak_5395	712.32	224	0	0	0	intergen
13	64411774	64411912	MACS_peak_5396	1025.3	138	0	0	0	intergen
13	64616345	64616604	MACS_peak_5397	380.3	259	0	0	0	intergen
13	64694898	64695226	MACS_peak_5398	506.92	328	0	0	0	intergen
13	65993393	65993785	MACS_peak_5400	127.47	392	0	0	0	intergen
13	66258506	66258730	MACS_peak_5402	179.9	224	0	0	0	intergen
13	66281974	66282365	MACS_peak_5403	137.17	391	0	0	0	intergen
13	66757524	66757789	MACS_peak_5405	997.03	265	0	1	0	gen
13	66776306	66776607	MACS_peak_5406	91.11	301	0	1	0	gen
13	66999508	66999876	MACS_peak_5407	159.56	368	0	1	1	gen
13	67224317	67224750	MACS_peak_5408	1371.95	433	0	1	0	gen
13	67366549	67366907	MACS_peak_5409	527.43	358	0	0	0	intergen
13	67456955	67457346	MACS_peak_5410	314.21	391	0	0	0	intergen
13	67564370	67564694	MACS_peak_5411	50.32	324	0	0	0	intergen
13	67592842	67593101	MACS_peak_5412	153.73	259	0	0	0	intergen
13	67607825	67608277	MACS_peak_5413	1352.74	452	0	0	0	intergen
13	67681137	67681484	MACS_peak_5414	115.96	347	0	0	0	intergen
13	67683949	67684369	MACS_peak_5415	66.96	420	0	0	0	intergen
13	67845730	67846098	MACS_peak_5416	109.53	368	0	0	0	intergen
13	67848076	67848441	MACS_peak_5418	103.45	365	0	0	0	intergen
13	68082128	68082567	MACS_peak_5419	1663.07	439	0	0	0	intergen
13	68304835	68304968	MACS_peak_5420	1098.16	133	0	0	0	intergen
13	68339673	68340013	MACS_peak_5421	104.52	340	0	0	0	intergen
13	68340119	68340449	MACS_peak_5422	120.16	330	0	0	0	intergen
13	68376373	68376515	MACS_peak_5423	1282.94	142	0	0	0	intergen
13	69579403	69579646	MACS_peak_5424	645.81	243	0	0	0	intergen
13	69679570	69679811	MACS_peak_5425	238.95	241	0	0	0	intergen
13	69684907	69685155	MACS_peak_5426	310.5	248	0	0	0	intergen
13	69710991	69711201	MACS_peak_5427	607.01	210	0	1	0	gen
13	69786804	69787192	MACS_peak_5428	110.11	388	0	1	0	gen
13	69857328	69857514	MACS_peak_5429	712.32	186	0	1	0	gen
13	70145261	70145622	MACS_peak_5430	112.48	361	0	0	0	intergen
13	70166881	70167120	MACS_peak_5431	172.27	239	0	0	0	intergen
13	70210528	70210877	MACS_peak_5432	75.01	349	0	0	0	intergen
13	70213973	70214329	MACS_peak_5433	105.65	356	0	0	0	intergen
13	70623310	70623613	MACS_peak_5434	440.97	303	0	0	0	intergen
13	70803072	70803437	MACS_peak_5435	409.04	365	0	0	0	intergen
13	71255944	71256098	MACS_peak_5436	1153.04	154	0	0	0	intergen
13	71299361	71299722	MACS_peak_5437	265.34	361	0	0	0	intergen
13	71320504	71320787	MACS_peak_5438	452.74	283	0	0	0	intergen
13	71385527	71385760	MACS_peak_5439	111.21	233	0	0	0	intergen
13	71388909	71389322	MACS_peak_5440	73.5	413	0	0	0	intergen
13	71506831	71507152	MACS_peak_5441	268.99	321	0	1	0	gen
13	71672623	71672877	MACS_peak_5442	580.75	254	0	1	0	gen
13	72061252	72061647	MACS_peak_5443	366.31	395	0	0	0	intergen
13	72201075	72201500	MACS_peak_5444	202.06	425	0	0	0	intergen
13	72227186	72227524	MACS_peak_5445	54.95	338	0	0	0	intergen
13	72452751	72453034	MACS_peak_5446	575.98	283	0	0	0	intergen
13	72613826	72614131	MACS_peak_5447	70.39	305	0	0	0	intergen
13	72675678	72675882	MACS_peak_5448	236.86	204	0	0	0	intergen
13	72696639	72696878	MACS_peak_5449	516.86	239	0	0	0	intergen
13	72882560	72882816	MACS_peak_5450	729.14	256	0	1	0	gen
13	73103739	73103980	MACS_peak_5451	324.89	241	0	0	0	intergen
13	73168066	73168204	MACS_peak_5452	885.2	138	0	0	0	intergen
13	73415629	73415991	MACS_peak_5453	525.14	362	0	0	1	other
13	73453757	73454073	MACS_peak_5454	60.03	316	0	0	1	other
13	73642521	73642794	MACS_peak_5455	120.59	273	0	0	1	other
13	73849374	73849581	MACS_peak_5456	1134.69	207	0	1	0	gen
13	74236153	74236506	MACS_peak_5457	104.18	353	0	0	1	other
13	74238876	74239127	MACS_peak_5458	56.16	251	0	0	1	other
13	74239217	74239639	MACS_peak_5459	74.5	422	0	0	1	other
13	74430990	74431316	MACS_peak_5461	92.08	326	0	0	1	other
13	74431380	74431858	MACS_peak_5462	126.45	478	0	0	1	other
13	74810747	74811007	MACS_peak_5464	1002.97	260	0	0	0	intergen
13	74865538	74865751	MACS_peak_5465	763.02	213	0	0	0	intergen
13	75241804	75242124	MACS_peak_5466	73.59	320	0	0	0	intergen
13	75243336	75243629	MACS_peak_5467	88.97	293	0	0	0	intergen
13	75258110	75258476	MACS_peak_5468	1305.07	366	0	0	0	intergen
13	75278069	75278429	MACS_peak_5469	97.28	360	0	0	0	intergen
13	75695811	75696126	MACS_peak_5470	808.97	315	0	1	1	gen
13	75729257	75729615	MACS_peak_5471	52.95	358	0	1	1	gen
13	76492984	76493190	MACS_peak_5473	629.38	206	0	0	0	intergen
13	76573088	76573224	MACS_peak_5474	565.56	136	0	0	1	other
13	76605584	76605882	MACS_peak_5475	105.65	298	0	0	1	other
13	76612977	76613329	MACS_peak_5476	120.61	352	0	0	1	other
13	76614220	76614535	MACS_peak_5477	59.5	315	0	0	1	other
13	76903658	76903912	MACS_peak_5478	596.79	254	0	0	0	intergen
13	77478399	77478683	MACS_peak_5479	452.13	284	0	0	0	intergen
13	77493015	77493187	MACS_peak_5480	797.18	172	0	0	0	intergen
13	77751941	77752135	MACS_peak_5481	678.9	194	0	1	0	gen
13	77779479	77779787	MACS_peak_5482	950.21	308	0	0	0	intergen
13	78095524	78095891	MACS_peak_5483	84.86	367	0	0	1	other
13	78158783	78159017	MACS_peak_5484	218.56	234	0	0	1	other
13	78284620	78285003	MACS_peak_5485	148.8	383	0	0	1	other
13	78496500	78496697	MACS_peak_5486	662.31	197	0	0	1	other
13	79236528	79236751	MACS_peak_5487	144.63	223	0	0	0	intergen
13	79491534	79491857	MACS_peak_5488	722.05	323	0	1	0	gen
13	79541425	79541765	MACS_peak_5489	421.18	340	0	1	0	gen
13	79679310	79679568	MACS_peak_5490	468.72	258	0	0	0	intergen
13	79818045	79818395	MACS_peak_5491	70.75	350	0	0	0	intergen
13	79818464	79818718	MACS_peak_5492	95.32	254	0	0	0	intergen
13	79821217	79821599	MACS_peak_5493	50.92	382	0	0	0	intergen
13	79844034	79844441	MACS_peak_5494	51.06	407	0	0	0	intergen
13	80152875	80153344	MACS_peak_5495	50.57	469	0	0	0	intergen
13	80289859	80290146	MACS_peak_5496	380.3	287	0	0	0	intergen
13	80368827	80369188	MACS_peak_5497	892.36	361	0	0	0	intergen
13	80674759	80675163	MACS_peak_5498	167.99	404	0	0	0	intergen
13	80732291	80732581	MACS_peak_5499	93.4	290	0	0	0	intergen
13	80983517	80983850	MACS_peak_5500	90.41	333	0	0	0	intergen
13	81462487	81462813	MACS_peak_5501	109.53	326	0	0	0	intergen
13	81559395	81559697	MACS_peak_5502	120.03	302	0	0	0	intergen
13	81560143	81560496	MACS_peak_5503	91.72	353	0	0	0	intergen
13	81860730	81861097	MACS_peak_5504	93.4	367	0	0	0	intergen
13	82046727	82047128	MACS_peak_5505	91.24	401	0	0	0	intergen
13	82229979	82230454	MACS_peak_5506	63.13	475	0	0	0	intergen
13	82538137	82538484	MACS_peak_5507	167.98	347	0	0	0	intergen
13	82616216	82616514	MACS_peak_5508	824.29	298	0	0	0	intergen
13	82759577	82759895	MACS_peak_5509	237.25	318	0	0	0	intergen
13	82956539	82956756	MACS_peak_5510	580.62	217	0	0	0	intergen
13	82976558	82976819	MACS_peak_5511	860.98	261	0	0	0	intergen
13	83418814	83419021	MACS_peak_5512	603.96	207	0	0	0	intergen
13	83522767	83523130	MACS_peak_5513	69.19	363	0	0	0	intergen
13	83707270	83707495	MACS_peak_5514	226.37	225	0	0	0	intergen
13	83965867	83966349	MACS_peak_5515	192.18	482	0	0	0	intergen
13	84175840	84176233	MACS_peak_5516	142.43	393	0	0	0	intergen
13	84435520	84435768	MACS_peak_5517	485.56	248	0	0	0	intergen
13	84844480	84844759	MACS_peak_5519	455.19	279	0	0	0	intergen
13	85126459	85126929	MACS_peak_5520	59.07	470	0	0	0	intergen
13	85127726	85128101	MACS_peak_5521	54.27	375	0	0	0	intergen
13	85567530	85567702	MACS_peak_5522	471.91	172	0	0	0	intergen
13	85864921	85865277	MACS_peak_5523	191.6	356	0	0	0	intergen
13	85998060	85998395	MACS_peak_5524	126.82	335	0	0	0	intergen
13	86115323	86115600	MACS_peak_5525	456.44	277	0	0	1	other
13	86290525	86290829	MACS_peak_5526	164.26	304	0	0	0	intergen
13	86534955	86535095	MACS_peak_5527	889.07	140	0	0	0	intergen
13	86684736	86684979	MACS_peak_5528	368.49	243	0	0	0	intergen
13	86870434	86870675	MACS_peak_5529	501.16	241	0	0	0	intergen
13	86898207	86898538	MACS_peak_5531	59.05	331	0	0	0	intergen
13	87290397	87290673	MACS_peak_5533	457.06	276	0	0	0	intergen
13	87376814	87377166	MACS_peak_5534	243.82	352	0	0	0	intergen
13	87439832	87440155	MACS_peak_5535	283.43	323	0	0	3	other
13	87612486	87612693	MACS_peak_5536	613.04	207	0	0	1	other
13	87653113	87653383	MACS_peak_5537	380.3	270	0	0	1	other
13	87669439	87669728	MACS_peak_5538	571.63	289	1	0	1	promoter
13	88427456	88427726	MACS_peak_5539	460.86	270	0	0	0	intergen
13	88458472	88458840	MACS_peak_5540	766.12	368	0	0	0	intergen
13	88682865	88683239	MACS_peak_5541	148.43	374	0	0	0	intergen
13	89066991	89067214	MACS_peak_5542	1043.77	223	0	0	0	intergen
13	89092627	89092976	MACS_peak_5543	118.63	349	0	0	0	intergen
13	89155258	89155482	MACS_peak_5544	357.19	224	0	0	0	intergen
13	89206986	89207200	MACS_peak_5545	209.55	214	0	0	0	intergen
13	89695759	89696118	MACS_peak_5546	647.47	359	0	0	0	intergen
13	89777382	89777734	MACS_peak_5547	652.21	352	0	0	0	intergen
13	89965487	89965916	MACS_peak_5548	388.99	429	0	0	0	intergen
13	90325360	90325737	MACS_peak_5549	69	377	0	0	0	intergen
13	90672008	90672141	MACS_peak_5551	755.02	133	0	0	0	intergen
13	90867344	90867646	MACS_peak_5552	441.54	302	0	0	0	intergen
13	90868394	90868571	MACS_peak_5553	763.02	177	0	0	0	intergen
13	91056363	91056593	MACS_peak_5554	265.34	230	0	0	0	intergen
13	91134248	91134527	MACS_peak_5555	980.98	279	0	0	0	intergen
13	91605337	91605657	MACS_peak_5556	97.3	320	0	1	0	gen
13	91722364	91722565	MACS_peak_5557	645.81	201	0	1	0	gen
13	92125824	92125974	MACS_peak_5559	1274.65	150	0	1	0	gen
13	92521410	92521700	MACS_peak_5560	85.08	290	0	1	0	gen
13	92545578	92545893	MACS_peak_5561	114.74	315	0	1	0	gen
13	92613256	92613709	MACS_peak_5562	1085.02	453	0	1	0	gen
13	92686518	92686829	MACS_peak_5563	67.81	311	0	1	0	gen
13	92690726	92691134	MACS_peak_5564	65.22	408	0	1	0	gen
13	92757313	92757641	MACS_peak_5566	70.8	328	0	1	0	gen
13	93248643	93248821	MACS_peak_5567	763.02	178	0	1	0	gen
13	93541653	93542051	MACS_peak_5569	96.03	398	0	1	0	gen
13	94374325	94374569	MACS_peak_5571	93.41	244	0	1	0	gen
13	95002629	95002857	MACS_peak_5572	198.86	228	0	0	0	intergen
13	95223185	95223458	MACS_peak_5573	458.95	273	0	1	0	gen
13	95350511	95350794	MACS_peak_5574	192.06	283	0	0	0	intergen
13	95380845	95380977	MACS_peak_5575	1116.4	132	0	0	0	intergen
13	96075970	96076265	MACS_peak_5577	445.58	295	0	0	0	intergen
13	96958279	96958589	MACS_peak_5578	437.04	310	0	0	1	other
13	97012494	97012772	MACS_peak_5579	579.67	278	0	0	0	intergen
13	97344412	97344789	MACS_peak_5580	403.51	377	0	1	0	gen
13	97361711	97361934	MACS_peak_5581	462.45	223	0	1	0	gen
13	97461897	97462162	MACS_peak_5582	464.09	265	0	1	0	gen
13	97734589	97734847	MACS_peak_5583	89.53	258	0	0	0	intergen
13	98033393	98033603	MACS_peak_5584	473.4	210	0	0	0	intergen
13	98058900	98059356	MACS_peak_5585	702.21	456	0	0	0	intergen
13	98605924	98606293	MACS_peak_5587	765.37	369	0	0	0	intergen
13	98683205	98683567	MACS_peak_5588	312.33	362	1	0	0	promoter
13	98840198	98840402	MACS_peak_5589	629.38	204	0	1	0	gen
13	99266027	99266192	MACS_peak_5590	1061.85	165	0	1	0	gen
13	99269662	99269933	MACS_peak_5591	460.22	271	0	1	0	gen
13	99528642	99528891	MACS_peak_5592	485.56	249	0	1	0	gen
13	100633953	100634269	MACS_peak_5593	678.2	316	0	1	0	gen
13	101127867	101128070	MACS_peak_5594	612.68	203	0	1	0	gen
13	101155975	101156178	MACS_peak_5595	629.38	203	0	1	0	gen
13	101642117	101642350	MACS_peak_5596	263.69	233	0	1	0	gen
13	101932753	101932886	MACS_peak_5597	1291.76	133	0	1	0	gen
13	101942069	101942384	MACS_peak_5598	434.29	315	0	1	0	gen
13	102154526	102154908	MACS_peak_5599	52.41	382	0	1	0	gen
13	102525151	102525429	MACS_peak_5600	50.92	278	0	0	0	intergen
13	102526934	102527284	MACS_peak_5601	61.44	350	0	0	0	intergen
13	103883066	103883392	MACS_peak_5602	428.39	326	0	0	0	intergen
13	104318066	104318426	MACS_peak_5604	646.8	360	0	0	0	intergen
13	104958963	104959336	MACS_peak_5605	56.38	373	0	0	0	intergen
13	105038341	105038570	MACS_peak_5606	695.57	229	0	0	0	intergen
13	105300246	105300699	MACS_peak_5607	121.82	453	0	0	0	intergen
13	105386376	105386685	MACS_peak_5608	126.67	309	0	0	0	intergen
13	105387536	105387806	MACS_peak_5609	117.17	270	0	0	0	intergen
13	105803076	105803294	MACS_peak_5610	442.94	218	0	0	0	intergen
13	106083675	106083960	MACS_peak_5611	451.52	285	0	0	0	intergen
13	106216700	106217081	MACS_peak_5612	56.65	381	0	0	0	intergen
13	106218375	106218826	MACS_peak_5613	96.97	451	0	0	0	intergen
13	106781401	106781818	MACS_peak_5614	77.64	417	0	0	0	intergen
13	106815941	106816192	MACS_peak_5615	485.56	251	0	0	0	intergen
13	106918124	106918389	MACS_peak_5616	464.09	265	0	0	0	intergen
13	107124219	107124582	MACS_peak_5617	644.81	363	0	0	0	intergen
13	107336939	107337173	MACS_peak_5618	532.66	234	0	1	0	gen
13	107768905	107769195	MACS_peak_5619	156.66	290	0	1	0	gen
13	107769296	107769586	MACS_peak_5620	214.69	290	0	1	0	gen
13	107775300	107775678	MACS_peak_5621	229.83	378	0	1	0	gen
13	107923915	107924303	MACS_peak_5622	50.95	388	0	0	0	intergen
13	108085666	108085827	MACS_peak_5623	1054.55	161	0	0	0	intergen
13	108086552	108086755	MACS_peak_5624	467.74	203	0	0	0	intergen
13	108155580	108155856	MACS_peak_5625	581.17	276	0	0	0	intergen
13	108176689	108176907	MACS_peak_5626	580.62	218	0	0	0	intergen
13	108322241	108322585	MACS_peak_5627	419.18	344	0	0	0	intergen
13	108511059	108511357	MACS_peak_5628	57.07	298	0	0	0	intergen
13	108515792	108516224	MACS_peak_5629	68.08	432	0	0	0	intergen
13	108880284	108880616	MACS_peak_5630	114.74	332	0	1	0	gen
13	108915197	108915422	MACS_peak_5631	548.55	225	0	1	0	gen
13	109023311	109023555	MACS_peak_5632	629.38	244	0	1	0	gen
13	109145604	109145961	MACS_peak_5633	412.83	357	0	1	0	gen
13	109348036	109348195	MACS_peak_5636	310.19	159	0	0	0	intergen
13	109572672	109572805	MACS_peak_5638	1201.31	133	0	0	1	other
13	110051885	110052292	MACS_peak_5640	122.97	407	0	0	1	other
13	110086474	110086786	MACS_peak_5641	435.94	312	0	0	0	intergen
13	110111834	110112191	MACS_peak_5642	55.2	357	0	0	0	intergen
13	110944369	110944597	MACS_peak_5643	1171.45	228	0	0	0	intergen
13	111221106	111221410	MACS_peak_5645	440.4	304	0	1	0	gen
13	111497050	111497464	MACS_peak_5646	51.03	414	0	0	0	intergen
13	112409264	112409613	MACS_peak_5647	62.38	349	0	1	0	gen
13	112573095	112573359	MACS_peak_5648	857.82	264	0	1	0	gen
13	113241400	113241532	MACS_peak_5649	1116.4	132	0	1	0	gen
13	113450994	113451331	MACS_peak_5650	1485.25	337	1	1	0	promoter
13	113621483	113621698	MACS_peak_5651	944.23	215	0	1	0	gen
13	114218849	114219179	MACS_peak_5653	93.4	330	0	1	0	gen
13	114339939	114340140	MACS_peak_5654	989.9	201	0	0	0	intergen
13	18211683	18211905	MACS_peak_21744	564.54	222	0	0	1	other
13	18211998	18212375	MACS_peak_21745	759.47	377	0	0	1	other
13	18212931	18213164	MACS_peak_21746	532.66	233	0	0	1	other
13	18344686	18344854	MACS_peak_21748	1025.76	168	0	0	1	other
14	18225786	18225996	MACS_peak_5655	88.25	210	0	0	0	intergen
14	18232751	18233129	MACS_peak_5656	374.04	378	0	0	0	intergen
14	18242931	18243349	MACS_peak_5659	50.38	418	0	0	0	intergen
14	18244308	18244645	MACS_peak_5660	94.29	337	0	0	0	intergen
14	18247274	18247681	MACS_peak_5661	167.15	407	0	0	0	intergen
14	18253934	18254205	MACS_peak_5662	86.42	271	0	0	0	intergen
14	18259367	18259722	MACS_peak_5663	53.98	355	0	0	0	intergen
14	18259984	18260243	MACS_peak_5664	140.13	259	0	0	0	intergen
14	18266053	18266281	MACS_peak_5669	247.93	228	0	0	0	intergen
14	18275569	18275901	MACS_peak_5670	76.3	332	0	0	0	intergen
14	18277369	18277729	MACS_peak_5671	65.21	360	0	0	0	intergen
14	18294802	18295140	MACS_peak_5672	172.39	338	0	0	0	intergen
14	18568913	18569275	MACS_peak_5673	112.11	362	0	0	1	other
14	18592222	18592618	MACS_peak_5674	1430.48	396	0	0	1	other
14	18608352	18608706	MACS_peak_5675	140.32	354	0	0	0	intergen
14	18670509	18670647	MACS_peak_5676	831.96	138	0	0	0	intergen
14	19053739	19054174	MACS_peak_5678	676.05	435	0	0	1	other
14	19068952	19069272	MACS_peak_5680	247.19	320	0	0	1	other
14	19128356	19128609	MACS_peak_5682	396.92	253	0	0	2	other
14	19188521	19188859	MACS_peak_5683	84.4	338	0	0	0	intergen
14	19171419	19171823	MACS_peak_5684	1605.78	404	0	0	1	other
14	19271384	19271644	MACS_peak_5685	388.99	260	0	0	1	other
14	19330777	19331097	MACS_peak_5687	327.76	320	0	0	1	other
14	19344676	19345025	MACS_peak_5688	1351.62	349	0	0	1	other
14	19414175	19414522	MACS_peak_5690	204.19	347	0	1	0	gen
14	19419907	19420361	MACS_peak_5691	406.4	454	0	1	0	gen
14	19505067	19505318	MACS_peak_5692	52.42	251	0	0	1	other
14	19505562	19505903	MACS_peak_5693	64.24	341	0	0	1	other
14	19667934	19668362	MACS_peak_5694	164.26	428	0	0	2	other
14	19704309	19704609	MACS_peak_5695	145.99	300	0	0	0	intergen
14	19720193	19720583	MACS_peak_5696	109.53	390	1	0	0	promoter
14	19725132	19725558	MACS_peak_5697	831.79	426	0	1	0	gen
14	19999461	19999690	MACS_peak_5698	548.55	229	0	0	0	intergen
14	20068226	20068499	MACS_peak_5700	650.91	273	0	0	0	intergen
14	20082808	20083172	MACS_peak_5701	180.16	364	0	0	0	intergen
14	20107280	20107686	MACS_peak_5702	100.84	406	1	0	0	promoter
14	20233512	20233941	MACS_peak_5703	56.99	429	0	0	0	intergen
14	20237721	20238041	MACS_peak_5705	292.38	320	1	0	0	promoter
14	20238112	20238567	MACS_peak_5706	441.6	455	1	0	0	promoter
14	20606400	20606593	MACS_peak_5707	678.9	193	0	2	1	gen
14	20609338	20609692	MACS_peak_5708	414.27	354	0	2	0	gen
14	20690992	20691364	MACS_peak_5709	763.14	372	0	3	0	gen
14	20861946	20862375	MACS_peak_5710	88.88	429	0	0	0	intergen
14	20873733	20873967	MACS_peak_5711	532.66	234	0	0	0	intergen
14	21067877	21068028	MACS_peak_5712	630.94	151	1	1	0	promoter
14	21068397	21068698	MACS_peak_5713	560.03	301	1	1	0	promoter
14	21092518	21092833	MACS_peak_5714	434.29	315	1	0	0	promoter
14	21104483	21104911	MACS_peak_5715	605.31	428	0	0	0	intergen
14	21135994	21136256	MACS_peak_5716	1428.68	262	0	0	0	intergen
14	21188915	21189333	MACS_peak_5717	149.97	418	0	0	0	intergen
14	21456563	21456927	MACS_peak_5718	582.02	364	1	0	0	promoter
14	21641209	21641401	MACS_peak_5719	2354.81	192	0	0	0	intergen
14	21734390	21734795	MACS_peak_5720	729.82	405	0	0	0	intergen
14	21846293	21846655	MACS_peak_5721	645.47	362	0	0	0	intergen
14	21852135	21852348	MACS_peak_5722	918.92	213	0	0	0	intergen
14	21868428	21868821	MACS_peak_5723	677.09	393	0	0	0	intergen
14	21898637	21898985	MACS_peak_5724	143.04	348	0	0	0	intergen
14	21917921	21918210	MACS_peak_5725	571.63	289	0	0	0	intergen
14	21940949	21941188	MACS_peak_5726	1264.23	239	0	0	0	intergen
14	21978288	21978525	MACS_peak_5727	516.86	237	0	0	0	intergen
14	21987932	21988179	MACS_peak_5728	1061.85	247	0	0	0	intergen
14	22040243	22040519	MACS_peak_5729	710.92	276	0	0	0	intergen
14	22099741	22100020	MACS_peak_5730	708.3	279	0	0	0	intergen
14	22100231	22100519	MACS_peak_5731	572.35	288	0	0	0	intergen
14	22162983	22163311	MACS_peak_5732	669.21	328	0	0	0	intergen
14	22169970	22170201	MACS_peak_5733	678.9	231	0	0	0	intergen
14	22200927	22201282	MACS_peak_5734	650.16	355	0	0	0	intergen
14	22221383	22221796	MACS_peak_5735	613.85	413	0	0	0	intergen
14	22353739	22354109	MACS_peak_5736	172.39	370	0	0	0	intergen
14	22375417	22375672	MACS_peak_5737	729.14	255	0	0	0	intergen
14	22557093	22557462	MACS_peak_5738	521.76	369	0	0	1	other
14	22653111	22653466	MACS_peak_5739	1606.87	355	0	0	0	intergen
14	22657939	22658249	MACS_peak_5740	439.97	310	0	0	0	intergen
14	22872617	22872829	MACS_peak_5741	763.02	212	1	0	0	promoter
14	22953680	22954016	MACS_peak_5742	311.01	336	0	2	1	gen
14	22983413	22983646	MACS_peak_5743	532.66	233	1	0	1	promoter
14	22986426	22986891	MACS_peak_5744	611.86	465	1	0	1	promoter
14	22994753	22994963	MACS_peak_5745	596.67	210	0	1	1	gen
14	23056189	23056497	MACS_peak_5746	438.15	308	1	1	0	promoter
14	23068929	23069191	MACS_peak_5747	723.53	262	0	1	0	gen
14	23120793	23121098	MACS_peak_5748	872.75	305	2	0	0	promoter
14	23317446	23317717	MACS_peak_5749	460.22	271	1	1	0	promoter
14	23562895	23563159	MACS_peak_5750	464.74	264	1	0	1	promoter
14	23722288	23722461	MACS_peak_5751	711.26	173	0	0	0	intergen
14	23899264	23899417	MACS_peak_5752	621.55	153	0	0	0	intergen
14	24002940	24003316	MACS_peak_5753	176.43	376	0	1	1	gen
14	24008925	24009224	MACS_peak_5754	443.26	299	0	0	1	other
14	24020075	24020407	MACS_peak_5755	312.33	332	0	0	1	other
14	24036836	24037017	MACS_peak_5756	1134.69	181	0	0	2	other
14	24112447	24112819	MACS_peak_5757	64.04	372	1	1	0	promoter
14	24279675	24279912	MACS_peak_5758	662.31	237	0	0	0	intergen
14	24308093	24308376	MACS_peak_5759	704.85	283	3	1	0	promoter
14	24327933	24328123	MACS_peak_5760	730.64	190	1	1	0	promoter
14	24332236	24332444	MACS_peak_5761	780.06	208	2	1	0	promoter
14	24450712	24451009	MACS_peak_5762	127.5	297	0	0	0	intergen
14	24489823	24490196	MACS_peak_5763	50.92	373	0	0	0	intergen
14	24522558	24522773	MACS_peak_5764	433.22	215	0	0	0	intergen
14	24584757	24585107	MACS_peak_5765	84.4	350	0	0	0	intergen
14	24678934	24679246	MACS_peak_5766	1226.35	312	0	0	0	intergen
14	24691260	24691527	MACS_peak_5767	833.31	267	0	0	0	intergen
14	24710508	24710773	MACS_peak_5768	1102.85	265	0	0	0	intergen
14	24734960	24735208	MACS_peak_5769	901.33	248	0	0	0	intergen
14	25132893	25133151	MACS_peak_5770	595.17	258	0	0	0	intergen
14	25324509	25324880	MACS_peak_5772	76.3	371	0	0	0	intergen
14	25365647	25365971	MACS_peak_5773	96.97	324	0	0	0	intergen
14	25367550	25367981	MACS_peak_5774	50.4	431	0	0	0	intergen
14	25400715	25400909	MACS_peak_5775	615.76	194	0	0	0	intergen
14	25406024	25406245	MACS_peak_5776	482.68	221	0	0	0	intergen
14	25432902	25433113	MACS_peak_5777	457.61	211	0	0	0	intergen
14	25779115	25779568	MACS_peak_5780	96.21	453	0	0	1	other
14	25780817	25781185	MACS_peak_5781	54.13	368	0	0	1	other
14	25782174	25782374	MACS_peak_5782	99.18	200	0	0	1	other
14	25938924	25939159	MACS_peak_5784	516.86	235	0	0	2	other
14	25947785	25948128	MACS_peak_5785	55.36	343	0	0	2	other
14	25948196	25948576	MACS_peak_5786	64.17	380	0	0	2	other
14	25983048	25983286	MACS_peak_5788	364.27	238	0	0	2	other
14	26296098	26296515	MACS_peak_5789	133.07	417	0	0	0	intergen
14	26296649	26296917	MACS_peak_5790	120.56	268	0	0	0	intergen
14	26297421	26297839	MACS_peak_5791	51.86	418	0	0	0	intergen
14	26299655	26300006	MACS_peak_5792	72.97	351	0	0	0	intergen
14	26393992	26394340	MACS_peak_5793	760.25	348	0	0	0	intergen
14	26688671	26688965	MACS_peak_5794	83.45	294	0	0	1	other
14	26940791	26941053	MACS_peak_5795	838.54	262	0	0	1	other
14	27224733	27225076	MACS_peak_5797	63.61	343	0	0	0	intergen
14	27264164	27264602	MACS_peak_5798	194.77	438	0	0	1	other
14	27316887	27317114	MACS_peak_5799	548.55	227	0	0	1	other
14	27459674	27460055	MACS_peak_5800	58.58	381	0	0	1	other
14	27728136	27728397	MACS_peak_5801	860.98	261	0	0	1	other
14	28166400	28166628	MACS_peak_5802	349.1	228	0	0	0	intergen
14	28178200	28178587	MACS_peak_5803	158.42	387	0	0	0	intergen
14	28190569	28191000	MACS_peak_5804	178.98	431	0	0	0	intergen
14	28191526	28191911	MACS_peak_5805	51.81	385	0	0	0	intergen
14	28293031	28293273	MACS_peak_5807	487.14	242	0	0	0	intergen
14	28312953	28313288	MACS_peak_5808	73.22	335	0	0	0	intergen
14	28315190	28315512	MACS_peak_5809	81.74	322	0	0	0	intergen
14	28482474	28482754	MACS_peak_5811	454.58	280	0	0	0	intergen
14	28596359	28596785	MACS_peak_5812	606.43	426	0	0	1	other
14	28609211	28609544	MACS_peak_5813	793.64	333	0	0	1	other
14	28664165	28664520	MACS_peak_5814	1040	355	0	0	0	intergen
14	28801006	28801170	MACS_peak_5815	831.63	164	0	0	2	other
14	28814317	28814532	MACS_peak_5816	596.79	215	0	0	1	other
14	28818132	28818437	MACS_peak_5817	624.29	305	0	0	1	other
14	29003739	29004125	MACS_peak_5818	61.04	386	0	0	2	other
14	29222723	29222964	MACS_peak_5819	797.18	241	0	0	0	intergen
14	29251317	29251688	MACS_peak_5820	195.4	371	0	0	0	intergen
14	29478596	29478988	MACS_peak_5821	53.41	392	0	0	0	intergen
14	29481250	29481493	MACS_peak_5822	78.56	243	0	0	0	intergen
14	29536856	29537194	MACS_peak_5823	789.53	338	0	0	0	intergen
14	29779980	29780299	MACS_peak_5824	109.11	319	0	1	0	gen
14	29900482	29900771	MACS_peak_5825	1403.04	289	0	1	0	gen
14	30270733	30270949	MACS_peak_5826	901.33	216	0	0	1	other
14	30475417	30475729	MACS_peak_5827	109.35	312	0	0	1	other
14	30521959	30522277	MACS_peak_5828	676.68	318	0	0	1	other
14	30562227	30562554	MACS_peak_5829	258.94	327	1	0	1	promoter
14	30656168	30656457	MACS_peak_5830	449.12	289	0	1	0	gen
14	30666197	30666435	MACS_peak_5831	100.83	238	0	1	0	gen
14	30666512	30666816	MACS_peak_5832	132.69	304	0	1	0	gen
14	30681705	30682092	MACS_peak_5833	575.04	387	0	1	0	gen
14	30980230	30980535	MACS_peak_5835	825.19	305	0	1	0	gen
14	31082028	31082333	MACS_peak_5836	686.76	305	0	1	0	gen
14	31127996	31128246	MACS_peak_5837	485.56	250	0	1	0	gen
14	31277901	31278156	MACS_peak_5838	264.71	255	0	0	1	other
14	31355962	31356298	MACS_peak_5839	423.21	336	0	2	0	gen
14	31450026	31450395	MACS_peak_5840	876.48	369	1	1	1	promoter
14	31568774	31569054	MACS_peak_5841	454.58	280	0	1	0	gen
14	31653676	31653981	MACS_peak_5842	480.74	305	0	1	0	gen
14	31756460	31756832	MACS_peak_5843	69.02	372	0	1	0	gen
14	31796597	31796875	MACS_peak_5844	62.25	278	0	1	0	gen
14	31807511	31807857	MACS_peak_5845	67.2	346	0	1	0	gen
14	31923605	31923828	MACS_peak_5846	614.29	223	0	0	0	intergen
14	32118980	32119330	MACS_peak_5847	616.56	350	0	1	0	gen
14	32252163	32252464	MACS_peak_5848	563.21	301	0	0	0	intergen
14	32366477	32366877	MACS_peak_5849	504.65	400	0	1	0	gen
14	32560346	32560586	MACS_peak_5850	777.13	240	0	1	0	gen
14	32573525	32573787	MACS_peak_5851	312.33	262	0	1	0	gen
14	32576136	32576519	MACS_peak_5852	590.64	383	0	1	0	gen
14	32993382	32993599	MACS_peak_5853	901.33	217	0	1	0	gen
14	33342530	33342847	MACS_peak_5854	1364.65	317	0	1	0	gen
14	33475726	33475939	MACS_peak_5855	759.43	213	0	1	0	gen
14	33496614	33496851	MACS_peak_5856	376.34	237	0	1	0	gen
14	33792783	33793036	MACS_peak_5857	596.79	253	0	1	0	gen
14	33827749	33828130	MACS_peak_5858	83.57	381	0	0	0	intergen
14	33849179	33849507	MACS_peak_5859	545.46	328	0	0	0	intergen
14	33854135	33854375	MACS_peak_5860	516.86	240	0	0	0	intergen
14	34228080	34228337	MACS_peak_5861	865.27	257	0	1	0	gen
14	34295969	34296317	MACS_peak_5862	55.83	348	0	1	0	gen
14	34324325	34324631	MACS_peak_5863	423.97	306	0	1	0	gen
14	34348186	34348651	MACS_peak_5864	631.45	465	0	1	0	gen
14	34349730	34350109	MACS_peak_5866	1017.46	379	0	1	0	gen
14	34672708	34672907	MACS_peak_5867	645.81	199	0	0	0	intergen
14	35215138	35215333	MACS_peak_5868	848.95	195	0	2	0	gen
14	35229563	35229911	MACS_peak_5869	596.75	348	0	2	0	gen
14	35437652	35437784	MACS_peak_5871	977.06	132	0	0	0	intergen
14	35620301	35620649	MACS_peak_5872	227.21	348	0	1	0	gen
14	35879676	35879962	MACS_peak_5873	1558.15	286	0	1	0	gen
14	36120203	36120456	MACS_peak_5874	124.75	253	0	0	1	other
14	36120869	36121238	MACS_peak_5875	53.86	369	0	0	1	other
14	36186641	36186996	MACS_peak_5876	50.72	355	0	0	0	intergen
14	36413967	36414247	MACS_peak_5878	105.65	280	0	0	1	other
14	36553721	36553959	MACS_peak_5879	2127.88	238	0	0	1	other
14	36556873	36557122	MACS_peak_5880	1043.77	249	0	0	1	other
14	36781251	36781491	MACS_peak_5881	936.57	240	0	1	0	gen
14	36892542	36892901	MACS_peak_5883	179.12	359	0	1	0	gen
14	36942332	36942570	MACS_peak_5884	932.35	238	0	1	0	gen
14	37015511	37015838	MACS_peak_5885	121.38	327	0	1	0	gen
14	37015979	37016305	MACS_peak_5886	99.41	326	0	1	0	gen
14	37117632	37117893	MACS_peak_5887	466.72	261	0	1	0	gen
14	37149733	37150160	MACS_peak_5888	611.86	427	0	1	0	gen
14	37230702	37230918	MACS_peak_5889	1079.97	216	0	1	0	gen
14	37295498	37295747	MACS_peak_5890	133.99	249	0	1	0	gen
14	37446218	37446553	MACS_peak_5891	83.8	335	0	1	0	gen
14	37446564	37446938	MACS_peak_5892	119.37	374	0	1	0	gen
14	37594232	37594698	MACS_peak_5893	701.41	466	2	0	0	promoter
14	37682334	37682630	MACS_peak_5894	445	296	0	1	0	gen
14	37709467	37709858	MACS_peak_5895	1417.64	391	0	1	0	gen
14	37724321	37724541	MACS_peak_5896	471.49	220	0	1	0	gen
14	37890193	37890429	MACS_peak_5897	814.37	236	0	1	0	gen
14	37922104	37922467	MACS_peak_5898	114.74	363	0	1	0	gen
14	37923112	37923385	MACS_peak_5899	301.99	273	0	1	0	gen
14	37951746	37952033	MACS_peak_5900	157.2	287	0	1	0	gen
14	37985937	37986148	MACS_peak_5901	1116.4	211	0	1	0	gen
14	38147248	38147436	MACS_peak_5903	844.69	188	0	0	1	other
14	38197261	38197574	MACS_peak_5904	522.37	313	0	0	1	other
14	38583470	38583716	MACS_peak_5905	508.42	246	0	0	0	intergen
14	38693499	38693731	MACS_peak_5907	678.9	232	0	0	0	intergen
14	38714673	38715056	MACS_peak_5908	89.02	383	0	0	0	intergen
14	38715073	38715352	MACS_peak_5909	112.84	279	0	0	0	intergen
14	38721876	38722142	MACS_peak_5910	488.85	266	0	0	0	intergen
14	38922893	38923262	MACS_peak_5911	90.74	369	0	0	1	other
14	38967699	38968043	MACS_peak_5912	103.45	344	0	0	0	intergen
14	38985175	38985505	MACS_peak_5913	180.31	330	0	0	0	intergen
14	38985563	38985944	MACS_peak_5914	120.5	381	0	0	0	intergen
14	39003470	39003746	MACS_peak_5915	1126.98	276	0	0	0	intergen
14	39022050	39022425	MACS_peak_5916	99.55	375	0	0	0	intergen
14	39022437	39022760	MACS_peak_5917	94.16	323	0	0	0	intergen
14	39034695	39034997	MACS_peak_5918	441.54	302	1	0	0	promoter
14	39091727	39091928	MACS_peak_5919	1354.48	201	0	1	0	gen
14	39262875	39263277	MACS_peak_5920	171.46	402	0	1	0	gen
14	39517231	39517637	MACS_peak_5922	149.7	406	0	0	0	intergen
14	39584906	39585209	MACS_peak_5923	115.85	303	0	0	0	intergen
14	39820946	39821363	MACS_peak_5924	149.97	417	0	0	0	intergen
14	39935951	39936279	MACS_peak_5925	50.79	328	0	0	0	intergen
14	39989021	39989241	MACS_peak_5926	564.54	220	0	0	0	intergen
14	40012916	40013147	MACS_peak_5927	483.43	231	0	0	0	intergen
14	40331284	40331486	MACS_peak_5929	184.18	202	0	0	0	intergen
14	40349762	40350160	MACS_peak_5930	107.13	398	0	0	0	intergen
14	40379849	40380184	MACS_peak_5932	118.15	335	0	0	0	intergen
14	40423557	40424026	MACS_peak_5933	110.52	469	0	0	0	intergen
14	40730034	40730383	MACS_peak_5935	129.98	349	0	0	0	intergen
14	40949967	40950257	MACS_peak_5936	63.52	290	0	0	0	intergen
14	41084678	41084926	MACS_peak_5937	831.96	248	0	0	0	intergen
14	41100490	41100758	MACS_peak_5938	462.14	268	0	0	0	intergen
14	41280856	41281069	MACS_peak_5939	584.94	213	0	0	0	intergen
14	41347145	41347608	MACS_peak_5940	824.05	463	0	0	0	intergen
14	41526329	41526466	MACS_peak_5941	1178.47	137	0	0	0	intergen
14	41539486	41539793	MACS_peak_5942	1236.43	307	0	0	0	intergen
14	41586377	41586624	MACS_peak_5943	573.39	247	0	0	0	intergen
14	41933753	41934009	MACS_peak_5944	729.14	256	0	0	0	intergen
14	41940429	41940740	MACS_peak_5945	380.3	311	0	0	0	intergen
14	42051036	42051461	MACS_peak_5946	634.13	425	0	0	0	intergen
14	42092750	42093105	MACS_peak_5947	413.79	355	0	0	0	intergen
14	42224322	42224727	MACS_peak_5948	488.85	405	0	0	0	intergen
14	42255821	42256167	MACS_peak_5949	79.13	346	0	0	0	intergen
14	42515174	42515431	MACS_peak_5950	728.2	257	0	0	2	other
14	42552440	42552633	MACS_peak_5951	678.9	193	0	0	1	other
14	42567975	42568341	MACS_peak_5952	118.82	366	0	0	1	other
14	42611520	42611765	MACS_peak_5953	629.38	245	0	0	1	other
14	42675888	42676106	MACS_peak_5954	666.39	218	0	0	1	other
14	42956073	42956366	MACS_peak_5955	57.12	293	0	0	0	intergen
14	42968136	42968547	MACS_peak_5956	98.91	411	0	0	0	intergen
14	43065631	43065993	MACS_peak_5957	58.85	362	0	0	0	intergen
14	43067445	43067756	MACS_peak_5958	87.14	311	0	0	0	intergen
14	43165148	43165362	MACS_peak_5959	746.04	214	0	0	0	intergen
14	43265507	43265833	MACS_peak_5960	115.96	326	0	0	0	intergen
14	43414531	43414722	MACS_peak_5962	695.57	191	0	0	0	intergen
14	43449721	43450017	MACS_peak_5963	3100	296	0	0	0	intergen
14	43496994	43497419	MACS_peak_5964	113.26	425	0	0	0	intergen
14	43602470	43602775	MACS_peak_5965	139.5	305	0	0	0	intergen
14	43795674	43796155	MACS_peak_5966	1615.5	481	0	0	0	intergen
14	44025551	44025915	MACS_peak_5967	51.29	364	0	0	1	other
14	44083218	44083566	MACS_peak_5968	125.63	348	0	0	1	other
14	44159146	44159512	MACS_peak_5969	313.82	366	0	0	1	other
14	44322054	44322385	MACS_peak_5970	273.88	331	0	0	1	other
14	44554469	44554824	MACS_peak_5971	118	355	0	0	0	intergen
14	44590038	44590239	MACS_peak_5972	773.69	201	0	0	0	intergen
14	44616127	44616308	MACS_peak_5973	682.84	181	0	0	0	intergen
14	44675885	44676255	MACS_peak_5976	75.01	370	0	0	0	intergen
14	44735244	44735381	MACS_peak_5977	638.45	137	0	0	0	intergen
14	44859076	44859441	MACS_peak_5978	140.12	365	0	0	0	intergen
14	44913711	44913949	MACS_peak_5979	729.92	238	0	0	0	intergen
14	45268594	45268859	MACS_peak_5980	450.75	265	0	0	0	intergen
14	45324163	45324542	MACS_peak_5981	146.55	379	0	0	0	intergen
14	45349698	45350102	MACS_peak_5982	221.03	404	0	0	0	intergen
14	45426760	45427139	MACS_peak_5983	402.61	379	0	0	0	intergen
14	45476882	45477146	MACS_peak_5984	103.32	264	0	0	0	intergen
14	45477652	45477899	MACS_peak_5985	101.04	247	0	0	0	intergen
14	45527401	45527773	MACS_peak_5986	638.92	372	0	0	0	intergen
14	45650831	45651087	MACS_peak_5988	596.79	256	0	0	0	intergen
14	45716596	45716834	MACS_peak_5989	662.31	238	0	0	0	intergen
14	45884256	45884549	MACS_peak_5990	77.42	293	0	0	0	intergen
14	45928368	45928751	MACS_peak_5991	130.84	383	0	0	0	intergen
14	45931142	45931455	MACS_peak_5992	300.41	313	0	0	0	intergen
14	46010947	46011390	MACS_peak_5993	879.18	443	0	0	1	other
14	46127376	46127618	MACS_peak_5994	501.16	242	0	0	1	other
14	46152189	46152503	MACS_peak_5995	114.74	314	0	0	1	other
14	46152537	46152841	MACS_peak_5996	77.1	304	0	0	1	other
14	46180858	46181238	MACS_peak_5997	57.18	380	0	0	1	other
14	46181750	46182159	MACS_peak_5998	81.72	409	0	0	1	other
14	46207381	46207751	MACS_peak_5999	87.08	370	0	0	1	other
14	46250107	46250434	MACS_peak_6000	669.95	327	0	0	1	other
14	46269975	46270167	MACS_peak_6001	604.83	192	0	0	1	other
14	46275133	46275276	MACS_peak_6002	711.17	143	0	0	1	other
14	46306568	46306875	MACS_peak_6003	947.74	307	0	0	1	other
14	46427963	46428338	MACS_peak_6005	82.29	375	0	0	1	other
14	46581016	46581385	MACS_peak_6006	407.18	369	0	0	0	intergen
14	46613245	46613435	MACS_peak_6007	627.46	190	0	0	0	intergen
14	46727240	46727597	MACS_peak_6008	115.17	357	0	0	0	intergen
14	46786736	46787139	MACS_peak_6009	172.39	403	0	0	0	intergen
14	46882491	46882801	MACS_peak_6010	201.59	310	0	1	0	gen
14	47129694	47130065	MACS_peak_6011	79.7	371	0	1	0	gen
14	47175940	47176278	MACS_peak_6012	116.45	338	0	1	0	gen
14	47176913	47177385	MACS_peak_6013	113.77	472	0	1	0	gen
14	47333014	47333319	MACS_peak_6014	439.84	305	0	1	0	gen
14	47697153	47697488	MACS_peak_6015	541.11	335	0	0	0	intergen
14	47795942	47796357	MACS_peak_6016	73.64	415	0	0	0	intergen
14	47796697	47797054	MACS_peak_6017	82.04	357	0	0	0	intergen
14	47798121	47798496	MACS_peak_6018	56.61	375	0	0	0	intergen
14	47903309	47903725	MACS_peak_6019	109.79	416	0	0	0	intergen
14	47904037	47904516	MACS_peak_6020	101.11	479	0	0	0	intergen
14	47917422	47917735	MACS_peak_6021	945.2	313	0	0	0	intergen
14	48047200	48047454	MACS_peak_6022	596.79	254	0	0	0	intergen
14	48190156	48190450	MACS_peak_6023	75.06	294	0	0	0	intergen
14	48190918	48191298	MACS_peak_6024	64.89	380	0	0	0	intergen
14	48191841	48192220	MACS_peak_6025	59.19	379	0	0	0	intergen
14	48301798	48302115	MACS_peak_6026	433.2	317	0	0	0	intergen
14	48314301	48314606	MACS_peak_6027	208.73	305	0	0	0	intergen
14	48332363	48332590	MACS_peak_6028	400.49	227	0	0	0	intergen
14	48414182	48414505	MACS_peak_6029	94.16	323	0	0	1	other
14	48452066	48452281	MACS_peak_6030	657.66	215	0	0	1	other
14	48482508	48482731	MACS_peak_6031	275.94	223	0	0	1	other
14	48485904	48486230	MACS_peak_6032	156.13	326	0	0	1	other
14	48572874	48573213	MACS_peak_6033	147.25	339	0	0	0	intergen
14	48573857	48574279	MACS_peak_6034	179.22	422	0	0	0	intergen
14	48754473	48754867	MACS_peak_6035	625.13	394	0	0	0	intergen
14	48938446	48938793	MACS_peak_6036	373.49	347	0	0	0	intergen
14	49100124	49100344	MACS_peak_6037	65.87	220	0	0	0	intergen
14	49186587	49186829	MACS_peak_6039	886.13	242	0	0	0	intergen
14	49362206	49362499	MACS_peak_6040	178.37	293	0	0	0	intergen
14	49394811	49395061	MACS_peak_6041	149.41	250	0	0	0	intergen
14	49497765	49498072	MACS_peak_6042	685.18	307	0	0	0	intergen
14	49534254	49534589	MACS_peak_6043	69	335	0	0	0	intergen
14	49536472	49536685	MACS_peak_6044	607.68	213	0	0	0	intergen
14	49586929	49587176	MACS_peak_6045	485.56	247	0	1	0	gen
14	49830176	49830411	MACS_peak_6046	502.51	235	0	1	0	gen
14	49853856	49854073	MACS_peak_6047	901.33	217	0	0	0	intergen
14	49862029	49862308	MACS_peak_6048	916.24	279	0	0	1	other
14	49865482	49865685	MACS_peak_6049	1080.52	203	0	0	0	intergen
14	49912581	49912808	MACS_peak_6050	435.26	227	0	0	0	intergen
14	50075450	50075859	MACS_peak_6051	215.62	409	0	0	1	other
14	50105090	50105285	MACS_peak_6052	869.22	195	1	0	0	promoter
14	50236739	50237095	MACS_peak_6053	268.76	356	1	0	0	promoter
14	50243545	50243846	MACS_peak_6054	141.59	301	0	1	0	gen
14	50619647	50619896	MACS_peak_6055	397.9	249	0	1	0	gen
14	50714540	50714748	MACS_peak_6056	770.35	208	0	0	0	intergen
14	50755546	50755781	MACS_peak_6057	516.86	235	0	1	0	gen
14	50773766	50773967	MACS_peak_6058	645.81	201	0	1	0	gen
14	50777850	50778216	MACS_peak_6059	1165.72	366	0	1	0	gen
14	51215185	51215527	MACS_peak_6060	143.23	342	0	0	0	intergen
14	51217207	51217434	MACS_peak_6061	1026.08	227	0	0	0	intergen
14	51219937	51220201	MACS_peak_6062	319.23	264	0	0	0	intergen
14	51250173	51250429	MACS_peak_6063	666.39	256	0	1	0	gen
14	51283376	51283691	MACS_peak_6064	553.81	315	0	0	0	intergen
14	51312814	51313113	MACS_peak_6065	86.52	299	0	0	1	other
14	51701110	51701312	MACS_peak_6066	645.81	202	0	1	0	gen
14	51780150	51780430	MACS_peak_6067	707.43	280	0	0	1	other
14	51796592	51796881	MACS_peak_6068	68.26	289	0	0	1	other
14	51838479	51838737	MACS_peak_6069	468.72	258	0	1	0	gen
14	52015599	52015898	MACS_peak_6070	443.26	299	0	1	0	gen
14	52146609	52146876	MACS_peak_6071	418.12	267	0	0	0	intergen
14	52226181	52226554	MACS_peak_6072	114.57	373	0	0	0	intergen
14	52257562	52257921	MACS_peak_6073	97.63	359	0	0	0	intergen
14	52261670	52261960	MACS_peak_6074	142.21	290	0	0	0	intergen
14	52375446	52375739	MACS_peak_6075	446.75	293	0	0	0	intergen
14	52387639	52387944	MACS_peak_6076	89.5	305	0	0	0	intergen
14	52448005	52448335	MACS_peak_6077	488.85	330	0	1	0	gen
14	52529774	52530035	MACS_peak_6078	410.97	261	0	1	0	gen
14	52807743	52807998	MACS_peak_6080	456.71	255	0	0	2	other
14	52904551	52904914	MACS_peak_6081	819.05	363	0	1	1	gen
14	53055010	53055299	MACS_peak_6082	968.45	289	0	1	0	gen
14	53267092	53267456	MACS_peak_6083	108.86	364	0	0	1	other
14	53271097	53271479	MACS_peak_6084	50.92	382	0	0	1	other
14	53301172	53301502	MACS_peak_6085	67.82	330	0	0	1	other
14	53320234	53320541	MACS_peak_6086	148.53	307	0	0	1	other
14	53323256	53323687	MACS_peak_6087	186.49	431	0	0	1	other
14	53339399	53339661	MACS_peak_6088	591.97	262	0	0	1	other
14	53432343	53432526	MACS_peak_6089	688.89	183	0	0	1	other
14	53792922	53793231	MACS_peak_6090	437.6	309	0	0	2	other
14	53802575	53802877	MACS_peak_6091	164.26	302	0	0	2	other
14	54018671	54018909	MACS_peak_6093	777.11	238	0	0	0	intergen
14	54025635	54025996	MACS_peak_6094	305.92	361	0	0	0	intergen
14	54175368	54175653	MACS_peak_6096	451.52	285	0	0	0	intergen
14	54238850	54239254	MACS_peak_6098	84.68	404	0	0	0	intergen
14	54372598	54372809	MACS_peak_6099	368.39	211	0	0	0	intergen
14	54403026	54403301	MACS_peak_6100	69	275	0	1	0	gen
14	54489059	54489287	MACS_peak_6101	548.55	228	0	0	0	intergen
14	54564037	54564338	MACS_peak_6102	689.95	301	1	0	0	promoter
14	54691581	54691873	MACS_peak_6103	515.96	292	0	1	0	gen
14	54753535	54753730	MACS_peak_6104	514.01	195	0	1	0	gen
14	54903077	54903457	MACS_peak_6105	402.16	380	0	0	0	intergen
14	54950974	54951332	MACS_peak_6106	63.49	358	0	1	0	gen
14	54981782	54982015	MACS_peak_6107	429.38	233	0	1	0	gen
14	55051430	55051675	MACS_peak_6108	501.16	245	1	0	0	promoter
14	55161131	55161326	MACS_peak_6109	490.85	195	0	1	0	gen
14	55213041	55213379	MACS_peak_6110	629.4	338	0	0	0	intergen
14	55242515	55242814	MACS_peak_6111	959.43	299	0	0	0	intergen
14	55280350	55280707	MACS_peak_6113	443.57	357	0	1	0	gen
14	55297934	55298313	MACS_peak_6114	515.71	379	0	1	0	gen
14	55322992	55323345	MACS_peak_6115	272.05	353	0	1	0	gen
14	55438082	55438364	MACS_peak_6116	523.12	282	0	1	0	gen
14	55503997	55504211	MACS_peak_6117	580.75	214	0	0	1	other
14	55650216	55650575	MACS_peak_6118	359.51	359	0	1	0	gen
14	55661221	55661564	MACS_peak_6119	312.33	343	0	1	0	gen
14	55731928	55732251	MACS_peak_6120	821.02	323	0	0	0	intergen
14	55812997	55813249	MACS_peak_6121	142.68	252	0	0	0	intergen
14	55875292	55875452	MACS_peak_6122	1098.16	160	0	0	0	intergen
14	55989291	55989718	MACS_peak_6123	72.96	427	0	0	0	intergen
14	56018148	56018550	MACS_peak_6125	60.38	402	0	0	0	intergen
14	56232243	56232538	MACS_peak_6126	159.44	295	0	1	0	gen
14	56247570	56247927	MACS_peak_6127	648.81	357	0	1	0	gen
14	56280866	56281156	MACS_peak_6128	312.33	290	0	1	0	gen
14	56340171	56340415	MACS_peak_6129	629.38	244	0	0	1	other
14	56422674	56422916	MACS_peak_6130	645.81	242	0	0	0	intergen
14	56445284	56445571	MACS_peak_6131	55.92	287	0	0	0	intergen
14	56556009	56556219	MACS_peak_6132	760.34	210	0	1	0	gen
14	56579236	56579652	MACS_peak_6133	857.05	416	0	1	0	gen
14	56645033	56645392	MACS_peak_6134	137.17	359	0	1	1	gen
14	57012594	57012928	MACS_peak_6135	845.32	334	0	0	1	other
14	57108623	57108889	MACS_peak_6136	341.01	266	0	0	2	other
14	57115208	57115649	MACS_peak_6137	131.02	441	0	0	1	other
14	57116634	57117083	MACS_peak_6138	60.71	449	0	0	1	other
14	57183006	57183356	MACS_peak_6139	955.64	350	0	0	0	intergen
14	57202741	57202974	MACS_peak_6140	525.73	233	1	0	0	promoter
14	57294225	57294571	MACS_peak_6141	656.34	346	0	1	0	gen
14	57339447	57339924	MACS_peak_6142	94.52	477	0	0	0	intergen
14	57339962	57340293	MACS_peak_6143	89.98	331	0	0	0	intergen
14	57340843	57341252	MACS_peak_6144	51.32	409	0	0	0	intergen
14	57454737	57454875	MACS_peak_6145	704.53	138	0	0	0	intergen
14	57551974	57552273	MACS_peak_6146	110.5	299	0	0	0	intergen
14	57620964	57621279	MACS_peak_6147	118.28	315	0	1	0	gen
14	57621687	57622067	MACS_peak_6148	134.53	380	0	1	0	gen
14	57910046	57910278	MACS_peak_6149	810.9	232	0	1	0	gen
14	58034205	58034425	MACS_peak_6150	75.54	220	0	1	0	gen
14	58037219	58037535	MACS_peak_6151	115.17	316	0	1	0	gen
14	58108036	58108245	MACS_peak_6152	954.29	209	0	1	0	gen
14	58166479	58166731	MACS_peak_6153	746.04	252	0	1	0	gen
14	58208534	58208739	MACS_peak_6154	612.68	205	0	2	0	gen
14	58501172	58501487	MACS_peak_6155	884.12	315	0	1	0	gen
14	58870272	58870406	MACS_peak_6156	712.83	134	0	0	1	other
14	59022088	59022388	MACS_peak_6157	442.68	300	0	0	0	intergen
14	59028587	59028967	MACS_peak_6158	515.17	380	0	0	0	intergen
14	59055513	59055792	MACS_peak_6159	1551.79	279	0	0	0	intergen
14	59507384	59507620	MACS_peak_6160	516.86	236	1	0	1	promoter
14	59533879	59534191	MACS_peak_6162	634.13	312	0	1	0	gen
14	59576736	59577058	MACS_peak_6163	669.96	322	0	0	0	intergen
14	59883141	59883294	MACS_peak_6165	918.92	153	0	0	0	intergen
14	59918756	59919201	MACS_peak_6166	482.85	445	1	0	0	promoter
14	59947915	59948222	MACS_peak_6167	63.11	307	0	1	0	gen
14	59950412	59950844	MACS_peak_6169	67.11	432	0	1	0	gen
14	60064535	60064828	MACS_peak_6170	696.46	293	0	0	1	other
14	60079810	60080083	MACS_peak_6171	376.45	273	0	0	1	other
14	60268318	60268567	MACS_peak_6172	525.79	249	0	1	0	gen
14	60331795	60332086	MACS_peak_6173	380.3	291	0	0	0	intergen
14	60340212	60340536	MACS_peak_6174	62.38	324	0	0	0	intergen
14	60341815	60342168	MACS_peak_6175	123.81	353	0	0	0	intergen
14	60349936	60350185	MACS_peak_6176	485.56	249	0	0	0	intergen
14	60424423	60424796	MACS_peak_6177	100.22	373	0	1	0	gen
14	60887653	60888050	MACS_peak_6179	94.4	397	0	1	1	gen
14	60910917	60911259	MACS_peak_6180	90.24	342	0	1	1	gen
14	61011507	61011798	MACS_peak_6181	122.82	291	0	1	0	gen
14	61025316	61025556	MACS_peak_6182	502.51	240	0	1	0	gen
14	61155754	61155912	MACS_peak_6183	767.82	158	0	0	0	intergen
14	61252857	61253149	MACS_peak_6184	447.34	292	0	1	0	gen
14	61286247	61286563	MACS_peak_6185	808.09	316	0	1	0	gen
14	61296861	61297254	MACS_peak_6186	874.63	393	0	1	0	gen
14	61456653	61456934	MACS_peak_6187	706.57	281	0	1	0	gen
14	61461809	61461991	MACS_peak_6188	666.39	182	0	1	0	gen
14	61481978	61482118	MACS_peak_6189	1921	140	0	1	0	gen
14	61708070	61708364	MACS_peak_6190	99.82	294	0	1	0	gen
14	61837711	61837950	MACS_peak_6191	642.42	239	0	1	0	gen
14	61860294	61860613	MACS_peak_6192	551.21	319	0	1	0	gen
14	61958262	61958549	MACS_peak_6193	1556.58	287	0	1	0	gen
14	62046045	62046409	MACS_peak_6194	82.23	364	0	1	0	gen
14	62126959	62127318	MACS_peak_6195	488.85	359	0	0	1	other
14	62157571	62157802	MACS_peak_6196	532.66	231	0	0	0	intergen
14	62193530	62193747	MACS_peak_6197	528	217	0	0	0	intergen
14	62197726	62197957	MACS_peak_6198	358.93	231	0	0	0	intergen
14	62525298	62525619	MACS_peak_6199	170.5	321	0	0	0	intergen
14	62536311	62536539	MACS_peak_6200	134.65	228	0	0	0	intergen
14	62540277	62540681	MACS_peak_6201	53.77	404	0	0	0	intergen
14	62635107	62635239	MACS_peak_6203	691.34	132	0	0	0	intergen
14	62641943	62642335	MACS_peak_6204	89.02	392	0	0	0	intergen
14	62874485	62874945	MACS_peak_6205	134.63	460	0	1	0	gen
14	62876954	62877299	MACS_peak_6206	159.99	345	0	1	0	gen
14	62877625	62877984	MACS_peak_6207	101.28	359	0	1	0	gen
14	63104813	63105144	MACS_peak_6208	326.93	331	0	0	0	intergen
14	63222367	63222848	MACS_peak_6210	203.12	481	0	1	0	gen
14	63276832	63277065	MACS_peak_6211	532.66	233	0	1	0	gen
14	63308837	63309003	MACS_peak_6212	1043.77	166	1	0	0	promoter
14	63388937	63389202	MACS_peak_6213	464.09	265	0	1	0	gen
14	63398322	63398543	MACS_peak_6214	729.14	221	0	1	0	gen
14	63563015	63563389	MACS_peak_6215	449.15	374	0	0	0	intergen
14	63641464	63641642	MACS_peak_6216	1422.04	178	0	1	0	gen
14	63799558	63799940	MACS_peak_6217	351.75	382	0	0	0	intergen
14	64303470	64303792	MACS_peak_6218	673.67	322	0	1	0	gen
14	64430063	64430278	MACS_peak_6219	543.04	215	0	1	1	gen
14	64511174	64511379	MACS_peak_6220	573.39	205	0	1	0	gen
14	64636781	64637025	MACS_peak_6221	780.06	244	0	0	0	intergen
14	64697972	64698207	MACS_peak_6222	516.86	235	0	0	0	intergen
14	64910948	64911137	MACS_peak_6223	973.44	189	2	0	0	promoter
14	64983816	64984180	MACS_peak_6224	693.48	364	1	1	0	promoter
14	65222385	65222681	MACS_peak_6225	445	296	0	0	0	intergen
14	65415081	65415378	MACS_peak_6226	444.41	297	1	0	0	promoter
14	65420437	65420654	MACS_peak_6227	577.49	217	0	1	0	gen
14	65632329	65632540	MACS_peak_6228	508.42	211	0	1	0	gen
14	65663438	65663653	MACS_peak_6229	918.92	215	0	1	0	gen
14	65694637	65694922	MACS_peak_6230	260.52	285	0	1	0	gen
14	65856834	65857178	MACS_peak_6231	135.01	344	0	0	0	intergen
14	66027982	66028243	MACS_peak_6233	88.13	261	0	0	0	intergen
14	66401521	66401809	MACS_peak_6234	319.09	288	0	0	1	other
14	66474567	66474815	MACS_peak_6235	104.77	248	0	1	1	gen
14	66495544	66495851	MACS_peak_6236	1000.65	307	0	1	1	gen
14	66583795	66584176	MACS_peak_6237	75.42	381	0	1	0	gen
14	66746346	66746764	MACS_peak_6238	411.81	418	0	1	0	gen
14	66751891	66752057	MACS_peak_6239	1019.02	166	0	1	0	gen
14	66836286	66836668	MACS_peak_6240	81.03	382	0	1	0	gen
14	66958953	66959227	MACS_peak_6241	322.46	274	0	1	0	gen
14	67213442	67213759	MACS_peak_6243	79.58	317	0	1	0	gen
14	67584129	67584422	MACS_peak_6244	446.75	293	1	1	0	promoter
14	67837027	67837371	MACS_peak_6245	374.96	344	0	1	0	gen
14	67870610	67870991	MACS_peak_6246	109.53	381	0	1	0	gen
14	67910403	67910538	MACS_peak_6247	925.76	135	0	1	0	gen
14	68348314	68348606	MACS_peak_6249	406.81	292	0	1	0	gen
14	68582526	68582906	MACS_peak_6250	127.5	380	0	1	0	gen
14	69129320	69129601	MACS_peak_6252	577.45	281	0	1	0	gen
14	69248107	69248513	MACS_peak_6253	617.94	406	0	0	1	other
14	69460095	69460496	MACS_peak_6254	393.43	401	0	1	0	gen
14	69475249	69475433	MACS_peak_6255	1747.66	184	0	0	0	intergen
14	69503867	69504096	MACS_peak_6256	1126.8	229	0	1	0	gen
14	69535250	69535570	MACS_peak_6257	550.56	320	0	0	0	intergen
14	69574763	69575045	MACS_peak_6258	1718.39	282	0	0	0	intergen
14	69727061	69727262	MACS_peak_6259	793.98	201	1	0	0	promoter
14	69850622	69850755	MACS_peak_6260	1098.16	133	1	0	0	promoter
14	70013363	70013665	MACS_peak_6261	312.33	302	0	1	0	gen
14	70074027	70074215	MACS_peak_6262	883.81	188	0	1	0	gen
14	70126568	70126711	MACS_peak_6263	1007.8	143	0	1	0	gen
14	70270809	70270946	MACS_peak_6264	813.46	137	0	0	0	intergen
14	70330566	70330828	MACS_peak_6265	1336.03	262	1	1	0	promoter
14	70568008	70568200	MACS_peak_6266	651.85	192	0	0	0	intergen
14	70714106	70714278	MACS_peak_6267	797.18	172	0	0	0	intergen
14	70817706	70817941	MACS_peak_6268	1134.69	235	0	0	0	intergen
14	70938194	70938544	MACS_peak_6269	50.92	350	0	1	0	gen
14	70959886	70960146	MACS_peak_6270	81.88	260	0	1	0	gen
14	70975841	70976029	MACS_peak_6271	687.06	188	0	1	0	gen
14	71037281	71037531	MACS_peak_6272	75.91	250	0	1	0	gen
14	71050280	71050539	MACS_peak_6274	540.64	259	0	1	0	gen
14	71104010	71104220	MACS_peak_6275	613.04	210	0	1	0	gen
14	71235278	71235595	MACS_peak_6276	552.5	317	0	0	0	intergen
14	71369592	71369949	MACS_peak_6277	58.64	357	0	1	0	gen
14	71374493	71374715	MACS_peak_6278	386.24	222	0	1	0	gen
14	71397906	71398049	MACS_peak_6279	349.8	143	0	1	0	gen
14	71720972	71721263	MACS_peak_6280	570.2	291	0	1	0	gen
14	71724092	71724341	MACS_peak_6281	485.56	249	0	1	0	gen
14	71874110	71874521	MACS_peak_6283	127.15	411	0	0	1	other
14	71976713	71977062	MACS_peak_6284	57.54	349	0	1	0	gen
14	71979196	71979458	MACS_peak_6285	50.27	262	0	1	0	gen
14	71981643	71982022	MACS_peak_6286	85.83	379	0	1	0	gen
14	72023990	72024255	MACS_peak_6287	464.09	265	0	1	0	gen
14	72292486	72292672	MACS_peak_6288	901.33	186	0	1	0	gen
14	72398233	72398674	MACS_peak_6289	77.16	441	0	1	0	gen
14	72420774	72421052	MACS_peak_6290	843.51	278	0	1	0	gen
14	72472914	72473135	MACS_peak_6291	729.14	221	0	1	0	gen
14	72516989	72517164	MACS_peak_6292	1884.9	175	0	1	0	gen
14	72872918	72873293	MACS_peak_6293	76.3	375	0	1	0	gen
14	72904933	72905296	MACS_peak_6294	863.32	363	0	0	0	intergen
14	72912849	72913050	MACS_peak_6295	612.81	201	0	0	0	intergen
14	73023157	73023459	MACS_peak_6296	178.37	302	0	1	0	gen
14	73197843	73198135	MACS_peak_6297	488.85	292	0	1	0	gen
14	73314617	73314812	MACS_peak_6299	649.48	195	0	1	0	gen
14	73387717	73387947	MACS_peak_6300	510.52	230	0	1	1	gen
14	73390188	73390444	MACS_peak_6301	729.14	256	0	1	1	gen
14	73508741	73508879	MACS_peak_6302	1406.54	138	0	1	0	gen
14	73570973	73571285	MACS_peak_6303	1127.86	312	1	0	0	promoter
14	73777632	73777813	MACS_peak_6304	860.3	181	0	1	0	gen
14	73836532	73836674	MACS_peak_6305	868.02	142	0	0	0	intergen
14	74087339	74087542	MACS_peak_6306	654.07	203	1	0	0	promoter
14	74096931	74097159	MACS_peak_6307	498.19	228	0	1	0	gen
14	74111672	74111880	MACS_peak_6308	770.35	208	0	1	0	gen
14	74125460	74125919	MACS_peak_6309	157.77	459	0	1	0	gen
14	74180148	74180498	MACS_peak_6310	265.34	350	0	1	0	gen
14	74257490	74257840	MACS_peak_6311	416.22	350	0	1	0	gen
14	74362310	74362647	MACS_peak_6312	539.88	337	0	0	0	intergen
14	74508391	74508619	MACS_peak_6313	695.57	228	0	1	0	gen
14	74564005	74564419	MACS_peak_6314	1329.38	414	0	1	0	gen
14	74727146	74727504	MACS_peak_6315	56.95	358	0	1	0	gen
14	74878444	74878706	MACS_peak_6316	1136.13	262	1	0	0	promoter
14	74913920	74914262	MACS_peak_6317	536.84	342	0	1	0	gen
14	75088649	75088869	MACS_peak_6318	549.18	220	0	1	0	gen
14	75296252	75296474	MACS_peak_6319	394.77	222	0	0	1	other
14	75384235	75384684	MACS_peak_6320	1978.14	449	0	0	0	intergen
14	75488857	75489106	MACS_peak_6321	485.56	249	0	0	0	intergen
14	75654235	75654486	MACS_peak_6322	485.56	251	1	2	0	promoter
14	75906734	75907008	MACS_peak_6323	582.68	274	1	1	0	promoter
14	76149381	76149735	MACS_peak_6324	611.86	354	1	0	1	promoter
14	76199014	76199322	MACS_peak_6325	438.15	308	0	1	0	gen
14	76514735	76514920	MACS_peak_6327	712.32	185	0	0	1	other
14	76633703	76633872	MACS_peak_6328	814.37	169	0	0	1	other
14	76886279	76886464	MACS_peak_6329	712.32	185	0	0	0	intergen
14	76913672	76913995	MACS_peak_6330	416.74	323	0	0	0	intergen
14	77070759	77070984	MACS_peak_6331	895.4	225	0	0	2	other
14	77168206	77168418	MACS_peak_6332	526.96	212	0	2	0	gen
14	77269597	77269912	MACS_peak_6333	721.05	315	1	0	0	promoter
14	77300959	77301315	MACS_peak_6334	775.24	356	0	1	0	gen
14	77315816	77316150	MACS_peak_6335	664.84	334	0	1	0	gen
14	77862220	77862538	MACS_peak_6336	551.85	318	0	1	0	gen
14	78225281	78225632	MACS_peak_6337	69	351	0	1	0	gen
14	78362018	78362330	MACS_peak_6338	172.39	312	0	1	0	gen
14	78448558	78448835	MACS_peak_6339	456.44	277	0	1	0	gen
14	78597950	78598328	MACS_peak_6340	500.42	378	0	1	0	gen
14	78825195	78825327	MACS_peak_6341	977.06	132	0	1	0	gen
14	78848277	78848591	MACS_peak_6342	1082.36	314	0	1	0	gen
14	78926617	78926941	MACS_peak_6343	845.32	324	0	1	0	gen
14	78969211	78969471	MACS_peak_6344	711.32	260	0	1	0	gen
14	79048837	79049175	MACS_peak_6345	127.15	338	0	1	0	gen
14	79129475	79129884	MACS_peak_6346	91.31	409	0	1	0	gen
14	79129994	79130257	MACS_peak_6347	63.45	263	0	1	0	gen
14	79810229	79810471	MACS_peak_6348	645.81	242	0	1	0	gen
14	79952504	79952759	MACS_peak_6349	596.79	255	0	0	1	other
14	80030148	80030593	MACS_peak_6350	87.17	445	0	0	0	intergen
14	80031972	80032214	MACS_peak_6351	136.71	242	0	0	0	intergen
14	80356305	80356721	MACS_peak_6352	958.92	416	0	1	1	gen
14	80367806	80368153	MACS_peak_6353	76.3	347	0	1	1	gen
14	80488190	80488517	MACS_peak_6354	84.4	327	0	1	0	gen
14	80529218	80529413	MACS_peak_6355	485.3	195	0	1	0	gen
14	80622579	80622908	MACS_peak_6356	199.25	329	0	1	0	gen
14	80636004	80636391	MACS_peak_6357	511.42	387	0	1	0	gen
14	80850328	80850594	MACS_peak_6358	1139.76	266	0	1	0	gen
14	81040487	81040715	MACS_peak_6359	1007.8	228	0	1	1	gen
14	81117731	81118131	MACS_peak_6360	74.29	400	0	1	1	gen
14	81170664	81170911	MACS_peak_6362	629.38	247	1	0	0	promoter
14	81269476	81269714	MACS_peak_6363	954.29	238	0	1	0	gen
14	81453306	81453600	MACS_peak_6364	568.08	294	0	0	0	intergen
14	81457948	81458413	MACS_peak_6365	527.95	465	0	0	0	intergen
14	81464551	81464780	MACS_peak_6366	612.96	229	0	0	0	intergen
14	81565980	81566240	MACS_peak_6367	882.66	260	0	0	0	intergen
14	81710289	81710643	MACS_peak_6368	337.14	354	0	0	0	intergen
14	81863827	81864152	MACS_peak_6369	141.18	325	0	0	1	other
14	81923281	81923415	MACS_peak_6370	939.45	134	0	0	1	other
14	82163318	82163532	MACS_peak_6372	534.94	214	0	0	0	intergen
14	82473962	82474416	MACS_peak_6373	81.72	454	0	0	0	intergen
14	82791753	82791988	MACS_peak_6374	662.31	235	0	0	1	other
14	83159152	83159490	MACS_peak_6375	834.03	338	0	0	0	intergen
14	83169679	83169961	MACS_peak_6376	69	282	0	0	0	intergen
14	83300556	83300828	MACS_peak_6377	1278.59	272	0	0	0	intergen
14	83741202	83741444	MACS_peak_6379	501.16	242	0	0	0	intergen
14	84098759	84099140	MACS_peak_6380	340.73	381	0	0	1	other
14	84131361	84131500	MACS_peak_6381	825.59	139	0	0	1	other
14	84444578	84444812	MACS_peak_6382	532.66	234	0	0	0	intergen
14	84466776	84466925	MACS_peak_6383	524.32	149	0	0	0	intergen
14	84533569	84533802	MACS_peak_6384	678.9	233	0	0	0	intergen
14	84596284	84596634	MACS_peak_6385	532.08	350	0	0	0	intergen
14	84623835	84624071	MACS_peak_6386	394.53	236	0	0	0	intergen
14	84743462	84743684	MACS_peak_6387	1038.85	222	0	0	0	intergen
14	85021439	85021810	MACS_peak_6388	164.26	371	0	0	0	intergen
14	85022635	85023098	MACS_peak_6389	149.97	463	0	0	0	intergen
14	85212049	85212419	MACS_peak_6390	133.35	370	0	0	1	other
14	85288720	85288935	MACS_peak_6391	168.62	215	0	0	0	intergen
14	85295849	85295982	MACS_peak_6392	1229.93	133	0	0	0	intergen
14	85816979	85817252	MACS_peak_6393	458.95	273	0	0	0	intergen
14	85856472	85856891	MACS_peak_6394	721.05	419	0	0	0	intergen
14	85888840	85889158	MACS_peak_6395	114.55	318	0	0	0	intergen
14	85927000	85927320	MACS_peak_6397	439.97	320	0	0	0	intergen
14	85934892	85935150	MACS_peak_6398	727.26	258	0	0	1	other
14	86057029	86057430	MACS_peak_6399	741.31	401	0	0	2	other
14	86077082	86077387	MACS_peak_6401	96.97	305	0	0	1	other
14	86077441	86077839	MACS_peak_6402	139.27	398	0	0	1	other
14	86097486	86097956	MACS_peak_6403	83.91	470	0	0	1	other
14	86105602	86105939	MACS_peak_6404	125.63	337	0	0	1	other
14	86109169	86109596	MACS_peak_6406	100.2	427	0	0	1	other
14	86109695	86110036	MACS_peak_6407	55.96	341	0	0	1	other
14	86187120	86187488	MACS_peak_6408	86.02	368	0	0	0	intergen
14	86315399	86315745	MACS_peak_6409	60.5	346	0	0	0	intergen
14	86502167	86502423	MACS_peak_6411	488.85	256	0	0	0	intergen
14	87274761	87274969	MACS_peak_6412	674.85	208	0	0	0	intergen
14	87357303	87357672	MACS_peak_6413	63.13	369	0	0	1	other
14	87416613	87416887	MACS_peak_6414	122.05	274	0	0	1	other
14	87423717	87423990	MACS_peak_6415	180.31	273	0	0	1	other
14	87945008	87945384	MACS_peak_6416	517.34	376	0	1	0	gen
14	88189466	88189682	MACS_peak_6417	580.62	216	0	1	0	gen
14	88407507	88407838	MACS_peak_6418	105.65	331	0	1	0	gen
14	88445498	88445762	MACS_peak_6419	50.92	264	0	1	0	gen
14	88459240	88459610	MACS_peak_6420	124.97	370	0	1	0	gen
14	88460023	88460435	MACS_peak_6421	89.02	412	0	1	0	gen
14	88468463	88468780	MACS_peak_6422	3100	317	1	1	0	promoter
14	88796765	88797203	MACS_peak_6423	1498.01	438	0	0	0	intergen
14	89020686	89020896	MACS_peak_6424	597.38	210	0	0	1	other
14	89100862	89101059	MACS_peak_6425	376.34	197	0	0	0	intergen
14	89528371	89528512	MACS_peak_6426	926.94	141	0	1	1	gen
14	89868112	89868452	MACS_peak_6427	421.18	340	0	1	1	gen
14	89915259	89915673	MACS_peak_6428	1986.91	414	0	1	1	gen
14	90057641	90057940	MACS_peak_6429	229.83	299	1	0	0	promoter
14	90114630	90114818	MACS_peak_6430	695.57	188	0	1	0	gen
14	90209624	90209968	MACS_peak_6431	109.92	344	0	0	0	intergen
14	90235470	90235693	MACS_peak_6432	712.32	223	0	0	0	intergen
14	90289350	90289625	MACS_peak_6433	496.66	275	0	1	0	gen
14	90301605	90301831	MACS_peak_6434	548.55	226	0	1	0	gen
14	90399375	90399796	MACS_peak_6435	722.05	421	1	0	0	promoter
14	90436932	90437322	MACS_peak_6436	272.05	390	0	0	0	intergen
14	90599930	90600138	MACS_peak_6437	1046.02	208	0	1	0	gen
14	90635285	90635484	MACS_peak_6438	1766.88	199	0	1	0	gen
14	90900736	90901107	MACS_peak_6439	520.09	371	0	1	0	gen
14	91140751	91140960	MACS_peak_6440	780.06	209	0	1	0	gen
14	91286425	91286735	MACS_peak_6441	813.39	310	0	1	0	gen
14	91323560	91323884	MACS_peak_6442	547.99	324	0	1	0	gen
14	91431123	91431484	MACS_peak_6443	124.37	361	0	0	0	intergen
14	91556482	91556837	MACS_peak_6444	356.34	355	0	0	0	intergen
14	91562941	91563348	MACS_peak_6445	152.66	407	0	0	0	intergen
14	91645552	91645893	MACS_peak_6446	85.73	341	0	1	0	gen
14	91649868	91650240	MACS_peak_6447	413.49	372	0	1	0	gen
14	92382713	92383010	MACS_peak_6448	565.98	297	0	1	0	gen
14	92547057	92547469	MACS_peak_6449	930.85	412	0	1	0	gen
14	92661452	92661747	MACS_peak_6450	567.38	295	0	1	0	gen
14	92681124	92681540	MACS_peak_6451	496.62	416	0	1	0	gen
14	92690477	92690642	MACS_peak_6452	831.63	165	0	0	0	intergen
14	92783887	92784134	MACS_peak_6453	485.56	247	0	0	0	intergen
14	93072608	93072740	MACS_peak_6454	1083.63	132	0	1	0	gen
14	93112869	93113102	MACS_peak_6455	429.38	233	0	1	0	gen
14	93234003	93234319	MACS_peak_6457	1053.5	316	1	0	0	promoter
14	93465027	93465428	MACS_peak_6458	950.42	401	0	1	0	gen
14	93619283	93619487	MACS_peak_6459	782.26	204	0	1	0	gen
14	93906831	93907014	MACS_peak_6460	1134.69	183	0	0	1	other
14	93936190	93936517	MACS_peak_6461	488.85	327	1	0	0	promoter
14	94036530	94036749	MACS_peak_6462	580.62	219	0	1	0	gen
14	94259658	94259921	MACS_peak_6463	380.3	263	0	1	0	gen
14	94423571	94423802	MACS_peak_6464	678.9	231	0	0	0	intergen
14	94433809	94434126	MACS_peak_6465	433.2	317	0	0	1	other
14	94486399	94486586	MACS_peak_6466	901.33	187	1	0	0	promoter
14	95099133	95099348	MACS_peak_6467	596.79	215	0	1	0	gen
14	95358824	95359053	MACS_peak_6468	426.16	229	0	0	0	intergen
14	95561009	95561222	MACS_peak_6469	763.02	213	0	0	0	intergen
14	95680395	95680647	MACS_peak_6470	470.06	252	0	0	1	other
14	95994334	95994611	MACS_peak_6471	580.42	277	0	0	0	intergen
14	96297017	96297308	MACS_peak_6472	1173.86	291	0	1	0	gen
14	96432092	96432420	MACS_peak_6473	264.96	328	0	1	0	gen
14	96464441	96464584	MACS_peak_6474	856.68	143	0	1	0	gen
14	96567310	96567569	MACS_peak_6475	468.05	259	0	0	0	intergen
14	97167077	97167350	MACS_peak_6476	141.91	273	0	0	0	intergen
14	98305843	98306142	MACS_peak_6478	695.38	299	0	0	0	intergen
14	99255400	99255532	MACS_peak_6479	1090.31	132	0	1	0	gen
14	99266642	99267009	MACS_peak_6480	1303.94	367	0	1	0	gen
14	99389304	99389598	MACS_peak_6481	446.16	294	0	0	0	intergen
14	99393207	99393354	MACS_peak_6482	972.07	147	1	0	0	promoter
14	99628914	99629161	MACS_peak_6483	629.38	247	0	0	0	intergen
14	100037890	100038049	MACS_peak_6484	866.35	159	0	1	0	gen
14	100108340	100108571	MACS_peak_6485	678.9	231	0	1	0	gen
14	100181619	100181941	MACS_peak_6486	127.5	322	0	0	0	intergen
14	100242020	100242205	MACS_peak_6487	536.31	185	1	0	0	promoter
14	100271186	100271549	MACS_peak_6488	478.36	363	0	1	0	gen
14	100383685	100383925	MACS_peak_6489	516.86	240	0	1	0	gen
14	100440180	100440456	MACS_peak_6490	581.17	276	0	1	0	gen
14	101144354	101144734	MACS_peak_6491	243.49	380	0	0	0	intergen
14	101270740	101271063	MACS_peak_6492	79.96	323	0	0	1	other
14	101271722	101272026	MACS_peak_6493	136.99	304	0	0	1	other
14	101327850	101328006	MACS_peak_6494	1346.43	156	0	0	0	intergen
14	101419585	101419948	MACS_peak_6495	1546.78	363	0	0	0	intergen
14	101628495	101628711	MACS_peak_6496	1264.23	216	0	0	0	intergen
14	101771058	101771470	MACS_peak_6497	552.59	412	0	1	0	gen
14	101961143	101961440	MACS_peak_6498	825.22	297	1	0	0	promoter
14	102096634	102096875	MACS_peak_6499	487.14	241	0	1	0	gen
14	102314299	102314547	MACS_peak_6500	485.56	248	1	0	0	promoter
14	102524466	102524720	MACS_peak_6501	470.06	254	0	0	0	intergen
14	102972684	102972850	MACS_peak_6502	527.73	166	0	1	0	gen
14	103031951	103032192	MACS_peak_6503	646.51	241	0	1	0	gen
14	103048518	103048808	MACS_peak_6504	274.91	290	0	1	0	gen
14	103105069	103105260	MACS_peak_6505	695.57	191	0	0	0	intergen
14	103141223	103141470	MACS_peak_6506	485.56	247	0	0	1	other
14	103185460	103185688	MACS_peak_6507	1026.72	228	0	0	0	intergen
14	103273069	103273218	MACS_peak_6508	458.32	149	0	0	0	intergen
14	103394033	103394297	MACS_peak_6509	986.85	264	0	1	0	gen
14	103613619	103613828	MACS_peak_6510	596.67	209	0	2	0	gen
14	103808462	103808683	MACS_peak_6511	564.54	221	0	1	0	gen
14	103893390	103893652	MACS_peak_6512	859.93	262	0	0	0	intergen
14	103980690	103981094	MACS_peak_6513	693.28	404	0	1	0	gen
14	104007498	104007656	MACS_peak_6514	856.51	158	0	1	0	gen
14	104077930	104078255	MACS_peak_6515	933.51	325	0	0	0	intergen
14	104259120	104259347	MACS_peak_6517	491.58	227	0	0	1	other
14	104273703	104273997	MACS_peak_6518	406.81	294	0	0	1	other
14	104341984	104342213	MACS_peak_6519	548.55	229	0	0	0	intergen
14	104413399	104413779	MACS_peak_6520	74.12	380	0	0	0	intergen
14	104640029	104640271	MACS_peak_6521	645.81	242	0	0	0	intergen
14	104896739	104897173	MACS_peak_6522	534.92	434	0	0	0	intergen
14	105090523	105090751	MACS_peak_6524	548.55	228	0	0	0	intergen
14	105317156	105317433	MACS_peak_6525	691.36	277	0	1	0	gen
14	105480944	105481109	MACS_peak_6526	1061.85	165	0	0	0	intergen
14	105557215	105557524	MACS_peak_6527	1204.12	309	0	0	0	intergen
14	105559785	105559993	MACS_peak_6528	1134.69	208	0	0	0	intergen
14	105560405	105560685	MACS_peak_6529	841.52	280	0	0	0	intergen
14	105677629	105677964	MACS_peak_6530	1487.01	335	0	0	0	intergen
14	105680172	105680410	MACS_peak_6531	1608.09	238	0	0	0	intergen
14	105680822	105681102	MACS_peak_6532	841.52	280	0	0	0	intergen
14	105717788	105718161	MACS_peak_6533	479.98	373	0	0	0	intergen
14	105958078	105958521	MACS_peak_6534	183.5	443	0	0	0	intergen
14	106006081	106006342	MACS_peak_6535	977.7	261	0	0	0	intergen
14	106061907	106062190	MACS_peak_6536	976.55	283	0	0	0	intergen
14	106153380	106153670	MACS_peak_6538	685.16	290	0	0	0	intergen
14	106170251	106170659	MACS_peak_6539	863.05	408	0	0	0	intergen
14	106234803	106235192	MACS_peak_6540	511.42	389	0	0	0	intergen
14	106318770	106319051	MACS_peak_6541	577.45	281	0	0	0	intergen
14	106334877	106335137	MACS_peak_6542	371.55	260	0	0	0	intergen
14	106349063	106349342	MACS_peak_6543	1102.85	279	0	0	0	intergen
14	106421513	106421859	MACS_peak_6544	660.56	346	0	0	0	intergen
14	106556632	106557094	MACS_peak_6545	1342.96	462	0	0	0	intergen
14	106618538	106618767	MACS_peak_6546	695.57	229	0	0	0	intergen
14	106627093	106627293	MACS_peak_6547	814.37	200	0	0	0	intergen
14	106683907	106684253	MACS_peak_6548	534.45	346	0	0	1	other
14	106797524	106797928	MACS_peak_6549	125.63	404	0	0	0	intergen
14	106872628	106872991	MACS_peak_6550	645.47	363	0	0	0	intergen
14	106873076	106873340	MACS_peak_6551	464.09	264	0	0	0	intergen
15	19795148	19795530	MACS_peak_6552	68.69	382	0	0	0	intergen
15	19795668	19795950	MACS_peak_6553	125.08	282	0	0	0	intergen
15	19805750	19806105	MACS_peak_6555	64.86	355	0	0	0	intergen
15	19807150	19807461	MACS_peak_6556	76.73	311	0	0	0	intergen
15	19826112	19826491	MACS_peak_6558	95.96	379	0	0	0	intergen
15	19828011	19828269	MACS_peak_6559	113.62	258	0	0	0	intergen
15	19835078	19835435	MACS_peak_6560	130.39	357	0	0	0	intergen
15	19836099	19836377	MACS_peak_6561	526.91	278	0	0	0	intergen
15	19845756	19846173	MACS_peak_6562	180.31	417	0	0	0	intergen
15	19916926	19917346	MACS_peak_6563	690.06	420	0	0	0	intergen
15	19953243	19953568	MACS_peak_6564	142.05	325	0	0	0	intergen
15	20021496	20021649	MACS_peak_6565	918.92	153	0	0	0	intergen
15	20035278	20035647	MACS_peak_6566	138.21	369	0	0	0	intergen
15	20130107	20130555	MACS_peak_6567	109.53	448	0	0	1	other
15	20167980	20168158	MACS_peak_6568	871.97	178	0	0	0	intergen
15	20179944	20180078	MACS_peak_6569	525.27	134	0	0	0	intergen
15	20194665	20195062	MACS_peak_6571	603.06	397	0	0	0	intergen
15	20312152	20312512	MACS_peak_6572	63.35	360	0	0	0	intergen
15	20323028	20323424	MACS_peak_6573	89.02	396	0	0	0	intergen
15	20356354	20356643	MACS_peak_6574	653.8	289	0	0	1	other
15	20406498	20406755	MACS_peak_6575	242.1	257	0	0	1	other
15	20430664	20430823	MACS_peak_6577	768.33	159	0	0	1	other
15	20440320	20440570	MACS_peak_6578	485.56	250	0	0	1	other
15	20533737	20533951	MACS_peak_6579	1110.53	214	1	0	0	promoter
15	20570332	20570607	MACS_peak_6580	953.02	275	0	0	1	other
15	20577520	20577709	MACS_peak_6581	642.64	189	0	0	0	intergen
15	20609599	20610036	MACS_peak_6582	1243.42	437	0	0	0	intergen
15	20622163	20622475	MACS_peak_6583	422.67	312	0	0	0	intergen
15	20640500	20640737	MACS_peak_6584	465.7	237	0	0	0	intergen
15	20653758	20654098	MACS_peak_6585	470.76	340	0	0	0	intergen
15	20884677	20885012	MACS_peak_6586	986.22	335	0	0	0	intergen
15	20978011	20978404	MACS_peak_6587	1243.72	393	0	0	1	other
15	21028061	21028297	MACS_peak_6588	662.31	236	0	0	0	intergen
15	21041932	21042301	MACS_peak_6589	90.74	369	0	0	0	intergen
15	21136636	21137032	MACS_peak_6590	89.02	396	0	0	0	intergen
15	21284217	21284673	MACS_peak_6591	828.74	456	0	0	0	intergen
15	21295478	21295785	MACS_peak_6592	134.28	307	0	0	0	intergen
15	21458382	21458781	MACS_peak_6593	1066.48	399	0	0	0	intergen
15	21525854	21525986	MACS_peak_6594	724.36	132	0	0	0	intergen
15	21551891	21552151	MACS_peak_6595	706.68	260	1	0	0	promoter
15	21989177	21989437	MACS_peak_6596	706.68	260	0	0	0	intergen
15	22019812	22020184	MACS_peak_6597	761.56	372	1	0	1	promoter
15	22025884	22026210	MACS_peak_6598	80.1	326	0	1	1	gen
15	22081168	22081380	MACS_peak_6600	592.85	212	0	2	0	gen
15	22088121	22088319	MACS_peak_6601	831.63	198	0	1	0	gen
15	22264738	22264992	MACS_peak_6602	1014.24	254	0	0	0	intergen
15	22429767	22430042	MACS_peak_6603	953.02	275	0	0	1	other
15	22467132	22467346	MACS_peak_6604	1110.53	214	0	1	0	gen
15	22884430	22884673	MACS_peak_6605	780.06	243	0	1	0	gen
15	22609675	22609921	MACS_peak_6606	796.85	246	0	0	1	other
15	22559893	22560123	MACS_peak_6607	532.66	230	0	0	1	other
15	22551145	22551324	MACS_peak_6608	756.91	179	0	0	1	other
15	22514957	22515095	MACS_peak_6609	1032.97	138	0	0	1	other
15	23128948	23129162	MACS_peak_6610	1061.17	214	1	0	0	promoter
15	23165343	23165618	MACS_peak_6611	863.32	275	0	0	1	other
15	22390349	22390807	MACS_peak_6612	1243.42	458	0	0	0	intergen
15	22377910	22378222	MACS_peak_6613	422.67	312	0	0	0	intergen
15	22359649	22359886	MACS_peak_6614	662.31	237	0	0	0	intergen
15	23326413	23326627	MACS_peak_6615	1281.8	214	0	0	1	other
15	23362711	23362950	MACS_peak_6616	951.3	239	0	1	0	gen
15	23411180	23411414	MACS_peak_6617	518.73	234	0	0	0	intergen
15	23552196	23552391	MACS_peak_6618	639.26	195	0	0	0	intergen
15	23900297	23900654	MACS_peak_6619	103.45	357	0	0	0	intergen
15	23993723	23994060	MACS_peak_6620	80.32	337	0	0	1	other
15	24010625	24011000	MACS_peak_6621	73.47	375	0	0	0	intergen
15	24011286	24011657	MACS_peak_6622	114.74	371	0	0	0	intergen
15	24137247	24137390	MACS_peak_6623	1695.71	143	0	0	0	intergen
15	24154993	24155331	MACS_peak_6624	130.39	338	0	0	0	intergen
15	24255553	24255799	MACS_peak_6625	485.56	246	0	0	1	other
15	24703741	24703962	MACS_peak_6626	619.26	221	0	0	0	intergen
15	24761713	24762004	MACS_peak_6627	570.2	291	0	0	0	intergen
15	24766971	24767298	MACS_peak_6628	492.77	327	0	0	0	intergen
15	24767362	24767765	MACS_peak_6629	720	403	0	0	0	intergen
15	24927371	24927597	MACS_peak_6630	243.16	226	0	1	0	gen
15	25479077	25479212	MACS_peak_6631	1666.76	135	0	0	0	intergen
15	25840869	25841145	MACS_peak_6632	710.92	276	0	1	0	gen
15	26618814	26619277	MACS_peak_6633	219.36	463	0	1	0	gen
15	26823070	26823299	MACS_peak_6634	426.16	229	0	1	0	gen
15	27566908	27567117	MACS_peak_6636	887.75	209	0	0	0	intergen
15	27852383	27852792	MACS_peak_6637	62.66	409	0	1	0	gen
15	27852853	27853233	MACS_peak_6638	105.38	380	0	1	0	gen
15	28305243	28305633	MACS_peak_6639	137.06	390	0	1	0	gen
15	28349729	28349943	MACS_peak_6640	1061.17	214	0	0	1	other
15	28386635	28386917	MACS_peak_6641	950.42	282	0	1	0	gen
15	28517511	28517795	MACS_peak_6642	406.81	284	1	0	0	promoter
15	28524718	28525000	MACS_peak_6643	950.42	282	0	1	0	gen
15	28561686	28561900	MACS_peak_6644	1226.64	214	0	0	0	intergen
15	28645635	28645814	MACS_peak_6645	756.91	179	0	0	1	other
15	28663789	28663948	MACS_peak_6646	794.58	159	0	0	1	other
15	28704170	28704334	MACS_peak_6647	1113.8	164	1	0	0	promoter
15	29414513	29414811	MACS_peak_6649	62.47	298	0	1	0	gen
15	29477995	29478377	MACS_peak_6650	229.83	382	0	1	0	gen
15	29668058	29668362	MACS_peak_6651	687.55	304	0	0	0	intergen
15	29925960	29926200	MACS_peak_6652	516.86	240	0	1	0	gen
15	30067124	30067438	MACS_peak_6653	94.75	314	0	0	1	other
15	30091117	30091363	MACS_peak_6654	796.85	246	0	1	0	gen
15	30097882	30098321	MACS_peak_6655	1318.98	439	0	0	0	intergen
15	30143209	30143373	MACS_peak_6656	1113.8	164	0	1	0	gen
15	30150010	30150369	MACS_peak_6657	473.71	359	0	0	0	intergen
15	30243685	30244089	MACS_peak_6658	133.28	404	0	0	0	intergen
15	30262079	30262462	MACS_peak_6659	513.56	383	0	0	0	intergen
15	30398926	30399365	MACS_peak_6662	1638.03	439	1	0	0	promoter
15	30405919	30406106	MACS_peak_6663	664.25	187	1	0	0	promoter
15	30462236	30462667	MACS_peak_6664	722.76	431	0	0	0	intergen
15	30560134	30560321	MACS_peak_6665	664.25	187	0	1	0	gen
15	30566880	30567303	MACS_peak_6666	793.31	423	0	0	0	intergen
15	30612179	30612425	MACS_peak_6667	863.28	246	0	1	0	gen
15	30621486	30621725	MACS_peak_6668	415.95	239	2	0	1	promoter
15	30661193	30661538	MACS_peak_6669	535.04	345	0	1	2	gen
15	30799615	30799818	MACS_peak_6670	797.91	203	0	0	1	other
15	30851271	30851659	MACS_peak_6671	85.8	388	0	0	0	intergen
15	30859263	30859580	MACS_peak_6672	552.5	317	0	0	0	intergen
15	30929601	30930024	MACS_peak_6673	722.05	423	0	1	0	gen
15	31237915	31238050	MACS_peak_6674	1666.76	135	0	0	0	intergen
15	31867965	31868225	MACS_peak_6675	1002.97	260	0	1	0	gen
15	31977889	31978064	MACS_peak_6676	972.07	175	0	1	0	gen
15	32045990	32046304	MACS_peak_6677	196.45	314	0	1	0	gen
15	32048512	32048889	MACS_peak_6678	91.18	377	0	1	0	gen
15	32140979	32141334	MACS_peak_6679	95.51	355	0	1	0	gen
15	32187987	32188317	MACS_peak_6680	91.52	330	0	0	0	intergen
15	32276194	32276577	MACS_peak_6681	513.56	383	0	0	0	intergen
15	32293883	32294279	MACS_peak_6682	55.91	396	0	0	0	intergen
15	32387979	32388338	MACS_peak_6683	457.44	359	1	0	0	promoter
15	32394911	32395136	MACS_peak_6684	842.08	225	1	0	0	promoter
15	32407912	32408274	MACS_peak_6685	358.11	362	0	0	2	other
15	32440284	32440697	MACS_peak_6686	1253.66	413	1	0	0	promoter
15	32447286	32447489	MACS_peak_6687	1046.67	203	1	0	0	promoter
15	32545037	32545468	MACS_peak_6688	722.76	431	0	0	1	other
15	32601595	32601798	MACS_peak_6689	1192.03	203	0	1	1	gen
15	32610841	32611125	MACS_peak_6690	575.25	284	1	0	1	promoter
15	32617486	32617737	MACS_peak_6691	131.01	251	1	0	0	promoter
15	32651294	32651566	MACS_peak_6692	714.45	272	0	1	0	gen
15	32737987	32738213	MACS_peak_6693	197.4	226	0	1	0	gen
15	33964127	33964395	MACS_peak_6694	699.35	268	1	1	0	promoter
15	34089104	34089390	MACS_peak_6695	277.16	286	0	1	0	gen
15	34708397	34708724	MACS_peak_6696	427.87	327	0	0	0	intergen
15	34814317	34814449	MACS_peak_6697	1396.21	132	0	0	0	intergen
15	35078520	35078769	MACS_peak_6698	827.31	249	0	0	0	intergen
15	35353071	35353399	MACS_peak_6699	80.8	328	0	1	0	gen
15	35354217	35354475	MACS_peak_6700	59.04	258	0	1	0	gen
15	35386731	35387141	MACS_peak_6701	137.06	410	0	1	0	gen
15	35389194	35389567	MACS_peak_6702	74.08	373	0	1	0	gen
15	36198235	36198590	MACS_peak_6704	59.3	355	0	0	1	other
15	36501114	36501443	MACS_peak_6705	544.83	329	0	0	0	intergen
15	36683139	36683331	MACS_peak_6706	216.5	192	0	1	0	gen
15	37078497	37078632	MACS_peak_6708	1965.34	135	0	1	0	gen
15	37219843	37220046	MACS_peak_6709	629.38	203	0	0	0	intergen
15	37402739	37403143	MACS_peak_6710	129.46	404	0	0	1	other
15	37443531	37443765	MACS_peak_6711	532.66	234	0	0	1	other
15	37476141	37476410	MACS_peak_6712	178.49	269	0	0	1	other
15	37793883	37794081	MACS_peak_6713	662.31	198	0	0	0	intergen
15	37808963	37809258	MACS_peak_6714	103.45	295	0	0	0	intergen
15	37995834	37995973	MACS_peak_6715	1320.51	139	0	0	1	other
15	38440290	38440559	MACS_peak_6716	852.62	269	0	0	0	intergen
15	38449872	38450072	MACS_peak_6717	645.81	200	1	0	0	promoter
15	38474209	38474369	MACS_peak_6718	866.35	160	0	1	0	gen
15	38595639	38596027	MACS_peak_6719	137.17	388	0	0	0	intergen
15	38690803	38691044	MACS_peak_6720	501.16	241	0	1	0	gen
15	38699698	38699970	MACS_peak_6721	459.58	272	0	1	0	gen
15	38817716	38818008	MACS_peak_6722	447.34	292	0	1	0	gen
15	38836976	38837415	MACS_peak_6724	58.74	439	0	1	0	gen
15	38853716	38853973	MACS_peak_6725	714.49	257	0	1	0	gen
15	38887710	38887849	MACS_peak_6726	902.92	139	0	1	1	gen
15	38974731	38974990	MACS_peak_6727	158.81	259	0	1	1	gen
15	39037109	39037457	MACS_peak_6728	98	348	0	1	1	gen
15	39223302	39223682	MACS_peak_6729	187.68	380	0	0	1	other
15	39228197	39228336	MACS_peak_6730	316.39	139	0	0	1	other
15	39685997	39686304	MACS_peak_6732	685.18	307	0	1	0	gen
15	39756975	39757330	MACS_peak_6733	413.79	355	0	1	0	gen
15	40045039	40045472	MACS_peak_6734	721.49	433	0	0	1	other
15	40077722	40077876	MACS_peak_6735	1365.09	154	0	0	1	other
15	40217222	40217551	MACS_peak_6736	544.83	329	1	1	0	promoter
15	40274781	40275035	MACS_peak_6737	470.06	254	1	2	0	promoter
15	40320990	40321264	MACS_peak_6738	458.32	274	1	0	0	promoter
15	40891841	40892187	MACS_peak_6739	656.34	346	1	0	0	promoter
15	40904071	40904267	MACS_peak_6740	1025.76	196	0	0	0	intergen
15	41051124	41051256	MACS_peak_6741	1090.31	132	0	1	0	gen
15	41383869	41384121	MACS_peak_6742	164.73	252	1	0	0	promoter
15	41560288	41560426	MACS_peak_6743	1320.51	138	1	0	0	promoter
15	41989588	41989780	MACS_peak_6744	1061.85	192	0	1	1	gen
15	42091218	42091463	MACS_peak_6745	464.37	245	0	1	0	gen
15	42137770	42138024	MACS_peak_6746	596.79	254	1	0	0	promoter
15	42177061	42177283	MACS_peak_6747	433.36	222	0	1	0	gen
15	42557248	42557468	MACS_peak_6748	482.68	220	0	1	0	gen
15	42765926	42766131	MACS_peak_6749	113.48	205	0	1	0	gen
15	43163499	43163783	MACS_peak_6750	398.72	284	0	1	1	gen
15	43177131	43177434	MACS_peak_6751	68.59	303	0	1	1	gen
15	43204375	43204678	MACS_peak_6752	819.69	303	0	1	1	gen
15	43289751	43290037	MACS_peak_6753	123.55	286	0	1	0	gen
15	43367856	43368080	MACS_peak_6754	378.09	224	1	1	0	promoter
15	43652875	43653189	MACS_peak_6755	89.02	314	0	1	0	gen
15	43689971	43690242	MACS_peak_6756	460.22	271	1	0	0	promoter
15	44255812	44256236	MACS_peak_6757	54.41	424	0	0	0	intergen
15	44256563	44256926	MACS_peak_6758	51.57	363	0	0	0	intergen
15	44256943	44257174	MACS_peak_6759	243.71	231	0	0	0	intergen
15	44288350	44288580	MACS_peak_6760	675.15	230	1	0	0	promoter
15	44360164	44360483	MACS_peak_6761	86.85	319	0	1	0	gen
15	44363056	44363504	MACS_peak_6762	76.89	448	0	1	0	gen
15	44853407	44853777	MACS_peak_6763	351.78	370	0	0	1	other
15	44922784	44923001	MACS_peak_6764	746.04	217	0	0	1	other
15	44942890	44943027	MACS_peak_6765	1339.36	137	0	0	0	intergen
15	44967885	44968102	MACS_peak_6766	644.42	217	0	1	0	gen
15	45053814	45054089	MACS_peak_6767	159.26	275	0	1	1	gen
15	45054550	45054911	MACS_peak_6768	71.38	361	0	1	1	gen
15	45268526	45268983	MACS_peak_6769	75.01	457	0	1	1	gen
15	45419896	45420039	MACS_peak_6770	1549.78	143	0	1	0	gen
15	45430298	45430572	MACS_peak_6771	712.68	274	1	0	0	promoter
15	45457901	45458265	MACS_peak_6772	524.01	364	0	0	1	other
15	45618332	45618703	MACS_peak_6773	520.09	371	0	1	0	gen
15	46304303	46304717	MACS_peak_6774	497.6	414	0	0	0	intergen
15	46339150	46339292	MACS_peak_6775	868.02	142	0	0	0	intergen
15	46539189	46539381	MACS_peak_6777	488.21	192	0	0	0	intergen
15	46745447	46745924	MACS_peak_6778	191.86	477	0	0	1	other
15	46746366	46746681	MACS_peak_6779	51.44	315	0	0	1	other
15	47118987	47119333	MACS_peak_6781	142.05	346	0	0	0	intergen
15	47169800	47170124	MACS_peak_6782	57.42	324	0	0	0	intergen
15	47170273	47170703	MACS_peak_6783	78.25	430	0	0	0	intergen
15	47279104	47279489	MACS_peak_6784	126.25	385	0	1	0	gen
15	48357957	48358337	MACS_peak_6785	402.16	380	0	0	0	intergen
15	48699627	48699924	MACS_peak_6786	408.82	297	0	0	0	intergen
15	48801157	48801363	MACS_peak_6787	629.38	206	0	1	0	gen
15	48861879	48862170	MACS_peak_6788	570.2	291	0	1	0	gen
15	49277047	49277410	MACS_peak_6789	69	363	0	1	0	gen
15	49322956	49323226	MACS_peak_6790	585.73	270	1	1	0	promoter
15	49471341	49471737	MACS_peak_6792	1192.27	396	0	2	0	gen
15	49494058	49494290	MACS_peak_6793	571.87	232	0	1	0	gen
15	49638688	49638989	MACS_peak_6794	608.28	301	0	1	0	gen
15	49832700	49832957	MACS_peak_6796	260.03	257	0	0	0	intergen
15	49902426	49902737	MACS_peak_6797	471.55	311	0	1	0	gen
15	50002586	50002806	MACS_peak_6798	378.09	220	0	1	0	gen
15	50003721	50004072	MACS_peak_6799	695.42	351	0	1	0	gen
15	50051889	50052117	MACS_peak_6800	879.24	228	0	1	0	gen
15	50089282	50089542	MACS_peak_6802	380.3	260	0	1	0	gen
15	50161988	50162223	MACS_peak_6803	394.53	235	0	1	0	gen
15	50316109	50316454	MACS_peak_6804	649.93	345	0	1	0	gen
15	50459886	50460022	MACS_peak_6805	753.52	136	0	1	0	gen
15	50505232	50505458	MACS_peak_6806	700.54	226	1	1	0	promoter
15	50598970	50599232	MACS_peak_6807	950.42	262	0	1	0	gen
15	50622245	50622673	MACS_peak_6808	406.81	428	0	1	0	gen
15	50733422	50733716	MACS_peak_6810	815.26	294	0	1	0	gen
15	50844806	50845157	MACS_peak_6811	252.39	351	0	0	1	other
15	50885749	50886229	MACS_peak_6813	1960.85	480	0	0	1	other
15	50908550	50908765	MACS_peak_6814	647.94	215	1	0	0	promoter
15	50962707	50962982	MACS_peak_6815	406.81	275	0	1	0	gen
15	50986004	50986366	MACS_peak_6816	85.57	362	0	1	0	gen
15	51036983	51037362	MACS_peak_6817	98.21	379	0	0	0	intergen
15	51132964	51133217	MACS_peak_6819	730.64	253	0	0	1	other
15	51162897	51163201	MACS_peak_6820	818.78	304	0	0	1	other
15	51176700	51177044	MACS_peak_6822	71	344	0	0	1	other
15	51192722	51193096	MACS_peak_6824	761.67	374	0	0	1	other
15	51381280	51381527	MACS_peak_6825	479.11	247	0	1	0	gen
15	51401912	51402188	MACS_peak_6826	457.06	276	0	1	0	gen
15	51403250	51403711	MACS_peak_6827	342.69	461	0	1	0	gen
15	51419323	51419552	MACS_peak_6828	91.25	229	0	0	1	other
15	51420381	51420847	MACS_peak_6829	101.55	466	0	0	1	other
15	51422673	51422999	MACS_peak_6830	71.48	326	0	0	1	other
15	51499440	51499696	MACS_peak_6831	722.05	256	0	1	0	gen
15	51500052	51500379	MACS_peak_6832	931.6	327	0	1	0	gen
15	51537066	51537268	MACS_peak_6833	1026.72	202	0	1	0	gen
15	51582106	51582438	MACS_peak_6834	255.99	332	0	1	0	gen
15	51583411	51583670	MACS_peak_6835	149.34	259	0	1	0	gen
15	51585220	51585438	MACS_peak_6836	130.39	218	0	1	0	gen
15	51777104	51777389	MACS_peak_6838	611.86	285	0	1	0	gen
15	51785413	51785584	MACS_peak_6839	598.96	171	0	1	0	gen
15	51851884	51852099	MACS_peak_6840	644.42	215	0	1	0	gen
15	51888624	51889040	MACS_peak_6841	1065.38	416	0	1	1	gen
15	51897370	51897594	MACS_peak_6842	230.25	224	0	1	1	gen
15	51905946	51906139	MACS_peak_6843	997.5	193	0	1	0	gen
15	51982281	51982540	MACS_peak_6844	663.58	259	0	1	0	gen
15	52214960	52215190	MACS_peak_6845	831.63	230	0	1	0	gen
15	52256185	52256597	MACS_peak_6846	1055.73	412	0	1	0	gen
15	52476222	52476584	MACS_peak_6847	145.88	362	0	1	0	gen
15	52780616	52780910	MACS_peak_6848	828.03	294	0	1	0	gen
15	52821769	52822053	MACS_peak_6849	265.16	284	0	0	0	intergen
15	52828806	52829094	MACS_peak_6850	69	288	0	0	0	intergen
15	53097542	53097780	MACS_peak_6851	529.15	238	0	0	0	intergen
15	53156422	53156854	MACS_peak_6852	172.77	432	0	0	0	intergen
15	53187610	53187962	MACS_peak_6853	75.26	352	0	0	0	intergen
15	53381329	53381705	MACS_peak_6854	56.1	376	0	0	0	intergen
15	53544174	53544529	MACS_peak_6855	50.72	355	0	1	0	gen
15	53590010	53590306	MACS_peak_6856	409.5	296	0	1	0	gen
15	53808207	53808421	MACS_peak_6857	423.19	214	0	0	0	intergen
15	53811635	53811840	MACS_peak_6858	729.92	205	0	0	0	intergen
15	53891899	53892242	MACS_peak_6859	247.94	343	0	0	0	intergen
15	53900195	53900519	MACS_peak_6860	1198.74	324	0	0	0	intergen
15	53952811	53953078	MACS_peak_6861	380.3	267	0	0	1	other
15	53962930	53963254	MACS_peak_6862	1795.3	324	0	0	1	other
15	54053324	54053803	MACS_peak_6863	383.19	479	0	1	0	gen
15	54081249	54081458	MACS_peak_6864	596.67	209	0	1	0	gen
15	54185117	54185448	MACS_peak_6865	100.86	331	0	1	0	gen
15	54236497	54236690	MACS_peak_6866	794.58	193	0	1	0	gen
15	54925935	54926379	MACS_peak_6868	182	444	0	0	0	intergen
15	55108854	55109157	MACS_peak_6870	688.35	303	0	0	0	intergen
15	55217652	55217971	MACS_peak_6871	439.33	319	0	1	0	gen
15	55433816	55434078	MACS_peak_6872	859.93	262	0	1	1	gen
15	55605657	55606006	MACS_peak_6873	397.64	349	0	0	0	intergen
15	55702152	55702395	MACS_peak_6874	760.34	243	0	1	0	gen
15	55846126	55846404	MACS_peak_6875	579.67	278	0	1	0	gen
15	55976528	55976767	MACS_peak_6876	502.51	239	0	1	0	gen
15	56125467	56125646	MACS_peak_6877	746.04	179	0	1	0	gen
15	56246040	56246360	MACS_peak_6878	1075.82	320	1	0	0	promoter
15	56311236	56311635	MACS_peak_6879	95.67	399	0	1	0	gen
15	56311695	56312040	MACS_peak_6880	69.9	345	0	1	0	gen
15	56331783	56332125	MACS_peak_6881	89.02	342	0	1	0	gen
15	56375748	56375996	MACS_peak_6882	93.12	248	0	1	0	gen
15	56437523	56437876	MACS_peak_6883	93.4	353	0	2	0	gen
15	56461863	56462015	MACS_peak_6884	817.2	152	0	1	0	gen
15	57146442	57146678	MACS_peak_6885	502.51	236	0	1	0	gen
15	57779282	57779551	MACS_peak_6886	406.81	269	0	1	0	gen
15	57866209	57866418	MACS_peak_6887	613.04	209	0	0	0	intergen
15	57870822	57871035	MACS_peak_6888	593.82	213	0	0	0	intergen
15	58126130	58126382	MACS_peak_6889	146.76	252	0	1	0	gen
15	58127590	58127990	MACS_peak_6890	60.97	400	0	1	0	gen
15	58130974	58131281	MACS_peak_6891	75.97	307	0	1	0	gen
15	58131343	58131628	MACS_peak_6892	180.73	285	0	1	0	gen
15	58196425	58196899	MACS_peak_6893	81.3	474	0	1	0	gen
15	58204364	58204543	MACS_peak_6894	746.04	179	0	1	0	gen
15	58347358	58347585	MACS_peak_6895	177.34	227	0	1	0	gen
15	60444114	60444427	MACS_peak_6896	555.13	313	0	1	0	gen
15	60515851	60516242	MACS_peak_6897	1156.62	391	0	1	1	gen
15	61818126	61818347	MACS_peak_6898	862.08	221	0	0	0	intergen
15	62037127	62037494	MACS_peak_6900	380.3	367	0	1	0	gen
15	62056298	62056499	MACS_peak_6901	918.11	201	0	1	0	gen
15	62306979	62307212	MACS_peak_6902	532.66	233	0	0	0	intergen
15	62596114	62596394	MACS_peak_6903	348.12	280	0	1	0	gen
15	62912894	62913138	MACS_peak_6904	501.16	244	0	0	0	intergen
15	63048049	63048472	MACS_peak_6905	1245.23	423	0	1	1	gen
15	63102180	63102455	MACS_peak_6906	164.26	275	0	0	1	other
15	63487289	63487588	MACS_peak_6907	488.85	299	0	0	0	intergen
15	63547772	63548008	MACS_peak_6908	793.98	236	0	1	1	gen
15	63619264	63619476	MACS_peak_6910	119.31	212	0	1	0	gen
15	63620133	63620506	MACS_peak_6911	51.86	373	0	1	0	gen
15	63621654	63621989	MACS_peak_6912	121.27	335	0	1	0	gen
15	63740650	63740926	MACS_peak_6913	581.17	276	0	1	0	gen
15	63826649	63826974	MACS_peak_6914	506.92	325	0	1	0	gen
15	63945194	63945564	MACS_peak_6915	1161.6	370	0	1	0	gen
15	64209818	64210066	MACS_peak_6916	613.04	248	0	2	0	gen
15	64364689	64365049	MACS_peak_6917	158.81	360	1	1	0	promoter
15	64395985	64396298	MACS_peak_6918	600.44	313	0	1	0	gen
15	64402007	64402271	MACS_peak_6919	540.16	264	0	1	0	gen
15	64681513	64681737	MACS_peak_6920	564.54	224	0	1	0	gen
15	65101688	65101956	MACS_peak_6921	462.14	268	0	1	0	gen
15	65271083	65271279	MACS_peak_6922	662.31	196	0	1	0	gen
15	65304286	65304635	MACS_peak_6923	654.27	349	0	0	0	intergen
15	65517691	65517958	MACS_peak_6924	913.96	267	0	0	0	intergen
15	65638685	65638878	MACS_peak_6925	1043.77	193	0	1	0	gen
15	65859481	65859616	MACS_peak_6926	1358.26	135	0	1	0	gen
15	65885691	65885947	MACS_peak_6927	722.05	256	0	1	0	gen
15	66252281	66252576	MACS_peak_6928	445.58	295	0	1	0	gen
15	66449967	66450259	MACS_peak_6929	99.97	292	0	1	0	gen
15	66451843	66452134	MACS_peak_6930	218.29	291	0	1	0	gen
15	66497774	66498032	MACS_peak_6931	727.26	258	1	0	0	promoter
15	66712687	66712820	MACS_peak_6932	1098.16	133	0	1	0	gen
15	67433638	67433805	MACS_peak_6933	814.37	167	0	1	1	gen
15	67449234	67449536	MACS_peak_6934	123.52	302	0	1	1	gen
15	67456935	67457363	MACS_peak_6935	431.4	428	0	1	1	gen
15	68154954	68155274	MACS_peak_6936	550.56	320	0	1	0	gen
15	68161375	68161509	MACS_peak_6937	1377.21	134	0	1	0	gen
15	68252999	68253234	MACS_peak_6938	972.07	235	0	1	0	gen
15	68383540	68383765	MACS_peak_6939	548.55	225	0	1	0	gen
15	68396819	68397084	MACS_peak_6940	565.47	265	0	1	0	gen
15	68397277	68397651	MACS_peak_6941	735.03	374	0	1	0	gen
15	68397998	68398311	MACS_peak_6942	76.3	313	0	1	0	gen
15	68400783	68400993	MACS_peak_6943	919.78	210	0	1	0	gen
15	68664521	68664879	MACS_peak_6944	648.14	358	0	1	0	gen
15	68674141	68674358	MACS_peak_6945	580.62	217	0	1	0	gen
15	68829083	68829352	MACS_peak_6946	461.5	269	0	1	0	gen
15	69059207	69059587	MACS_peak_6947	402.16	380	0	1	0	gen
15	69265398	69265687	MACS_peak_6948	699.78	289	0	1	0	gen
15	69575990	69576378	MACS_peak_6949	628.81	388	0	0	1	other
15	70346428	70346701	MACS_peak_6950	470.9	273	0	0	0	intergen
15	70460244	70460452	MACS_peak_6951	613.04	208	0	0	0	intergen
15	70512905	70513151	MACS_peak_6952	485.56	246	0	0	0	intergen
15	70569121	70569468	MACS_peak_6953	533.85	347	0	0	0	intergen
15	70663089	70663365	MACS_peak_6954	142.05	276	0	1	0	gen
15	70984334	70984571	MACS_peak_6955	189.9	237	0	1	0	gen
15	70986490	70986831	MACS_peak_6956	55.24	341	0	1	0	gen
15	70988472	70988759	MACS_peak_6957	66.55	287	0	1	0	gen
15	70990017	70990272	MACS_peak_6958	169.18	255	0	1	0	gen
15	71011586	71011834	MACS_peak_6959	1140.18	248	0	1	0	gen
15	71095044	71095374	MACS_peak_6960	101.24	330	1	0	0	promoter
15	71134731	71135107	MACS_peak_6961	142.05	376	0	1	0	gen
15	71369438	71369760	MACS_peak_6962	97.7	322	0	1	0	gen
15	71443467	71443835	MACS_peak_6963	641.52	368	0	1	0	gen
15	71531928	71532322	MACS_peak_6964	625.13	394	0	1	0	gen
15	71586984	71587245	MACS_peak_6965	223.1	261	0	1	0	gen
15	71587641	71587917	MACS_peak_6966	199.77	276	0	1	0	gen
15	71793682	71794088	MACS_peak_6967	70.6	406	1	0	0	promoter
15	71794261	71794578	MACS_peak_6968	65.71	317	1	0	0	promoter
15	71794761	71794992	MACS_peak_6969	69.13	231	1	0	0	promoter
15	72079238	72079586	MACS_peak_6971	517.37	348	0	1	0	gen
15	72099319	72099457	MACS_peak_6972	885.2	138	0	1	0	gen
15	72156113	72156378	MACS_peak_6973	464.09	265	1	0	0	promoter
15	72473641	72473847	MACS_peak_6974	629.38	206	1	0	1	promoter
15	72498859	72499077	MACS_peak_6975	442.94	218	0	1	0	gen
15	72611098	72611434	MACS_peak_6976	423.21	336	0	0	2	other
15	72663846	72664188	MACS_peak_6977	263.91	342	0	1	0	gen
15	72670607	72670945	MACS_peak_6978	1269.98	338	0	0	0	intergen
15	73062963	73063184	MACS_peak_6979	482.68	221	0	1	0	gen
15	73216878	73217309	MACS_peak_6980	107.46	431	0	1	0	gen
15	73240947	73241228	MACS_peak_6981	706.57	281	0	1	0	gen
15	73265606	73265864	MACS_peak_6982	451.95	258	0	1	0	gen
15	73508590	73508856	MACS_peak_6983	203.93	266	0	1	0	gen
15	73509499	73509936	MACS_peak_6984	68.97	437	0	1	0	gen
15	73532706	73533023	MACS_peak_6986	70.04	317	0	1	0	gen
15	73542941	73543077	MACS_peak_6987	847.14	136	0	1	0	gen
15	73636490	73636781	MACS_peak_6988	839.67	291	0	0	0	intergen
15	73700345	73700541	MACS_peak_6989	1025.76	196	0	1	0	gen
15	73712157	73712315	MACS_peak_6990	767.82	158	0	1	0	gen
15	73873890	73874268	MACS_peak_6991	403.06	378	1	0	0	promoter
15	73876071	73876248	MACS_peak_6992	815.65	177	1	0	0	promoter
15	74048334	74048646	MACS_peak_6993	555.79	312	0	0	0	intergen
15	74065842	74066005	MACS_peak_6994	1155.39	163	1	0	0	promoter
15	74307876	74308084	MACS_peak_6996	604.98	208	0	1	0	gen
15	74382444	74382660	MACS_peak_6997	746.04	216	0	0	1	other
15	74631871	74632262	MACS_peak_6998	626.96	391	1	1	0	promoter
15	74635251	74635516	MACS_peak_6999	1141.07	265	1	1	0	promoter
15	74753731	74753863	MACS_peak_7001	1116.4	132	0	0	0	intergen
15	74769003	74769390	MACS_peak_7002	511.42	387	0	0	0	intergen
15	74835292	74835634	MACS_peak_7003	420.18	342	1	0	0	promoter
15	74901647	74901880	MACS_peak_7004	831.63	233	1	1	0	promoter
15	74925682	74926049	MACS_peak_7005	296.48	367	0	1	0	gen
15	74950373	74950647	MACS_peak_7006	932.94	274	1	0	0	promoter
15	75084439	75084883	MACS_peak_7007	87.04	444	0	1	0	gen
15	75250040	75250329	MACS_peak_7008	770.52	289	0	0	0	intergen
15	75274348	75274698	MACS_peak_7010	1541.77	350	0	0	0	intergen
15	75299345	75299508	MACS_peak_7012	822.5	163	0	0	0	intergen
15	75410866	75411296	MACS_peak_7013	437.12	430	0	1	0	gen
15	75481987	75482359	MACS_peak_7014	103.45	372	0	1	0	gen
15	76057444	76057748	MACS_peak_7016	440.4	304	1	1	0	promoter
15	76139543	76139851	MACS_peak_7017	684.39	308	0	1	0	gen
15	76147970	76148289	MACS_peak_7018	432.12	319	0	1	0	gen
15	76330565	76330818	MACS_peak_7019	448.82	253	0	0	0	intergen
15	76422930	76423249	MACS_peak_7020	51.86	319	0	1	0	gen
15	76537955	76538293	MACS_peak_7021	91.68	338	0	1	0	gen
15	76637750	76638148	MACS_peak_7022	489.87	398	0	1	0	gen
15	76641096	76641373	MACS_peak_7023	158.81	277	0	1	0	gen
15	76732342	76732530	MACS_peak_7024	695.57	188	0	1	0	gen
15	76762362	76762494	MACS_peak_7025	977.06	132	0	1	0	gen
15	77118818	77119119	MACS_peak_7026	821.52	301	0	1	0	gen
15	77171264	77171732	MACS_peak_7027	564.47	468	0	1	0	gen
15	77262996	77263343	MACS_peak_7029	76.91	347	0	1	0	gen
15	77618441	77618610	MACS_peak_7030	3108.84	169	0	1	0	gen
15	77633580	77633815	MACS_peak_7031	516.86	235	0	1	0	gen
15	77870506	77870733	MACS_peak_7032	548.55	227	0	0	0	intergen
15	77910414	77910855	MACS_peak_7033	1095.16	441	0	0	0	intergen
15	77917457	77917767	MACS_peak_7034	312.33	310	0	0	2	other
15	78422891	78423128	MACS_peak_7035	814.37	237	0	0	0	intergen
15	78432696	78432960	MACS_peak_7036	451.4	264	1	0	0	promoter
15	78606336	78606598	MACS_peak_7037	402.25	262	0	1	0	gen
15	78724962	78725192	MACS_peak_7038	322.91	230	0	1	1	gen
15	78736211	78736566	MACS_peak_7039	301.94	355	0	0	1	other
15	78860176	78860540	MACS_peak_7040	374.08	364	0	1	0	gen
15	79338551	79338880	MACS_peak_7041	356.46	329	0	1	0	gen
15	79340060	79340298	MACS_peak_7042	1116.4	238	0	1	0	gen
15	79352933	79353406	MACS_peak_7043	634.13	473	0	1	0	gen
15	79381070	79381329	MACS_peak_7044	726.32	259	0	1	0	gen
15	79596059	79596491	MACS_peak_7046	972.47	432	0	0	0	intergen
15	79711108	79711455	MACS_peak_7047	123.16	347	0	0	0	intergen
15	79769219	79769434	MACS_peak_7049	746.04	215	0	0	0	intergen
15	80455749	80456091	MACS_peak_7051	659.14	342	0	1	0	gen
15	80848865	80849070	MACS_peak_7052	335.51	205	0	1	0	gen
15	80982492	80982729	MACS_peak_7053	528.22	237	0	1	0	gen
15	81155198	81155330	MACS_peak_7054	1116.4	132	1	0	0	promoter
15	81256973	81257243	MACS_peak_7055	716.24	270	0	1	0	gen
15	81400743	81400966	MACS_peak_7056	712.32	223	0	0	1	other
15	81480643	81480835	MACS_peak_7057	866.35	192	0	0	2	other
15	81584125	81584390	MACS_peak_7058	93.4	265	0	0	2	other
15	81647649	81647829	MACS_peak_7059	681.25	180	0	0	2	other
15	81733917	81734308	MACS_peak_7061	52.48	391	0	0	2	other
15	81765291	81765591	MACS_peak_7062	488.85	300	0	0	1	other
15	81873489	81873825	MACS_peak_7065	72.42	336	0	0	0	intergen
15	81875647	81875937	MACS_peak_7066	114.37	290	0	0	0	intergen
15	81939671	81940022	MACS_peak_7067	415.73	351	0	0	0	intergen
15	82000644	82001036	MACS_peak_7068	125.63	392	0	0	0	intergen
15	82108527	82108800	MACS_peak_7069	388.02	273	0	0	0	intergen
15	82139830	82140120	MACS_peak_7070	698.94	290	0	1	0	gen
15	82343090	82343363	MACS_peak_7071	997.14	273	1	0	0	promoter
15	82365705	82365998	MACS_peak_7072	1042.98	293	0	0	1	other
15	82435792	82436096	MACS_peak_7073	1068.61	304	0	1	0	gen
15	82468275	82468625	MACS_peak_7074	532.08	350	0	0	1	other
15	82525809	82526113	MACS_peak_7076	1404.74	304	0	0	1	other
15	82530869	82531066	MACS_peak_7077	641.55	197	0	0	0	intergen
15	82503030	82503272	MACS_peak_7085	402.63	242	0	0	1	other
15	82743321	82743543	MACS_peak_7088	614.29	222	0	0	0	intergen
15	82789213	82789472	MACS_peak_7089	506.92	259	0	1	0	gen
15	82884135	82884612	MACS_peak_7090	56.89	477	0	1	0	gen
15	83073896	83074116	MACS_peak_7091	400.18	220	0	0	2	other
15	83385603	83385909	MACS_peak_7092	138.82	306	0	0	1	other
15	83446902	83447125	MACS_peak_7093	415.08	223	1	0	0	promoter
15	83528350	83528601	MACS_peak_7094	320.46	251	0	1	0	gen
15	83572085	83572357	MACS_peak_7095	714.45	272	0	1	0	gen
15	83660775	83661161	MACS_peak_7096	75.42	386	0	1	0	gen
15	83781790	83781987	MACS_peak_7097	927.92	197	0	1	0	gen
15	83829259	83829544	MACS_peak_7098	75.5	285	0	1	0	gen
15	84167448	84167819	MACS_peak_7099	331.61	371	0	0	1	other
15	84195702	84195999	MACS_peak_7100	444.41	297	0	0	1	other
15	84242003	84242276	MACS_peak_7101	1179.91	273	0	1	0	gen
15	84426921	84427346	MACS_peak_7102	727.98	425	0	0	0	intergen
15	84505745	84506116	MACS_peak_7103	370.63	371	0	0	0	intergen
15	84510258	84510512	MACS_peak_7104	1208.47	254	0	0	1	other
15	84570799	84571198	MACS_peak_7105	739.69	399	0	0	2	other
15	84587938	84588265	MACS_peak_7106	427.87	327	0	0	0	intergen
15	84845638	84845884	MACS_peak_7107	629.38	246	0	1	0	gen
15	85200282	85200592	MACS_peak_7108	664.2	310	0	0	2	other
15	85246630	85246855	MACS_peak_7109	508.73	225	0	0	1	other
15	85399239	85399627	MACS_peak_7110	243.49	388	0	1	0	gen
15	85439261	85439634	MACS_peak_7111	97.58	373	0	1	0	gen
15	85486004	85486218	MACS_peak_7112	761	214	0	1	0	gen
15	85505143	85505338	MACS_peak_7113	644.94	195	0	1	0	gen
15	86213608	86213855	MACS_peak_7114	436.8	247	0	1	0	gen
15	86458841	86459095	MACS_peak_7115	487.24	254	0	1	0	gen
15	86528903	86529301	MACS_peak_7116	75.42	398	0	1	0	gen
15	86532644	86533109	MACS_peak_7117	93.97	465	0	1	0	gen
15	86743356	86743631	MACS_peak_7118	404.73	275	0	1	0	gen
15	86973901	86974152	MACS_peak_7119	468.24	251	0	1	1	gen
15	87277598	87277955	MACS_peak_7120	76.3	357	0	0	0	intergen
15	87329422	87329797	MACS_peak_7121	76.3	375	0	0	0	intergen
15	87382681	87383118	MACS_peak_7123	137.06	437	0	0	0	intergen
15	87425624	87425839	MACS_peak_7124	746.04	215	0	0	0	intergen
15	87447348	87447644	MACS_peak_7125	722.05	296	0	0	1	other
15	87468518	87468930	MACS_peak_7126	87.15	412	0	0	1	other
15	87485333	87485663	MACS_peak_7127	50.92	330	0	0	1	other
15	87959089	87959330	MACS_peak_7128	501.16	241	0	1	0	gen
15	88455044	88455301	MACS_peak_7129	1006.59	257	2	0	0	promoter
15	88940672	88941152	MACS_peak_7132	101.68	480	0	0	0	intergen
15	89034591	89034833	MACS_peak_7133	304.63	242	0	0	0	intergen
15	89048325	89048707	MACS_peak_7134	66.1	382	0	0	1	other
15	89057548	89057819	MACS_peak_7135	460.22	271	0	0	1	other
15	89206726	89207134	MACS_peak_7136	1214.08	408	1	0	0	promoter
15	89416403	89416650	MACS_peak_7137	763.02	247	0	0	0	intergen
15	89442750	89443009	MACS_peak_7138	1004.17	259	0	0	0	intergen
15	89472904	89473073	MACS_peak_7139	814.37	169	1	0	0	promoter
15	89535494	89535915	MACS_peak_7142	131.32	421	0	0	1	other
15	89558033	89558507	MACS_peak_7143	71.7	474	0	0	1	other
15	89565702	89565914	MACS_peak_7144	1146.55	212	0	0	1	other
15	89842206	89842427	MACS_peak_7145	549.18	221	0	2	0	gen
15	89971586	89971809	MACS_peak_7146	564.54	223	0	0	0	intergen
15	90071397	90071674	MACS_peak_7147	309.76	277	0	1	0	gen
15	90185812	90185947	MACS_peak_7148	1965.34	135	0	1	0	gen
15	90214533	90214795	MACS_peak_7149	538.27	262	0	1	0	gen
15	90293396	90293606	MACS_peak_7150	613.04	210	0	1	1	gen
15	90320009	90320292	MACS_peak_7151	575.98	283	0	0	0	intergen
15	90362076	90362320	MACS_peak_7152	469.89	244	0	1	0	gen
15	90581247	90581505	MACS_peak_7153	380.3	258	0	1	0	gen
15	90648082	90648351	MACS_peak_7154	586.5	269	0	0	1	other
15	90693730	90693992	MACS_peak_7155	1002.15	262	0	0	1	other
15	90886068	90886486	MACS_peak_7156	495.64	418	1	0	0	promoter
15	90956591	90956788	MACS_peak_7157	806.85	197	1	0	0	promoter
15	90990038	90990469	MACS_peak_7158	349.84	431	0	2	0	gen
15	91092937	91093288	MACS_peak_7159	56.38	351	0	0	0	intergen
15	91270421	91270790	MACS_peak_7160	407.18	369	0	1	0	gen
15	91506192	91506520	MACS_peak_7161	152.59	328	0	0	1	other
15	91522610	91522887	MACS_peak_7162	844.51	277	0	0	1	other
15	91613361	91613818	MACS_peak_7163	133.34	457	0	0	0	intergen
15	91622542	91622791	MACS_peak_7164	485.56	249	0	0	0	intergen
15	91706425	91706742	MACS_peak_7165	552.5	317	0	0	0	intergen
15	91956918	91957171	MACS_peak_7166	746.04	253	0	1	0	gen
15	92082409	92082578	MACS_peak_7168	814.37	169	0	1	0	gen
15	92097658	92097871	MACS_peak_7169	1098.16	213	0	1	0	gen
15	92139893	92140246	MACS_peak_7170	113.12	353	0	1	0	gen
15	92226138	92226475	MACS_peak_7171	409.48	337	0	0	1	other
15	92228348	92228482	MACS_peak_7172	1666.76	134	0	0	1	other
15	92249800	92250060	MACS_peak_7173	310.95	260	0	0	1	other
15	92383601	92383858	MACS_peak_7174	469.39	257	0	0	0	intergen
15	92488490	92488803	MACS_peak_7175	101.27	313	0	0	1	other
15	92631066	92631523	MACS_peak_7176	573.99	457	0	1	0	gen
15	92683552	92683771	MACS_peak_7177	580.62	219	0	1	0	gen
15	92694108	92694467	MACS_peak_7178	772.93	359	0	1	0	gen
15	92700136	92700411	MACS_peak_7179	114.74	275	0	1	1	gen
15	92714758	92715093	MACS_peak_7180	1060	335	0	1	1	gen
15	92777545	92777891	MACS_peak_7181	1102.85	346	0	1	0	gen
15	92899683	92900052	MACS_peak_7182	407.18	369	1	1	0	promoter
15	93041585	93041957	MACS_peak_7183	361.74	372	0	1	0	gen
15	93402621	93402999	MACS_peak_7184	201.59	378	0	0	1	other
15	93595204	93595585	MACS_peak_7185	80.42	381	0	0	1	other
15	93639332	93639495	MACS_peak_7186	615.31	163	0	0	1	other
15	93795646	93796119	MACS_peak_7187	88.29	473	0	0	1	other
15	93874484	93874671	MACS_peak_7188	879.27	187	0	0	2	other
15	94119959	94120219	MACS_peak_7189	593.56	260	0	0	0	intergen
15	94150147	94150462	MACS_peak_7190	123.72	315	0	0	0	intergen
15	94264884	94265075	MACS_peak_7191	695.57	191	0	1	0	gen
15	94318166	94318310	MACS_peak_7192	828.01	144	0	1	0	gen
15	94390708	94391030	MACS_peak_7193	488.85	322	0	1	0	gen
15	94526155	94526548	MACS_peak_7194	794.65	393	0	0	0	intergen
15	94582439	94582711	MACS_peak_7195	459.58	272	0	0	0	intergen
15	94836236	94836458	MACS_peak_7196	883.81	222	0	0	0	intergen
15	94913518	94913734	MACS_peak_7197	944.23	216	0	0	1	other
15	95155278	95155626	MACS_peak_7198	173.01	348	0	0	1	other
15	95259499	95259804	MACS_peak_7199	560.48	305	0	0	1	other
15	95773011	95773288	MACS_peak_7200	2270.45	277	0	0	1	other
15	95787132	95787338	MACS_peak_7201	540.33	206	0	0	1	other
15	95790725	95790972	MACS_peak_7202	1195.31	247	0	0	1	other
15	96020313	96020680	MACS_peak_7203	642.17	367	0	0	1	other
15	96353952	96354274	MACS_peak_7204	430.51	322	0	0	0	intergen
15	96701513	96701725	MACS_peak_7205	758.25	212	0	0	0	intergen
15	97058885	97059023	MACS_peak_7206	2656.43	138	0	0	0	intergen
15	97221352	97221716	MACS_peak_7207	103.45	364	0	0	0	intergen
15	97235402	97235808	MACS_peak_7208	852.39	406	0	0	0	intergen
15	97245854	97246085	MACS_peak_7209	960.08	231	0	0	0	intergen
15	97295516	97295892	MACS_peak_7213	137.67	376	0	0	1	other
15	97375389	97375668	MACS_peak_7214	166.07	279	0	0	2	other
15	97395002	97395328	MACS_peak_7215	264.1	326	0	0	2	other
15	97413933	97414293	MACS_peak_7216	56.38	360	0	0	2	other
15	97414304	97414545	MACS_peak_7217	78.97	241	0	0	2	other
15	97415973	97416283	MACS_peak_7218	115.17	310	0	0	2	other
15	97435661	97435959	MACS_peak_7219	84.34	298	0	0	1	other
15	97436407	97436738	MACS_peak_7220	115.67	331	0	0	1	other
15	97437533	97437899	MACS_peak_7221	52.68	366	0	0	1	other
15	97461511	97461764	MACS_peak_7222	883.81	253	0	0	1	other
15	97640914	97641302	MACS_peak_7223	663.02	388	0	0	1	other
15	98009907	98010113	MACS_peak_7224	749.2	206	0	0	1	other
15	98085050	98085463	MACS_peak_7225	835.46	413	0	0	2	other
15	98421656	98421956	MACS_peak_7226	563.9	300	0	0	0	intergen
15	98442428	98442615	MACS_peak_7227	712.32	187	0	1	0	gen
15	98568439	98568699	MACS_peak_7228	380.3	260	0	0	0	intergen
15	98581830	98582028	MACS_peak_7229	762.11	198	0	0	0	intergen
15	98598619	98598864	MACS_peak_7230	426.48	245	0	0	0	intergen
15	98659171	98659537	MACS_peak_7231	507.03	366	0	1	0	gen
15	98904483	98904737	MACS_peak_7232	470.06	254	0	1	0	gen
15	99213296	99213589	MACS_peak_7233	490.12	293	0	1	0	gen
15	99273023	99273219	MACS_peak_7234	1226.97	196	0	1	0	gen
15	99286415	99286693	MACS_peak_7235	970.76	278	0	1	0	gen
15	99420209	99420568	MACS_peak_7236	70.43	359	0	0	0	intergen
15	99797274	99797629	MACS_peak_7237	906.11	355	0	0	1	other
15	99883270	99883696	MACS_peak_7238	145.73	426	0	0	0	intergen
15	99910077	99910284	MACS_peak_7239	613.04	207	0	0	0	intergen
15	99991269	99991602	MACS_peak_7240	219.32	333	0	1	0	gen
15	100070514	100070882	MACS_peak_7241	202.22	368	0	1	0	gen
15	100072307	100072667	MACS_peak_7242	101.68	360	0	1	0	gen
15	100349732	100349958	MACS_peak_7243	548.55	226	0	0	0	intergen
15	100572473	100572674	MACS_peak_7244	651.96	201	0	1	0	gen
15	100627832	100628126	MACS_peak_7245	446.16	294	0	1	0	gen
15	100741030	100741250	MACS_peak_7246	549.18	220	0	0	1	other
15	100873147	100873511	MACS_peak_7247	644.14	364	1	0	3	promoter
15	100934692	100934825	MACS_peak_7248	1011.74	133	0	1	0	gen
15	101008475	101008719	MACS_peak_7249	346.41	244	0	1	0	gen
15	101015228	101015403	MACS_peak_7250	780.06	175	0	1	0	gen
15	101152887	101153135	MACS_peak_7251	613.04	248	0	0	0	intergen
15	101258209	101258422	MACS_peak_7252	1453.47	213	0	0	0	intergen
15	101269891	101270171	MACS_peak_7253	562.2	280	1	0	0	promoter
15	101300157	101300617	MACS_peak_7254	588.1	460	1	0	2	promoter
15	101402629	101402956	MACS_peak_7255	102.4	327	0	1	0	gen
15	101629591	101629856	MACS_peak_7256	60.31	265	0	1	0	gen
15	101639194	101639503	MACS_peak_7257	488.85	309	0	1	0	gen
15	101641210	101641496	MACS_peak_7258	973.26	286	0	1	0	gen
15	101664228	101664626	MACS_peak_7259	349.84	398	0	1	0	gen
15	101753011	101753402	MACS_peak_7260	148.35	391	0	0	1	other
15	101757328	101757666	MACS_peak_7261	142.19	338	0	0	1	other
15	101766947	101767302	MACS_peak_7262	722.88	355	0	0	1	other
15	101773855	101774080	MACS_peak_7263	548.55	225	0	0	2	other
15	101891700	101892046	MACS_peak_7265	212.67	346	0	0	0	intergen
15	101896854	101897117	MACS_peak_7266	309.77	263	0	0	0	intergen
15	101916089	101916421	MACS_peak_7267	70.48	332	0	0	0	intergen
15	101917282	101917658	MACS_peak_7268	56.1	376	1	0	0	promoter
15	101917794	101918044	MACS_peak_7269	145.35	250	1	0	0	promoter
15	101964813	101965084	MACS_peak_7270	311.89	271	0	0	1	other
15	101979444	101979817	MACS_peak_7271	2333.78	373	0	0	0	intergen
16	18644	19042	MACS_peak_7273	272.05	398	0	0	1	other
16	22681	22994	MACS_peak_7274	399.72	313	0	0	1	other
16	52608	52894	MACS_peak_7275	265.34	286	1	1	0	promoter
16	386633	386855	MACS_peak_7276	867.76	222	0	1	1	gen
16	612094	612563	MACS_peak_7277	398.43	469	0	1	0	gen
16	612712	613081	MACS_peak_7278	236.35	369	0	1	0	gen
16	743339	743651	MACS_peak_7279	539.85	312	0	0	0	intergen
16	1236490	1236893	MACS_peak_7280	741.16	403	1	0	0	promoter
16	1249536	1249869	MACS_peak_7281	789.4	333	0	0	0	intergen
16	1812693	1812941	MACS_peak_7282	485.56	248	0	1	0	gen
16	1863716	1863964	MACS_peak_7283	1208.41	248	0	1	0	gen
16	1929680	1929985	MACS_peak_7284	439.84	305	0	0	0	intergen
16	2639184	2639374	MACS_peak_7286	695.57	190	0	0	1	other
16	2660956	2661221	MACS_peak_7287	1943.14	265	0	0	1	other
16	2670196	2670463	MACS_peak_7288	740.61	267	0	0	1	other
16	2795120	2795373	MACS_peak_7289	746.04	253	1	0	0	promoter
16	2868490	2868751	MACS_peak_7290	466.72	261	0	0	0	intergen
16	2874834	2875176	MACS_peak_7291	659.14	342	0	0	0	intergen
16	2907226	2907557	MACS_peak_7292	527.67	331	1	0	0	promoter
16	2961838	2962162	MACS_peak_7293	672.17	324	1	0	0	promoter
16	2983730	2983954	MACS_peak_7294	564.54	224	1	0	0	promoter
16	3074597	3074746	MACS_peak_7295	1964.25	149	0	1	0	gen
16	3166014	3166268	MACS_peak_7296	601.15	254	0	0	0	intergen
16	4045404	4045733	MACS_peak_7298	349.84	329	0	1	0	gen
16	4175467	4175716	MACS_peak_7299	485.56	249	0	0	0	intergen
16	4288475	4288676	MACS_peak_7300	1164.24	201	0	0	0	intergen
16	4330373	4330637	MACS_peak_7301	1142.38	264	1	1	0	promoter
16	4823623	4823761	MACS_peak_7302	1043.77	138	0	1	0	gen
16	5084841	5085073	MACS_peak_7303	532.66	232	1	1	0	promoter
16	5092403	5092593	MACS_peak_7304	677.53	190	0	1	0	gen
16	6350360	6350722	MACS_peak_7305	662.91	362	0	1	0	gen
16	6643097	6643404	MACS_peak_7307	685.18	307	0	1	0	gen
16	6860729	6860917	MACS_peak_7309	1034.21	188	0	1	0	gen
16	6870594	6870806	MACS_peak_7310	763.02	212	0	1	0	gen
16	6924781	6925186	MACS_peak_7311	159.56	405	0	1	0	gen
16	7028505	7028736	MACS_peak_7312	966.16	231	0	1	0	gen
16	7067709	7068134	MACS_peak_7313	238.69	425	0	1	0	gen
16	7268162	7268479	MACS_peak_7314	433.2	317	0	1	0	gen
16	7313319	7313568	MACS_peak_7315	388.7	249	0	1	0	gen
16	8008817	8009120	MACS_peak_7316	185.66	303	0	0	0	intergen
16	8060303	8060653	MACS_peak_7317	133.58	350	0	0	0	intergen
16	8364192	8364359	MACS_peak_7318	207.17	167	0	0	0	intergen
16	8567675	8568060	MACS_peak_7319	630.67	385	0	1	0	gen
16	8652010	8652310	MACS_peak_7320	329.82	300	0	0	0	intergen
16	8660981	8661245	MACS_peak_7321	658.98	264	0	0	0	intergen
16	8873627	8874013	MACS_peak_7322	1815.39	386	0	0	0	intergen
16	8905261	8905549	MACS_peak_7323	449.72	288	0	1	0	gen
16	9139075	9139318	MACS_peak_7324	936.57	243	0	0	0	intergen
16	9317105	9317438	MACS_peak_7325	123.2	333	0	0	0	intergen
16	9584318	9584758	MACS_peak_7326	160.35	440	0	0	1	other
16	9585791	9586175	MACS_peak_7327	54.72	384	0	0	1	other
16	9589220	9589546	MACS_peak_7328	110.98	326	0	0	1	other
16	9589710	9590173	MACS_peak_7329	187.99	463	0	0	1	other
16	9724194	9724431	MACS_peak_7331	433.73	237	0	0	0	intergen
16	9729458	9729743	MACS_peak_7332	129.19	285	0	0	0	intergen
16	9848773	9849242	MACS_peak_7333	583.48	469	0	1	0	gen
16	9914823	9915148	MACS_peak_7334	272.05	325	0	1	0	gen
16	10122577	10122955	MACS_peak_7335	403.06	378	0	1	0	gen
16	10188698	10188832	MACS_peak_7336	1212.73	134	0	0	0	intergen
16	10460847	10461109	MACS_peak_7338	603.02	262	0	1	0	gen
16	10477568	10477928	MACS_peak_7339	56.38	360	0	1	0	gen
16	10971445	10971748	MACS_peak_7341	440.97	303	0	1	0	gen
16	11067074	11067219	MACS_peak_7342	1099.11	145	0	1	1	gen
16	11136312	11136676	MACS_peak_7343	409.51	364	0	1	0	gen
16	11396316	11396565	MACS_peak_7344	1043.77	249	0	1	0	gen
16	11405643	11405865	MACS_peak_7345	1396.21	222	0	1	0	gen
16	11419606	11420078	MACS_peak_7346	57.86	472	0	1	0	gen
16	11459183	11459560	MACS_peak_7347	349.84	377	0	1	0	gen
16	11737748	11738100	MACS_peak_7349	371.07	352	0	1	0	gen
16	11921996	11922175	MACS_peak_7350	531.2	179	0	0	0	intergen
16	11960864	11961008	MACS_peak_7351	989.9	144	1	1	0	promoter
16	12067974	12068148	MACS_peak_7352	460.34	174	0	1	0	gen
16	12074039	12074323	MACS_peak_7353	85.12	284	0	1	0	gen
16	12095226	12095488	MACS_peak_7354	591.97	262	0	1	0	gen
16	12228815	12228986	MACS_peak_7355	797.18	171	0	1	0	gen
16	12455306	12455590	MACS_peak_7356	975.45	284	0	1	0	gen
16	12468160	12468297	MACS_peak_7357	896.34	137	0	1	0	gen
16	12606770	12606992	MACS_peak_7358	301.85	222	0	0	1	other
16	12616008	12616248	MACS_peak_7359	645.81	240	0	0	0	intergen
16	13740023	13740265	MACS_peak_7360	645.81	242	0	0	1	other
16	14249570	14249808	MACS_peak_7361	468.75	238	0	1	0	gen
16	14386998	14387372	MACS_peak_7362	222.62	374	0	0	0	intergen
16	14833424	14833793	MACS_peak_7363	434.03	369	1	0	0	promoter
16	14873094	14873452	MACS_peak_7364	399.16	358	0	1	0	gen
16	14897251	14897636	MACS_peak_7365	1722.91	385	0	0	0	intergen
16	14941357	14941700	MACS_peak_7366	119.24	343	0	1	0	gen
16	14995106	14995545	MACS_peak_7367	185.07	439	0	1	0	gen
16	15114682	15114961	MACS_peak_7368	137.17	279	0	1	2	gen
16	15219832	15220225	MACS_peak_7369	748.06	393	0	0	0	intergen
16	15223479	15223857	MACS_peak_7370	603.02	378	0	0	0	intergen
16	15427652	15427855	MACS_peak_7371	705.57	203	0	1	0	gen
16	15655862	15656216	MACS_peak_7372	180.31	354	0	1	0	gen
16	15682135	15682352	MACS_peak_7373	580.62	217	0	1	0	gen
16	15821746	15822111	MACS_peak_7374	439.1	365	0	1	0	gen
16	16127799	16128112	MACS_peak_7375	488.85	313	0	1	0	gen
16	16232238	16232608	MACS_peak_7376	485.3	370	1	0	0	promoter
16	16295919	16296308	MACS_peak_7377	1722.91	389	0	0	0	intergen
16	16439505	16439729	MACS_peak_7378	303.32	224	0	0	0	intergen
16	16530867	16531158	MACS_peak_7379	431.23	291	0	0	0	intergen
16	16593440	16593747	MACS_peak_7380	1133.98	307	0	0	0	intergen
16	16618281	16618645	MACS_peak_7381	84.4	364	0	0	0	intergen
16	16745291	16745612	MACS_peak_7382	76.3	321	0	0	0	intergen
16	16840783	16841196	MACS_peak_7384	180.36	413	0	0	0	intergen
16	16841333	16841627	MACS_peak_7385	80.96	294	0	0	0	intergen
16	17738002	17738334	MACS_peak_7386	103.96	332	0	0	0	intergen
16	17909311	17909525	MACS_peak_7387	226.43	214	0	0	0	intergen
16	18131456	18131844	MACS_peak_7388	628.81	388	0	0	2	other
16	18135106	18135471	MACS_peak_7389	523.45	365	0	0	2	other
16	18181015	18181306	MACS_peak_7390	447.93	291	0	0	0	intergen
16	18415826	18416216	MACS_peak_7391	1993.08	390	1	0	0	promoter
16	18522720	18523078	MACS_peak_7392	368.21	358	0	1	0	gen
16	18562098	18562467	MACS_peak_7393	549.05	369	0	0	0	intergen
16	18610536	18610956	MACS_peak_7394	51.33	420	0	0	0	intergen
16	18759981	18760261	MACS_peak_7395	915.13	280	0	0	0	intergen
16	18825774	18826163	MACS_peak_7396	86.37	389	0	1	0	gen
16	19086545	19086772	MACS_peak_7398	695.57	227	0	0	0	intergen
16	19179931	19180270	MACS_peak_7399	421.69	339	0	1	0	gen
16	19375656	19375877	MACS_peak_7400	564.54	221	0	0	1	other
16	19434152	19434432	MACS_peak_7401	434.52	280	0	1	0	gen
16	19502761	19502973	MACS_peak_7402	758.25	212	1	0	0	promoter
16	19519339	19519475	MACS_peak_7403	1061.85	136	1	1	0	promoter
16	19583758	19584052	MACS_peak_7404	564.39	294	0	1	0	gen
16	19601289	19601634	MACS_peak_7405	657.04	345	0	1	0	gen
16	19794216	19794486	MACS_peak_7406	716.24	270	0	1	0	gen
16	19886321	19886566	MACS_peak_7407	501.16	245	0	0	0	intergen
16	20185638	20185972	MACS_peak_7408	87.05	334	0	0	0	intergen
16	20385846	20386162	MACS_peak_7409	553.16	316	0	1	0	gen
16	20574377	20574663	MACS_peak_7411	158.81	286	0	1	0	gen
16	20653531	20653883	MACS_peak_7412	124.75	352	0	2	0	gen
16	20743262	20743606	MACS_peak_7413	405.97	344	0	1	0	gen
16	20774795	20775051	MACS_peak_7414	729.14	256	0	1	0	gen
16	20998699	20998875	MACS_peak_7415	526.96	176	0	1	0	gen
16	21438200	21438486	MACS_peak_7416	123.55	286	0	1	0	gen
16	21462200	21462593	MACS_peak_7417	1004.46	393	0	0	1	other
16	21554908	21555199	MACS_peak_7418	447.93	291	0	0	0	intergen
16	21640768	21640985	MACS_peak_7419	580.62	217	1	1	0	promoter
16	21708645	21708909	MACS_peak_7420	590.39	264	0	1	0	gen
16	21745595	21745935	MACS_peak_7421	201.59	340	0	1	0	gen
16	21756960	21757380	MACS_peak_7422	1656.54	420	0	1	0	gen
16	21786058	21786462	MACS_peak_7423	361.27	404	0	0	0	intergen
16	21849352	21849580	MACS_peak_7425	167.15	228	0	1	0	gen
16	22001022	22001351	MACS_peak_7426	426.82	329	0	0	0	intergen
16	22034624	22034858	MACS_peak_7427	653.49	234	0	1	0	gen
16	22077755	22078047	MACS_peak_7428	569.49	292	0	1	0	gen
16	22099073	22099325	MACS_peak_7429	470.06	252	0	1	0	gen
16	22318789	22319026	MACS_peak_7430	814.37	237	0	1	0	gen
16	22452946	22453319	MACS_peak_7431	114.74	373	0	0	1	other
16	22500108	22500483	MACS_peak_7432	116.25	375	0	1	0	gen
16	22561718	22562058	MACS_peak_7433	272.05	340	0	0	1	other
16	22573100	22573520	MACS_peak_7434	1656.54	420	0	0	1	other
16	22602244	22602586	MACS_peak_7435	425.29	342	0	0	0	intergen
16	22680675	22680922	MACS_peak_7436	901.33	247	0	0	0	intergen
16	22766579	22766725	MACS_peak_7437	1226.97	146	0	0	0	intergen
16	22847655	22847920	MACS_peak_7438	589.61	265	0	1	0	gen
16	23182403	23182754	MACS_peak_7439	415.73	351	1	0	1	promoter
16	23253070	23253368	MACS_peak_7440	1243.82	298	0	0	0	intergen
16	23278941	23279105	MACS_peak_7441	810.9	164	1	0	0	promoter
16	23296982	23297114	MACS_peak_7442	972.31	132	0	1	0	gen
16	23431600	23431834	MACS_peak_7443	342.45	234	0	1	0	gen
16	23434465	23434714	MACS_peak_7444	471.88	249	0	1	0	gen
16	23435430	23435769	MACS_peak_7445	661.26	339	0	1	0	gen
16	24010558	24010744	MACS_peak_7446	1098.16	186	0	1	0	gen
16	24253124	24253397	MACS_peak_7447	713.56	273	1	0	0	promoter
16	24375042	24375243	MACS_peak_7448	565.9	201	0	0	0	intergen
16	24499265	24499477	MACS_peak_7449	596.79	212	0	0	0	intergen
16	24645717	24645973	MACS_peak_7450	596.79	256	0	1	0	gen
16	24664393	24664689	MACS_peak_7451	445	296	0	1	1	gen
16	24689918	24690137	MACS_peak_7452	446.78	219	0	1	0	gen
16	24800757	24801004	MACS_peak_7453	485.56	247	0	1	0	gen
16	24891946	24892079	MACS_peak_7454	1291.76	133	0	1	0	gen
16	24906395	24906616	MACS_peak_7455	561.48	221	0	1	0	gen
16	24961411	24961615	MACS_peak_7456	268.92	204	0	1	0	gen
16	25233802	25234013	MACS_peak_7457	596.79	211	1	0	0	promoter
16	25276639	25276953	MACS_peak_7458	679.74	314	0	0	0	intergen
16	25392810	25393005	MACS_peak_7459	662.31	195	0	0	0	intergen
16	26097052	26097431	MACS_peak_7460	63.23	379	0	1	0	gen
16	26111999	26112191	MACS_peak_7461	1023.52	192	0	1	0	gen
16	26257272	26257515	MACS_peak_7462	768.02	243	0	0	0	intergen
16	26409426	26409734	MACS_peak_7463	129.48	308	0	0	0	intergen
16	27179557	27179804	MACS_peak_7464	485.56	247	0	0	0	intergen
16	27234957	27235213	MACS_peak_7465	580.75	256	0	1	0	gen
16	27605586	27605908	MACS_peak_7467	936.39	322	0	1	0	gen
16	27642660	27642800	MACS_peak_7468	1301.7	140	0	1	0	gen
16	27690667	27690945	MACS_peak_7469	442.5	278	0	1	1	gen
16	28070721	28071008	MACS_peak_7470	450.32	287	0	0	0	intergen
16	28160189	28160371	MACS_peak_7471	687.62	182	0	1	0	gen
16	28218198	28218470	MACS_peak_7472	262.15	272	0	0	0	intergen
16	28364784	28365003	MACS_peak_7473	873.1	219	0	0	1	other
16	28396625	28396866	MACS_peak_7474	471.95	241	0	1	0	gen
16	28415292	28415606	MACS_peak_7475	327.87	314	0	0	0	intergen
16	28426368	28426699	MACS_peak_7476	393.26	331	0	0	0	intergen
16	28599382	28599644	MACS_peak_7477	466.05	262	0	0	1	other
16	28612376	28612638	MACS_peak_7478	452.71	262	0	1	1	gen
16	28688312	28688643	MACS_peak_7479	424.46	331	1	0	1	promoter
16	28718438	28718764	MACS_peak_7480	356.34	326	0	1	1	gen
16	28739803	28740110	MACS_peak_7481	400.06	307	0	0	1	other
16	28750291	28750510	MACS_peak_7482	854.34	219	1	0	1	promoter
16	28852131	28852537	MACS_peak_7483	864.57	406	0	1	0	gen
16	28852593	28852928	MACS_peak_7484	664.12	335	0	1	0	gen
16	29094728	29095095	MACS_peak_7485	361.23	367	0	0	3	other
16	29115500	29115826	MACS_peak_7486	312.33	326	0	0	2	other
16	29518657	29518927	MACS_peak_7489	131.38	270	0	0	0	intergen
16	29647966	29648251	MACS_peak_7490	843.52	285	0	0	0	intergen
16	29691970	29692252	MACS_peak_7491	453.35	282	0	2	0	gen
16	29710460	29710669	MACS_peak_7492	750.34	209	0	0	0	intergen
16	29713277	29713689	MACS_peak_7493	668.82	412	0	0	0	intergen
16	29721757	29722027	MACS_peak_7494	863.32	270	0	0	0	intergen
16	29722246	29722482	MACS_peak_7495	352.92	236	0	0	0	intergen
16	29752627	29752964	MACS_peak_7496	229.83	337	0	0	0	intergen
16	29815579	29815774	MACS_peak_7497	604.07	195	5	0	1	promoter
16	29848600	29848843	MACS_peak_7498	487.14	243	0	0	0	intergen
16	29881615	29881956	MACS_peak_7499	201.59	341	0	1	0	gen
16	30032250	30032490	MACS_peak_7500	502.51	240	0	1	0	gen
16	30210401	30210729	MACS_peak_7502	285.42	328	0	0	0	intergen
16	30430171	30430434	MACS_peak_7503	412.35	263	0	1	0	gen
16	30449838	30450066	MACS_peak_7504	677.53	228	0	0	0	intergen
16	30499919	30500168	MACS_peak_7505	388.7	249	0	1	0	gen
16	30598242	30598502	MACS_peak_7506	353.78	260	1	0	1	promoter
16	30694067	30694249	MACS_peak_7507	1785.17	182	1	0	0	promoter
16	30865612	30865918	MACS_peak_7508	611.86	306	0	1	0	gen
16	30985027	30985214	MACS_peak_7509	712.32	187	2	0	1	promoter
16	31105630	31105914	MACS_peak_7510	596.03	284	1	0	0	promoter
16	31281913	31282233	MACS_peak_7511	76.3	320	0	1	0	gen
16	31299042	31299265	MACS_peak_7512	712.32	223	0	1	0	gen
16	31342179	31342539	MACS_peak_7513	54.35	360	0	0	0	intergen
16	31443068	31443380	MACS_peak_7514	1084.56	312	0	0	0	intergen
16	31465280	31465481	MACS_peak_7515	793.98	201	0	1	0	gen
16	31477932	31478178	MACS_peak_7516	629.38	246	0	0	0	intergen
16	31696931	31697298	MACS_peak_7517	486.96	367	0	0	0	intergen
16	31764671	31764997	MACS_peak_7518	114.74	326	0	1	0	gen
16	31775516	31775745	MACS_peak_7519	541.5	229	0	1	0	gen
16	31828404	31828686	MACS_peak_7520	59.4	282	0	0	0	intergen
16	31903594	31903935	MACS_peak_7522	57.93	341	0	1	0	gen
16	31904073	31904368	MACS_peak_7523	90.82	295	0	1	0	gen
16	31939641	31940002	MACS_peak_7524	60.35	361	0	0	0	intergen
16	31940106	31940481	MACS_peak_7525	54.27	375	0	0	0	intergen
16	31956337	31956564	MACS_peak_7526	511.54	227	0	0	0	intergen
16	31974320	31974563	MACS_peak_7527	342.54	243	0	0	0	intergen
16	31985349	31985590	MACS_peak_7528	426.48	241	0	0	1	other
16	31989205	31989540	MACS_peak_7529	423.72	335	0	0	1	other
16	31996393	31996630	MACS_peak_7530	502.51	237	0	0	1	other
16	32089171	32089496	MACS_peak_7531	65.11	325	0	0	0	intergen
16	32092425	32092743	MACS_peak_7532	90.08	318	0	0	0	intergen
16	32095653	32096073	MACS_peak_7533	816.38	420	0	0	0	intergen
16	32135042	32135462	MACS_peak_7534	276.18	420	0	0	1	other
16	32398028	32398328	MACS_peak_7535	665.57	300	0	0	1	other
16	32445724	32445963	MACS_peak_7536	438.69	239	0	0	0	intergen
16	32561545	32561906	MACS_peak_7537	90.07	361	0	0	0	intergen
16	32792024	32792444	MACS_peak_7539	263.89	420	0	0	0	intergen
16	32792869	32793087	MACS_peak_7540	167.41	218	0	0	0	intergen
16	32831816	32832123	MACS_peak_7541	52.36	307	0	0	0	intergen
16	32915465	32915721	MACS_peak_7542	722.05	256	0	0	0	intergen
16	32932740	32933075	MACS_peak_7543	423.72	335	0	0	1	other
16	32939922	32940159	MACS_peak_7544	662.31	237	0	0	1	other
16	32956161	32956293	MACS_peak_7545	1007.15	132	0	0	1	other
16	33009566	33009829	MACS_peak_7546	524.2	263	0	0	1	other
16	33029959	33030245	MACS_peak_7547	61.38	286	0	0	0	intergen
16	33032387	33032786	MACS_peak_7548	52.99	399	0	0	0	intergen
16	33034758	33035040	MACS_peak_7549	103.61	282	0	0	0	intergen
16	33035493	33035844	MACS_peak_7550	81.13	351	0	0	0	intergen
16	33038979	33039364	MACS_peak_7551	667.59	385	0	0	0	intergen
16	33039772	33040043	MACS_peak_7552	115.69	271	0	0	0	intergen
16	33077635	33077853	MACS_peak_7553	164.59	218	0	0	1	other
16	33078278	33078698	MACS_peak_7554	424.06	420	0	0	1	other
16	33491600	33491886	MACS_peak_7555	175.35	286	0	0	0	intergen
16	33611897	33612123	MACS_peak_7556	545.36	226	0	0	1	other
16	33654847	33655114	MACS_peak_7557	611.86	267	0	0	0	intergen
16	33656535	33656851	MACS_peak_7558	953.02	316	0	0	0	intergen
16	33717437	33717792	MACS_peak_7559	762.23	355	0	0	0	intergen
16	33897662	33897795	MACS_peak_7561	995.54	133	0	0	0	intergen
16	33913651	33913889	MACS_peak_7562	600.37	238	0	0	1	other
16	33920750	33921085	MACS_peak_7563	541.11	335	0	0	1	other
16	33938097	33938447	MACS_peak_7564	492.97	350	0	0	0	intergen
16	33953256	33953623	MACS_peak_7565	58.61	367	0	0	0	intergen
16	33957934	33958292	MACS_peak_7567	65.11	358	0	0	0	intergen
16	33961582	33962014	MACS_peak_7568	293.89	432	0	0	0	intergen
16	34066085	34066385	MACS_peak_7570	63.51	300	0	0	0	intergen
16	34067166	34067601	MACS_peak_7571	77.14	435	0	0	0	intergen
16	34070409	34070861	MACS_peak_7572	197.63	452	0	0	0	intergen
16	34074194	34074653	MACS_peak_7574	51.9	459	0	0	0	intergen
16	34075611	34075963	MACS_peak_7575	57.67	352	0	0	0	intergen
16	34078592	34079056	MACS_peak_7577	67.58	464	0	0	0	intergen
16	34079185	34079471	MACS_peak_7578	57.86	286	0	0	0	intergen
16	34084220	34084499	MACS_peak_7579	258.94	279	0	0	0	intergen
16	34086709	34087097	MACS_peak_7581	164.69	388	0	0	0	intergen
16	34088074	34088448	MACS_peak_7582	69.21	374	0	0	0	intergen
16	34097131	34097581	MACS_peak_7587	346.32	450	0	0	0	intergen
16	34100031	34100347	MACS_peak_7588	139.49	316	0	0	0	intergen
16	34106781	34107186	MACS_peak_7589	122.09	405	0	0	0	intergen
16	34131628	34131909	MACS_peak_7590	373.87	281	0	0	0	intergen
16	34190752	34191155	MACS_peak_7591	125.11	403	0	0	0	intergen
16	34200977	34201320	MACS_peak_7592	53.46	343	0	0	0	intergen
16	34202153	34202483	MACS_peak_7593	66.04	330	0	0	0	intergen
16	34214885	34215338	MACS_peak_7594	157.17	453	0	0	0	intergen
16	34947393	34947868	MACS_peak_7595	470.6	475	0	0	0	intergen
16	34949595	34949875	MACS_peak_7597	125.31	280	0	0	0	intergen
16	34954395	34954747	MACS_peak_7598	298.95	352	0	0	0	intergen
16	34959516	34959897	MACS_peak_7601	71.68	381	0	0	0	intergen
16	34960495	34960904	MACS_peak_7602	379.81	409	0	0	0	intergen
16	34998222	34998572	MACS_peak_7603	340.31	350	0	0	0	intergen
16	35079966	35080291	MACS_peak_7604	87.62	325	0	0	2	other
16	35168747	35169211	MACS_peak_7605	219.32	464	0	0	0	intergen
16	35281867	35282310	MACS_peak_7606	298.95	443	0	0	1	other
16	35472535	35472975	MACS_peak_7607	148.8	440	0	0	0	intergen
16	35545087	35545556	MACS_peak_7608	597.83	469	0	0	0	intergen
16	35547427	35547679	MACS_peak_7609	470.06	252	0	0	0	intergen
16	35613489	35613880	MACS_peak_7610	86.19	391	0	0	0	intergen
16	35698601	35698945	MACS_peak_7611	93.4	344	0	0	0	intergen
16	35829251	35829600	MACS_peak_7612	147.22	349	0	0	0	intergen
16	35874289	35874639	MACS_peak_7613	100.83	350	0	0	0	intergen
16	35978674	35978924	MACS_peak_7614	130.45	250	0	0	0	intergen
16	35986205	35986421	MACS_peak_7615	523.63	216	0	0	0	intergen
16	35989308	35989600	MACS_peak_7617	192.4	292	0	0	0	intergen
16	35995544	35995767	MACS_peak_7618	90.11	223	0	0	0	intergen
16	36001964	36002325	MACS_peak_7619	53.81	361	0	0	0	intergen
16	36009267	36009545	MACS_peak_7621	60.91	278	0	0	0	intergen
16	36021522	36021857	MACS_peak_7622	63.97	335	0	0	0	intergen
16	36028941	36029198	MACS_peak_7623	110.53	257	0	0	0	intergen
16	36031893	36032361	MACS_peak_7624	152.33	468	0	0	0	intergen
16	36046880	36047281	MACS_peak_7625	692.87	401	0	0	0	intergen
16	46409102	46409471	MACS_peak_7629	78.17	369	0	0	0	intergen
16	46415514	46415926	MACS_peak_7630	377.75	412	0	0	0	intergen
16	46420949	46421229	MACS_peak_7631	137.96	280	0	0	0	intergen
16	46432089	46432388	MACS_peak_7633	114.74	299	0	0	0	intergen
16	46446232	46446512	MACS_peak_7634	53.69	280	0	0	0	intergen
16	46459953	46460366	MACS_peak_7635	333.02	413	0	0	0	intergen
16	46460669	46460935	MACS_peak_7636	88.18	266	0	0	0	intergen
16	46465749	46466055	MACS_peak_7637	61.53	306	0	0	0	intergen
16	46537041	46537314	MACS_peak_7638	109.31	273	0	0	1	other
16	46538444	46538807	MACS_peak_7639	71.76	363	0	0	1	other
16	46556967	46557344	MACS_peak_7640	272.05	377	0	0	1	other
16	46589971	46590320	MACS_peak_7641	149.86	349	0	1	0	gen
16	46629399	46629658	MACS_peak_7642	594.37	259	0	0	0	intergen
16	46644716	46644983	MACS_peak_7643	337	267	0	0	0	intergen
16	46782529	46782758	MACS_peak_7644	870.15	229	0	1	0	gen
16	46810905	46811150	MACS_peak_7645	507.55	245	0	1	0	gen
16	46889114	46889271	MACS_peak_7646	1377.21	157	1	0	0	promoter
16	46947883	46948094	MACS_peak_7647	596.79	211	0	0	0	intergen
16	47187772	47188161	MACS_peak_7648	139.91	389	0	1	0	gen
16	47222731	47223070	MACS_peak_7649	85.26	339	0	1	0	gen
16	47325480	47325857	MACS_peak_7650	126.19	377	0	1	0	gen
16	47913432	47913900	MACS_peak_7652	102.26	468	0	0	0	intergen
16	48019991	48020181	MACS_peak_7653	98.82	190	0	0	0	intergen
16	48400522	48400878	MACS_peak_7654	178.37	356	0	1	0	gen
16	48473589	48473964	MACS_peak_7655	120.92	375	0	0	0	intergen
16	48769207	48769506	MACS_peak_7656	60.26	299	0	0	0	intergen
16	48772467	48772739	MACS_peak_7658	104.19	272	0	0	0	intergen
16	49000563	49000778	MACS_peak_7660	1264.23	215	0	0	0	intergen
16	49232111	49232397	MACS_peak_7661	142.05	286	0	0	0	intergen
16	50255997	50256229	MACS_peak_7662	678.9	232	0	1	0	gen
16	50667398	50667751	MACS_peak_7663	414.75	353	1	0	1	promoter
16	51250764	51251096	MACS_peak_7664	93.4	332	0	0	1	other
16	53054868	53055209	MACS_peak_7665	641.27	341	1	0	0	promoter
16	53278605	53278891	MACS_peak_7666	139.71	286	0	1	0	gen
16	53331913	53332314	MACS_peak_7667	165.02	401	0	0	0	intergen
16	53401075	53401468	MACS_peak_7668	96.97	393	0	0	0	intergen
16	53401819	53402141	MACS_peak_7669	80.32	322	0	0	0	intergen
16	53510490	53510844	MACS_peak_7670	414.27	354	0	0	0	intergen
16	53539939	53540300	MACS_peak_7671	158.81	361	0	0	0	intergen
16	54047602	54047959	MACS_peak_7673	141.65	357	0	1	1	gen
16	54106491	54106972	MACS_peak_7674	935.65	481	0	1	0	gen
16	54702578	54702924	MACS_peak_7675	142.05	346	0	0	0	intergen
16	54920033	54920303	MACS_peak_7676	488.85	270	0	0	1	other
16	55599999	55600406	MACS_peak_7677	111.2	407	0	0	0	intergen
16	55842934	55843152	MACS_peak_7678	729.14	218	1	0	0	promoter
16	56041871	56042064	MACS_peak_7679	678.9	193	0	0	0	intergen
16	56157499	56157921	MACS_peak_7680	87.62	422	0	0	1	other
16	56513957	56514137	MACS_peak_7681	746.04	180	0	1	0	gen
16	56533929	56534063	MACS_peak_7682	1098.16	134	0	0	0	intergen
16	56702111	56702485	MACS_peak_7683	637.63	374	0	0	0	intergen
16	56808542	56808895	MACS_peak_7684	414.75	353	0	1	0	gen
16	56826953	56827174	MACS_peak_7685	354.64	221	0	1	0	gen
16	57600338	57600720	MACS_peak_7687	632.55	382	0	0	0	intergen
16	57775515	57775816	MACS_peak_7688	563.21	301	0	1	0	gen
16	58005416	58005818	MACS_peak_7689	662.91	402	0	1	0	gen
16	58089680	58089977	MACS_peak_7690	256.17	297	0	0	0	intergen
16	58780459	58780679	MACS_peak_7691	162.72	220	0	0	1	other
16	58816306	58816441	MACS_peak_7692	852.05	135	0	0	1	other
16	58838962	58839365	MACS_peak_7693	96.97	403	0	0	1	other
16	58841717	58842008	MACS_peak_7694	161.42	291	0	0	1	other
16	59073961	59074185	MACS_peak_7695	216.44	224	0	0	1	other
16	59077453	59077807	MACS_peak_7696	109.58	354	0	0	1	other
16	59232423	59232729	MACS_peak_7697	93.4	306	0	0	0	intergen
16	59409749	59410079	MACS_peak_7698	104.73	330	0	0	0	intergen
16	59443628	59443879	MACS_peak_7699	137.65	251	0	0	0	intergen
16	59559520	59559893	MACS_peak_7700	147.82	373	0	0	0	intergen
16	59680925	59681196	MACS_peak_7702	127.14	271	0	0	0	intergen
16	59750240	59750563	MACS_peak_7703	265.34	323	0	0	1	other
16	59980287	59980729	MACS_peak_7705	93.7	442	0	0	1	other
16	59981809	59982274	MACS_peak_7706	109.53	465	0	0	1	other
16	60081541	60081909	MACS_peak_7707	128.38	368	0	0	0	intergen
16	60523698	60524013	MACS_peak_7708	50.92	315	0	0	0	intergen
16	60527679	60528156	MACS_peak_7709	108.42	477	0	0	0	intergen
16	60808288	60808426	MACS_peak_7710	1406.54	138	0	0	0	intergen
16	60878917	60879222	MACS_peak_7711	51.39	305	0	0	0	intergen
16	60938931	60939395	MACS_peak_7712	87.62	464	0	0	0	intergen
16	60940702	60941010	MACS_peak_7713	149.81	308	0	0	0	intergen
16	61784437	61784857	MACS_peak_7714	95.53	420	0	1	0	gen
16	61806983	61807370	MACS_peak_7716	76.72	387	0	1	0	gen
16	61920484	61920635	MACS_peak_7717	278.04	151	0	1	1	gen
16	62190478	62190695	MACS_peak_7718	580.62	217	0	0	0	intergen
16	63124555	63124966	MACS_peak_7719	55.74	411	0	0	1	other
16	63149822	63150186	MACS_peak_7720	62.02	364	0	0	0	intergen
16	63151159	63151554	MACS_peak_7721	74.08	395	0	0	0	intergen
16	63289848	63290207	MACS_peak_7722	341.81	359	0	0	0	intergen
16	63361109	63361367	MACS_peak_7723	595.17	258	0	0	1	other
16	63393214	63393419	MACS_peak_7724	124.69	205	0	0	1	other
16	63443829	63444212	MACS_peak_7725	65.81	383	0	0	1	other
16	63446442	63446604	MACS_peak_7726	1138.8	162	0	0	1	other
16	64165951	64166248	MACS_peak_7727	1069.92	297	0	0	0	intergen
16	64188991	64189340	MACS_peak_7728	272.05	349	0	0	0	intergen
16	65321721	65322088	MACS_peak_7729	408.1	367	0	0	2	other
16	65322104	65322390	MACS_peak_7730	702.3	286	0	0	2	other
16	65359223	65359503	MACS_peak_7732	100.11	280	0	0	2	other
16	65361819	65362132	MACS_peak_7733	50.44	313	0	0	2	other
16	65551600	65551798	MACS_peak_7734	302.9	198	0	0	1	other
16	66275979	66276242	MACS_peak_7737	465.4	263	0	0	0	intergen
16	66357510	66357858	MACS_peak_7738	912.29	348	0	0	0	intergen
16	66483806	66484033	MACS_peak_7739	1007.8	227	0	2	0	gen
16	66765756	66766089	MACS_peak_7740	210.52	333	0	1	0	gen
16	66867943	66868124	MACS_peak_7741	746.04	181	0	1	0	gen
16	67273118	67273407	MACS_peak_7742	722.05	289	1	0	0	promoter
16	67340937	67341190	MACS_peak_7743	460.03	253	0	1	0	gen
16	67510926	67511192	MACS_peak_7744	288.97	266	0	0	0	intergen
16	67521556	67521776	MACS_peak_7745	564.54	220	1	0	1	promoter
16	67816101	67816244	MACS_peak_7746	463.04	143	0	1	0	gen
16	67942060	67942340	MACS_peak_7747	454.58	280	2	0	0	promoter
16	68000973	68001245	MACS_peak_7748	459.58	272	0	1	0	gen
16	68111204	68111416	MACS_peak_7749	561.02	212	0	1	1	gen
16	68116337	68116607	MACS_peak_7750	851.59	270	0	1	1	gen
16	68800399	68800634	MACS_peak_7752	465.7	235	0	1	0	gen
16	68855906	68856105	MACS_peak_7753	831.63	199	0	1	0	gen
16	68902417	68902754	MACS_peak_7754	790.35	337	0	1	0	gen
16	69122433	69122581	MACS_peak_7755	1012.48	148	1	0	0	promoter
16	69246426	69246647	MACS_peak_7756	127.99	221	0	1	0	gen
16	69287017	69287272	MACS_peak_7757	470.06	255	0	1	0	gen
16	69309964	69310203	MACS_peak_7758	1022.22	239	1	1	0	promoter
16	69428217	69428500	MACS_peak_7759	490.8	283	1	0	0	promoter
16	69533923	69534150	MACS_peak_7760	769.45	227	0	0	0	intergen
16	69912907	69913047	MACS_peak_7761	352.36	140	0	1	0	gen
16	70165112	70165395	MACS_peak_7762	1056.06	283	0	0	1	other
16	70331606	70331826	MACS_peak_7763	1061.85	220	0	2	1	gen
16	70370140	70370312	MACS_peak_7764	1686.4	172	0	2	1	gen
16	70816548	70816820	MACS_peak_7765	651.79	272	0	1	0	gen
16	70843541	70843943	MACS_peak_7766	91.42	402	0	1	0	gen
16	70876530	70876985	MACS_peak_7767	1192.27	455	0	1	0	gen
16	70948451	70948896	MACS_peak_7768	99	445	0	1	0	gen
16	71306644	71307004	MACS_peak_7769	141.68	360	0	0	0	intergen
16	71358543	71358746	MACS_peak_7770	629.38	203	1	0	0	promoter
16	71412777	71413066	MACS_peak_7771	1255.49	289	0	0	1	other
16	71493945	71494327	MACS_peak_7772	219.32	382	0	1	0	gen
16	71514495	71514866	MACS_peak_7773	721.05	371	0	1	1	gen
16	71695740	71696084	MACS_peak_7774	380.7	344	0	1	0	gen
16	71736265	71736622	MACS_peak_7775	268.31	357	0	1	0	gen
16	71746417	71746774	MACS_peak_7776	481.76	357	0	1	0	gen
16	71882476	71882869	MACS_peak_7777	611.86	393	0	3	0	gen
16	72241874	72242126	MACS_peak_7778	1026.72	252	0	0	0	intergen
16	72342423	72342710	MACS_peak_7779	209.84	287	0	0	1	other
16	72343141	72343386	MACS_peak_7780	91.12	245	0	0	1	other
16	72400206	72400484	MACS_peak_7781	411.21	278	0	0	1	other
16	72502168	72502414	MACS_peak_7782	738.67	246	0	0	2	other
16	72525677	72525979	MACS_peak_7783	360.98	302	0	0	2	other
16	72528145	72528443	MACS_peak_7784	150.16	298	0	0	2	other
16	72529039	72529263	MACS_peak_7785	374.97	224	0	0	2	other
16	72585807	72586247	MACS_peak_7786	107.03	440	0	0	1	other
16	73054898	73055192	MACS_peak_7787	568.08	294	0	1	0	gen
16	73145494	73145836	MACS_peak_7788	420.18	342	0	1	0	gen
16	73176526	73176818	MACS_peak_7789	447.34	292	0	1	0	gen
16	73219296	73219472	MACS_peak_7790	763.02	176	0	1	0	gen
16	73672758	73673066	MACS_peak_7791	435.51	308	0	1	0	gen
16	73714135	73714479	MACS_peak_7792	1050.85	344	0	1	0	gen
16	73956648	73956988	MACS_peak_7793	488.85	340	0	0	1	other
16	74107855	74108201	MACS_peak_7794	628.36	346	0	0	1	other
16	74226674	74226964	MACS_peak_7797	570.92	290	0	0	1	other
16	74238290	74238577	MACS_peak_7798	450.32	287	0	0	1	other
16	74309826	74310150	MACS_peak_7799	385.12	324	0	0	1	other
16	74329441	74329724	MACS_peak_7800	382.11	283	0	0	1	other
16	74430118	74430386	MACS_peak_7801	722.05	268	0	0	1	other
16	74454563	74454800	MACS_peak_7802	447.77	237	0	1	0	gen
16	74650985	74651228	MACS_peak_7803	1396.21	243	0	1	0	gen
16	74706716	74706951	MACS_peak_7804	847.1	235	0	0	0	intergen
16	74813192	74813562	MACS_peak_7805	764.63	370	0	0	0	intergen
16	75233719	75234143	MACS_peak_7806	492.72	424	0	1	0	gen
16	75385640	75385962	MACS_peak_7807	513.75	322	0	1	0	gen
16	75394649	75394789	MACS_peak_7808	960	140	0	1	0	gen
16	75402921	75403209	MACS_peak_7809	447.07	288	0	1	0	gen
16	75464748	75465064	MACS_peak_7810	1399.23	316	0	1	0	gen
16	75487706	75488024	MACS_peak_7811	476.21	318	0	1	1	gen
16	75655202	75655484	MACS_peak_7812	464.3	282	0	1	0	gen
16	75723631	75723863	MACS_peak_7813	124.31	232	0	2	0	gen
16	75737614	75738023	MACS_peak_7814	71.7	409	0	1	0	gen
16	75764228	75764491	MACS_peak_7815	1372.86	263	0	0	0	intergen
16	75875258	75875653	MACS_peak_7816	69.22	395	0	0	0	intergen
16	75878699	75878958	MACS_peak_7817	263.72	259	0	0	0	intergen
16	75998662	75998818	MACS_peak_7818	901.33	156	0	0	0	intergen
16	76079129	76079440	MACS_peak_7819	50.92	311	0	0	0	intergen
16	76088581	76088908	MACS_peak_7820	54.62	327	0	0	0	intergen
16	76151775	76152172	MACS_peak_7821	623.31	397	0	0	0	intergen
16	76204864	76205280	MACS_peak_7822	612.12	416	0	0	0	intergen
16	76317245	76317423	MACS_peak_7823	763.02	178	0	1	0	gen
16	76566146	76566434	MACS_peak_7824	572.35	288	0	1	0	gen
16	76632349	76632635	MACS_peak_7826	450.92	286	0	1	0	gen
16	76651933	76652201	MACS_peak_7827	462.14	268	0	1	1	gen
16	76692217	76692589	MACS_peak_7828	178.37	372	0	1	0	gen
16	76823006	76823248	MACS_peak_7829	645.81	242	0	0	1	other
16	76854243	76854480	MACS_peak_7830	516.86	237	0	0	1	other
16	76922007	76922387	MACS_peak_7831	804.98	380	0	0	1	other
16	76952957	76953267	MACS_peak_7832	115.17	310	0	0	0	intergen
16	77115390	77115526	MACS_peak_7833	1061.85	136	0	0	0	intergen
16	77171833	77172062	MACS_peak_7834	848.95	229	0	0	0	intergen
16	77505939	77506219	MACS_peak_7835	243.49	280	0	0	0	intergen
16	77584308	77584564	MACS_peak_7836	1608.09	256	0	0	0	intergen
16	77660583	77660782	MACS_peak_7837	601.74	199	0	0	0	intergen
16	77782820	77783178	MACS_peak_7838	773.7	358	0	0	0	intergen
16	77784969	77785244	MACS_peak_7839	457.69	275	1	0	0	promoter
16	77971581	77971929	MACS_peak_7840	781.5	348	0	1	0	gen
16	78122759	78123055	MACS_peak_7842	631.47	296	0	1	0	gen
16	78135975	78136195	MACS_peak_7843	629.32	220	0	1	0	gen
16	78151942	78152185	MACS_peak_7844	326.32	243	0	1	0	gen
16	78235257	78235525	MACS_peak_7845	587.27	268	0	1	0	gen
16	78437359	78437702	MACS_peak_7846	1190.35	343	0	1	0	gen
16	78478497	78478732	MACS_peak_7847	516.86	235	0	1	0	gen
16	78770611	78770894	MACS_peak_7848	838.58	283	0	1	0	gen
16	78925153	78925319	MACS_peak_7849	1043.77	166	0	1	0	gen
16	79261577	79261801	MACS_peak_7850	712.32	224	0	0	0	intergen
16	79413128	79413458	MACS_peak_7851	314.21	330	0	0	0	intergen
16	79602224	79602555	MACS_peak_7852	490.28	331	0	0	0	intergen
16	80088147	80088493	MACS_peak_7853	57.86	346	0	0	1	other
16	80089505	80089964	MACS_peak_7854	109.93	459	0	0	1	other
16	80221788	80222082	MACS_peak_7855	96.87	294	0	0	1	other
16	80317796	80318079	MACS_peak_7856	452.74	283	0	0	1	other
16	80405845	80406096	MACS_peak_7857	613.04	251	0	0	1	other
16	80526534	80526813	MACS_peak_7858	821.16	279	0	0	1	other
16	80644927	80645295	MACS_peak_7859	81.45	368	0	1	0	gen
16	80728630	80728960	MACS_peak_7860	51.92	330	0	1	0	gen
16	80974665	80974837	MACS_peak_7861	983.72	172	0	1	0	gen
16	81035585	81035860	MACS_peak_7862	711.8	275	1	1	0	promoter
16	81086060	81086312	MACS_peak_7863	369.08	252	1	2	0	promoter
16	81205079	81205372	MACS_peak_7864	568.79	293	0	0	1	other
16	81214801	81215064	MACS_peak_7865	591.18	263	0	0	1	other
16	81350379	81350621	MACS_peak_7866	890.09	242	0	1	0	gen
16	81366328	81366612	MACS_peak_7867	438.82	284	0	1	0	gen
16	81429001	81429195	MACS_peak_7868	678.9	194	0	0	0	intergen
16	81598184	81598525	MACS_peak_7869	420.68	341	0	1	0	gen
16	81697211	81697539	MACS_peak_7870	380.3	328	0	1	0	gen
16	81873945	81874194	MACS_peak_7871	572.72	249	0	1	0	gen
16	81890254	81890695	MACS_peak_7872	598.16	441	0	1	0	gen
16	81940909	81941218	MACS_peak_7873	437.6	309	0	1	0	gen
16	81977430	81977886	MACS_peak_7874	175.19	456	0	0	0	intergen
16	81980646	81981037	MACS_peak_7875	50.1	391	0	0	0	intergen
16	81981898	81982164	MACS_peak_7876	213.91	266	0	0	0	intergen
16	81997131	81997519	MACS_peak_7877	510.89	388	0	1	0	gen
16	82006178	82006506	MACS_peak_7878	383.03	328	0	1	0	gen
16	82143555	82143875	MACS_peak_7879	101.76	320	1	0	0	promoter
16	82205169	82205497	MACS_peak_7881	58.05	328	0	0	0	intergen
16	82205588	82206049	MACS_peak_7882	103.63	461	0	0	0	intergen
16	82230090	82230359	MACS_peak_7883	831.25	269	0	0	0	intergen
16	82263600	82263886	MACS_peak_7884	814.31	286	0	0	0	intergen
16	82322845	82323111	MACS_peak_7886	450.1	266	0	0	0	intergen
16	82448441	82448709	MACS_peak_7887	699.35	268	0	0	0	intergen
16	83167250	83167536	MACS_peak_7888	870.57	286	0	1	0	gen
16	83356207	83356551	MACS_peak_7889	915.87	344	0	1	0	gen
16	83446834	83447125	MACS_peak_7890	1252.87	291	0	1	0	gen
16	83638308	83638775	MACS_peak_7892	56.82	467	0	1	0	gen
16	83642703	83643060	MACS_peak_7893	61.53	357	0	1	0	gen
16	83683240	83683484	MACS_peak_7894	780.06	244	0	1	0	gen
16	83887185	83887458	MACS_peak_7895	458.95	273	0	0	0	intergen
16	83953941	83954330	MACS_peak_7896	750.87	389	0	1	0	gen
16	84156680	84156877	MACS_peak_7897	927.92	197	0	1	0	gen
16	84186925	84187222	MACS_peak_7898	825.22	297	1	0	0	promoter
16	84211121	84211379	MACS_peak_7899	468.72	258	0	0	0	intergen
16	84277293	84277601	MACS_peak_7900	1231.26	308	0	0	0	intergen
16	84456026	84456366	MACS_peak_7901	93.7	340	0	1	0	gen
16	84458073	84458275	MACS_peak_7902	322.11	202	0	1	0	gen
16	84511453	84511624	MACS_peak_7903	1007.8	171	0	1	0	gen
16	84672365	84672579	MACS_peak_7904	1264.23	214	0	0	0	intergen
16	84726071	84726315	MACS_peak_7905	596.07	244	0	1	0	gen
16	84738513	84738992	MACS_peak_7906	422.76	479	0	1	0	gen
16	84746858	84747117	MACS_peak_7907	1448.62	259	0	1	0	gen
16	84754456	84754655	MACS_peak_7908	645.81	199	0	1	0	gen
16	84848940	84849120	MACS_peak_7909	746.04	180	0	1	1	gen
16	85253254	85253552	MACS_peak_7910	565.28	298	0	1	0	gen
16	85275725	85276047	MACS_peak_7911	549.27	322	0	1	0	gen
16	85409308	85409671	MACS_peak_7912	339.96	363	0	1	0	gen
16	85420776	85421084	MACS_peak_7913	815.17	308	0	1	0	gen
16	85610566	85610909	MACS_peak_7914	658.44	343	0	1	0	gen
16	85759886	85760214	MACS_peak_7915	755.36	328	0	0	0	intergen
16	85901922	85902055	MACS_peak_7917	1291.76	133	1	0	0	promoter
16	86007749	86007991	MACS_peak_7918	518.84	242	0	0	0	intergen
16	86072950	86073232	MACS_peak_7919	1372.86	282	0	0	0	intergen
16	86098052	86098313	MACS_peak_7920	1599.36	261	0	0	0	intergen
16	86145455	86145716	MACS_peak_7922	860.98	261	0	0	0	intergen
16	86265059	86265411	MACS_peak_7924	65.32	352	0	0	1	other
16	86563655	86564107	MACS_peak_7926	1352.74	452	1	0	0	promoter
16	86678888	86679363	MACS_peak_7927	112.76	475	0	0	0	intergen
16	86761222	86761532	MACS_peak_7928	682.83	310	0	0	0	intergen
16	86874184	86874403	MACS_peak_7929	580.62	219	0	0	0	intergen
16	87077388	87077674	MACS_peak_7930	450.92	286	0	0	0	intergen
16	87203102	87203465	MACS_peak_7931	409.98	363	0	1	0	gen
16	87316899	87317076	MACS_peak_7932	763.02	177	0	2	0	gen
16	87394543	87394845	MACS_peak_7933	562.53	302	0	1	0	gen
16	87420686	87420941	MACS_peak_7934	470.06	255	0	1	0	gen
16	87550452	87550635	MACS_peak_7935	729.14	183	0	0	0	intergen
16	87653333	87653719	MACS_peak_7936	1011.16	386	0	1	0	gen
16	87769241	87769516	MACS_peak_7937	1066.87	275	0	0	0	intergen
16	87777401	87777734	MACS_peak_7938	265.34	333	0	0	1	other
16	87777934	87778198	MACS_peak_7939	913.39	264	0	0	1	other
16	87779120	87779393	MACS_peak_7940	423.1	273	0	0	0	intergen
16	87798446	87798921	MACS_peak_7941	939.94	475	0	0	1	other
16	87849986	87850258	MACS_peak_7942	459.58	272	0	1	0	gen
16	87860327	87860521	MACS_peak_7943	632.58	194	0	1	0	gen
16	87871637	87871909	MACS_peak_7944	777.87	272	0	0	0	intergen
16	88194141	88194432	MACS_peak_7945	570.2	291	0	0	0	intergen
16	88559126	88559408	MACS_peak_7946	523.12	282	0	0	0	intergen
16	88743902	88744071	MACS_peak_7947	1025.76	169	0	1	1	gen
16	88748034	88748245	MACS_peak_7948	1301.7	211	0	1	0	gen
16	88816069	88816247	MACS_peak_7949	763.02	178	1	0	0	promoter
16	89106290	89106527	MACS_peak_7950	406.23	237	0	1	0	gen
16	89186573	89186862	MACS_peak_7951	449.12	289	0	1	0	gen
16	89333858	89334184	MACS_peak_7952	312.33	326	0	1	0	gen
16	89557414	89557754	MACS_peak_7953	421.18	340	1	1	0	promoter
16	89565528	89565911	MACS_peak_7954	400.82	383	0	0	0	intergen
16	89641318	89641544	MACS_peak_7955	548.55	226	1	0	0	promoter
16	89752636	89752869	MACS_peak_7956	387.94	233	0	1	0	gen
16	89793098	89793535	MACS_peak_7957	606.62	437	0	1	0	gen
16	89860871	89861114	MACS_peak_7958	780.06	243	0	1	0	gen
16	89945675	89945931	MACS_peak_7959	406.81	256	1	0	0	promoter
16	90019514	90019817	MACS_peak_7960	561.84	303	1	1	0	promoter
16	90081854	90082130	MACS_peak_7961	569.35	276	0	1	0	gen
16	90106295	90106531	MACS_peak_7962	430.2	236	0	0	1	other
16	90112331	90112652	MACS_peak_7963	264.57	321	0	0	2	other
16	90162020	90162253	MACS_peak_7965	501.51	233	0	0	2	other
16	90165439	90165672	MACS_peak_7966	602.06	233	0	0	2	other
16	90166523	90166914	MACS_peak_7967	370.2	391	0	0	2	other
16	90201210	90201577	MACS_peak_7968	201.59	367	0	0	1	other
16	90201826	90202145	MACS_peak_7969	565.3	319	0	0	1	other
17	272219	272599	MACS_peak_7971	96.97	380	0	1	0	gen
17	412285	412579	MACS_peak_7972	446.16	294	1	0	1	promoter
17	592343	592651	MACS_peak_7974	77.98	308	0	1	0	gen
17	599398	599752	MACS_peak_7975	84.4	354	0	1	0	gen
17	636867	637262	MACS_peak_7976	57.86	395	0	1	0	gen
17	649094	649550	MACS_peak_7977	590.18	456	0	1	0	gen
17	700580	700885	MACS_peak_7978	439.84	305	0	1	0	gen
17	931769	932095	MACS_peak_7979	201.59	326	0	1	0	gen
17	1310417	1310729	MACS_peak_7981	195.62	312	0	0	0	intergen
17	1311186	1311557	MACS_peak_7982	185.39	371	0	0	0	intergen
17	1354960	1355274	MACS_peak_7983	710.55	314	0	1	0	gen
17	1365475	1365721	MACS_peak_7984	763.02	246	0	1	0	gen
17	1720840	1721061	MACS_peak_7985	729.14	221	1	0	0	promoter
17	3148715	3148999	MACS_peak_7986	92.05	284	0	0	1	other
17	3178780	3179084	MACS_peak_7987	193.28	304	0	0	0	intergen
17	3273533	3273830	MACS_peak_7988	73.76	297	1	0	0	promoter
17	3330574	3330927	MACS_peak_7989	60.54	353	0	1	0	gen
17	3347984	3348328	MACS_peak_7990	124.49	344	0	1	0	gen
17	3456196	3456414	MACS_peak_7991	133.76	218	0	1	0	gen
17	3456678	3457059	MACS_peak_7992	56.91	381	0	1	0	gen
17	3647880	3648089	MACS_peak_7993	780.06	209	0	1	0	gen
17	3788623	3788858	MACS_peak_7994	213.21	235	0	1	0	gen
17	4304533	4304821	MACS_peak_7995	890.5	288	0	1	0	gen
17	4404606	4404892	MACS_peak_7996	523.68	286	0	0	0	intergen
17	4565531	4565792	MACS_peak_7997	592.77	261	0	0	0	intergen
17	4654837	4655216	MACS_peak_7998	358.59	379	0	0	0	intergen
17	4889092	4889312	MACS_peak_7999	394.77	220	0	1	0	gen
17	5439114	5439467	MACS_peak_8000	1179.44	353	1	1	0	promoter
17	5841335	5841692	MACS_peak_8001	648.81	357	0	1	1	gen
17	5850773	5851108	MACS_peak_8002	55.86	335	0	1	1	gen
17	5851406	5851781	MACS_peak_8003	174.08	375	0	1	1	gen
17	6279822	6280076	MACS_peak_8004	597.36	254	0	0	0	intergen
17	6293463	6293596	MACS_peak_8005	1098.16	133	0	0	0	intergen
17	6805584	6806064	MACS_peak_8006	63.03	480	0	1	0	gen
17	6843295	6843553	MACS_peak_8007	603.02	258	0	0	0	intergen
17	6943828	6944137	MACS_peak_8008	103.45	309	0	0	2	other
17	7004207	7004543	MACS_peak_8009	663.41	336	0	1	2	gen
17	7004837	7005079	MACS_peak_8010	645.81	242	0	1	2	gen
17	7126336	7126585	MACS_peak_8011	413.37	249	0	0	0	intergen
17	7743535	7743937	MACS_peak_8012	908.25	402	0	1	0	gen
17	7749204	7749435	MACS_peak_8013	2221.29	231	0	1	0	gen
17	7913000	7913231	MACS_peak_8014	1491.86	231	1	0	0	promoter
17	7972494	7972666	MACS_peak_8015	1453.47	172	0	0	0	intergen
17	8073721	8073877	MACS_peak_8016	901.33	156	1	0	0	promoter
17	8138641	8138815	MACS_peak_8017	780.06	174	1	0	0	promoter
17	8157352	8157727	MACS_peak_8018	404.42	375	1	1	0	promoter
17	8383211	8383587	MACS_peak_8019	403.97	376	0	0	0	intergen
17	8693984	8694194	MACS_peak_8020	613.04	210	0	0	0	intergen
17	8791373	8791585	MACS_peak_8021	758.25	212	0	0	0	intergen
17	8991493	8991863	MACS_peak_8022	404.09	370	0	0	0	intergen
17	8998088	8998393	MACS_peak_8023	439.84	305	0	0	0	intergen
17	9554890	9555065	MACS_peak_8025	1760.85	175	0	1	1	gen
17	9559581	9559819	MACS_peak_8026	375.48	238	0	1	0	gen
17	9676204	9676471	MACS_peak_8027	462.79	267	0	1	0	gen
17	9681055	9681441	MACS_peak_8028	511.95	386	0	1	0	gen
17	9729027	9729319	MACS_peak_8029	829.92	292	0	1	0	gen
17	9745001	9745210	MACS_peak_8030	397.9	209	0	0	0	intergen
17	9761046	9761311	MACS_peak_8031	464.09	265	0	0	0	intergen
17	9905961	9906261	MACS_peak_8032	429.4	300	1	0	0	promoter
17	9965675	9965882	MACS_peak_8033	558.17	207	0	1	0	gen
17	10295741	10295959	MACS_peak_8034	580.62	218	0	0	1	other
17	10616605	10616906	MACS_peak_8035	829.25	301	0	0	2	other
17	10683906	10684162	MACS_peak_8036	470.06	256	0	1	0	gen
17	10995979	10996261	MACS_peak_8038	312.33	282	0	0	0	intergen
17	11144731	11144917	MACS_peak_8039	712.32	186	0	0	0	intergen
17	11698116	11698377	MACS_peak_8040	466.72	261	0	1	0	gen
17	11711854	11712227	MACS_peak_8041	518.99	373	0	1	0	gen
17	11778318	11778463	MACS_peak_8042	863.14	145	0	1	0	gen
17	11935879	11936192	MACS_peak_8043	555.13	313	0	1	0	gen
17	12103033	12103222	MACS_peak_8044	883.81	189	0	1	0	gen
17	12256466	12256660	MACS_peak_8045	678.9	194	0	0	0	intergen
17	12453181	12453620	MACS_peak_8048	71.93	439	0	0	0	intergen
17	13114508	13114824	MACS_peak_8051	433.75	316	0	0	0	intergen
17	13129849	13130139	MACS_peak_8052	570.92	290	0	0	0	intergen
17	13414314	13414560	MACS_peak_8053	471.88	246	0	0	0	intergen
17	13625956	13626088	MACS_peak_8054	977.06	132	0	0	0	intergen
17	13812263	13812457	MACS_peak_8055	819.6	194	0	0	1	other
17	14203493	14203676	MACS_peak_8056	729.14	183	0	1	0	gen
17	14688232	14688421	MACS_peak_8057	695.57	189	0	0	0	intergen
17	15156123	15156384	MACS_peak_8058	466.72	261	0	0	0	intergen
17	15248193	15248485	MACS_peak_8059	447.34	292	0	1	0	gen
17	15358932	15359400	MACS_peak_8060	122.63	468	0	0	0	intergen
17	15502893	15503114	MACS_peak_8061	729.14	221	1	2	0	promoter
17	15689745	15690066	MACS_peak_8063	229.83	321	0	0	0	intergen
17	15826602	15826918	MACS_peak_8064	619.83	316	0	0	0	intergen
17	16584208	16584481	MACS_peak_8065	713.56	273	0	0	0	intergen
17	16589348	16589637	MACS_peak_8066	449.12	289	0	0	0	intergen
17	16591134	16591312	MACS_peak_8067	831.12	178	0	0	0	intergen
17	16689925	16690236	MACS_peak_8068	1587.42	311	2	0	0	promoter
17	17001802	17002047	MACS_peak_8069	501.16	245	0	0	0	intergen
17	17356139	17356418	MACS_peak_8070	980.98	279	0	0	0	intergen
17	17388133	17388435	MACS_peak_8071	441.54	302	0	0	0	intergen
17	17619231	17619374	MACS_peak_8072	472.3	143	0	0	0	intergen
17	17641876	17642106	MACS_peak_8073	532.66	230	0	0	0	intergen
17	18094013	18094276	MACS_peak_8074	722.6	263	0	1	0	gen
17	18563579	18563889	MACS_peak_8075	437.04	310	0	0	1	other
17	18625596	18626052	MACS_peak_8076	1861.17	456	0	0	0	intergen
17	18689934	18690188	MACS_peak_8077	135.93	254	0	0	0	intergen
17	18816782	18817098	MACS_peak_8078	1815.75	316	0	0	0	intergen
17	19032413	19032665	MACS_peak_8079	883.81	252	0	1	1	gen
17	19052314	19052622	MACS_peak_8080	1355.06	308	0	0	0	intergen
17	19070307	19070647	MACS_peak_8081	551.63	340	0	0	0	intergen
17	19076216	19076582	MACS_peak_8082	367.32	366	0	0	0	intergen
17	19121919	19122309	MACS_peak_8083	1325.64	390	0	0	0	intergen
17	19141880	19142132	MACS_peak_8084	883.81	252	0	1	1	gen
17	19175522	19175854	MACS_peak_8085	352.55	332	0	0	0	intergen
17	19181552	19181892	MACS_peak_8086	524.15	340	0	0	0	intergen
17	19196368	19196708	MACS_peak_8087	645.18	340	0	0	0	intergen
17	19202273	19202639	MACS_peak_8088	345.92	366	0	0	0	intergen
17	19766509	19766796	MACS_peak_8089	450.32	287	1	0	0	promoter
17	20092192	20092324	MACS_peak_8090	1116.4	132	0	1	0	gen
17	20164056	20164190	MACS_peak_8091	1666.76	134	0	1	0	gen
17	20295707	20296059	MACS_peak_8092	134.47	352	0	1	1	gen
17	20320871	20321127	MACS_peak_8093	1007.8	256	0	0	1	other
17	20381769	20382161	MACS_peak_8094	508.79	392	0	0	1	other
17	20644495	20644792	MACS_peak_8095	630.66	297	0	0	0	intergen
17	20759460	20759809	MACS_peak_8096	245.18	349	0	0	0	intergen
17	20848979	20849170	MACS_peak_8097	866.35	191	0	1	0	gen
17	20892940	20893229	MACS_peak_8098	437.33	289	0	1	1	gen
17	20992988	20993306	MACS_peak_8099	1102.85	318	0	0	1	other
17	21020233	21020435	MACS_peak_8100	2606.56	202	0	1	0	gen
17	21043664	21043917	MACS_peak_8101	470.06	253	0	0	0	intergen
17	21108104	21108343	MACS_peak_8102	368.72	239	0	0	0	intergen
17	21129112	21129459	MACS_peak_8103	404.48	347	0	1	0	gen
17	21442594	21442736	MACS_peak_8104	684.56	142	0	1	0	gen
17	21449958	21450297	MACS_peak_8105	607.32	339	0	1	0	gen
17	22059647	22059798	MACS_peak_8106	477.58	151	0	0	0	intergen
17	22324035	22324263	MACS_peak_8107	296.39	228	0	0	0	intergen
17	22533760	22534039	MACS_peak_8108	312.33	279	0	0	0	intergen
17	22548936	22549375	MACS_peak_8109	425.58	439	0	0	0	intergen
17	26943758	26944163	MACS_peak_8114	51.05	405	0	0	0	intergen
17	26979936	26980343	MACS_peak_8115	203.1	407	0	0	0	intergen
17	27011037	27011375	MACS_peak_8116	79.97	338	0	0	0	intergen
17	27034698	27035067	MACS_peak_8117	152.59	369	0	0	1	other
17	27040090	27040412	MACS_peak_8118	117.06	322	0	0	1	other
17	27042558	27042891	MACS_peak_8119	57.86	333	0	0	1	other
17	27129187	27129499	MACS_peak_8120	76.3	312	0	0	1	other
17	27146516	27146802	MACS_peak_8121	63.18	286	0	0	1	other
17	27160851	27161200	MACS_peak_8122	94.23	349	0	0	1	other
17	27191045	27191275	MACS_peak_8123	335.79	230	0	0	0	intergen
17	27197479	27197770	MACS_peak_8124	678.21	291	0	0	0	intergen
17	27353765	27354019	MACS_peak_8125	729.14	254	0	0	0	intergen
17	27427888	27428159	MACS_peak_8126	158.61	271	0	0	1	other
17	27577043	27577175	MACS_peak_8127	1116.4	132	0	1	0	gen
17	27599897	27600194	MACS_peak_8128	695.17	297	0	1	0	gen
17	27601746	27602034	MACS_peak_8129	572.35	288	0	1	0	gen
17	27603237	27603472	MACS_peak_8130	662.31	235	0	1	0	gen
17	27753201	27753448	MACS_peak_8131	485.56	247	1	0	1	promoter
17	27900848	27901173	MACS_peak_8132	140.51	325	0	0	0	intergen
17	27901273	27901561	MACS_peak_8133	121.32	288	0	0	0	intergen
17	27955487	27955864	MACS_peak_8134	432.56	377	0	0	1	other
17	28233288	28233574	MACS_peak_8135	835.66	286	0	0	1	other
17	28250757	28250923	MACS_peak_8136	721.03	166	0	0	0	intergen
17	28302434	28302576	MACS_peak_8137	1511.8	142	0	0	1	other
17	28548200	28548401	MACS_peak_8138	645.81	201	1	1	0	promoter
17	28719542	28719929	MACS_peak_8139	511.42	387	2	0	0	promoter
17	28726876	28727098	MACS_peak_8140	564.54	222	2	0	0	promoter
17	28750117	28750341	MACS_peak_8141	564.54	224	0	1	0	gen
17	28903062	28903351	MACS_peak_8142	449.12	289	1	0	0	promoter
17	28916395	28916679	MACS_peak_8143	442.3	284	0	1	0	gen
17	29198958	29199184	MACS_peak_8144	423.66	226	0	0	0	intergen
17	29219441	29219753	MACS_peak_8145	681.28	312	0	0	0	intergen
17	29252195	29252630	MACS_peak_8146	601.44	435	1	1	0	promoter
17	29274779	29275007	MACS_peak_8147	848.95	228	0	1	0	gen
17	29899087	29899559	MACS_peak_8148	62.95	472	0	1	0	gen
17	30011881	30012184	MACS_peak_8149	803.03	303	0	1	0	gen
17	30023122	30023449	MACS_peak_8150	89.02	327	0	1	0	gen
17	30359246	30359634	MACS_peak_8151	1143.6	388	0	0	0	intergen
17	30644561	30644710	MACS_peak_8152	1208.41	149	0	0	1	other
17	31949569	31949783	MACS_peak_8153	1007.79	214	0	1	0	gen
17	32060570	32060719	MACS_peak_8154	954.29	149	0	0	0	intergen
17	32135657	32135891	MACS_peak_8155	1039.87	234	0	0	0	intergen
17	32641096	32641440	MACS_peak_8156	103.03	344	0	1	1	gen
17	32642124	32642483	MACS_peak_8157	60.94	359	0	1	1	gen
17	32681470	32681931	MACS_peak_8158	61.67	461	0	1	1	gen
17	32683387	32683722	MACS_peak_8159	96	335	0	1	1	gen
17	32891242	32891649	MACS_peak_8160	101.68	407	0	0	0	intergen
17	33751184	33751435	MACS_peak_8161	1043.77	251	0	1	0	gen
17	33932609	33932747	MACS_peak_8162	682.8	138	0	1	1	gen
17	34197429	34197672	MACS_peak_8163	501.16	243	0	0	0	intergen
17	35200242	35200563	MACS_peak_8164	69	321	0	0	0	intergen
17	35311558	35311916	MACS_peak_8165	395.79	358	0	0	0	intergen
17	35398576	35399000	MACS_peak_8166	128.99	424	0	0	0	intergen
17	35461470	35461755	MACS_peak_8167	574.52	285	1	0	0	promoter
17	35947154	35947356	MACS_peak_8168	966.16	202	0	0	0	intergen
17	36165924	36166301	MACS_peak_8169	623.32	377	1	0	1	promoter
17	36229689	36229999	MACS_peak_8170	2156.68	310	0	0	0	intergen
17	36253848	36254260	MACS_peak_8171	1248.79	412	1	0	0	promoter
17	36377740	36378152	MACS_peak_8173	1267.71	412	1	0	0	promoter
17	37373534	37373857	MACS_peak_8175	548.63	323	1	1	0	promoter
17	37934749	37935161	MACS_peak_8176	765.67	412	0	1	0	gen
17	37954176	37954532	MACS_peak_8177	2000.66	356	0	0	0	intergen
17	37978364	37978776	MACS_peak_8178	695.47	412	1	0	0	promoter
17	38225925	38226161	MACS_peak_8179	478.23	236	0	0	1	other
17	38288367	38288585	MACS_peak_8180	742.08	218	0	0	0	intergen
17	38983179	38983507	MACS_peak_8182	1815.39	328	0	0	0	intergen
17	39207024	39207253	MACS_peak_8183	848.95	229	1	0	0	promoter
17	39271012	39271270	MACS_peak_8184	458.45	258	0	1	0	gen
17	39485058	39485430	MACS_peak_8185	614.03	372	0	1	0	gen
17	40377745	40377894	MACS_peak_8186	1222.2	149	0	0	0	intergen
17	40533372	40533559	MACS_peak_8187	1246.66	187	0	0	0	intergen
17	40645829	40646050	MACS_peak_8188	513.05	221	0	2	0	gen
17	40791849	40792307	MACS_peak_8189	706.14	458	1	0	0	promoter
17	40803585	40803857	MACS_peak_8190	459.58	272	0	0	0	intergen
17	41051044	41051397	MACS_peak_8191	414.75	353	2	0	0	promoter
17	41244669	41245084	MACS_peak_8192	141.26	415	0	0	0	intergen
17	41456303	41456542	MACS_peak_8194	502.51	239	1	0	0	promoter
17	41496793	41496992	MACS_peak_8195	831.63	199	1	0	0	promoter
17	41662723	41662958	MACS_peak_8196	516.86	235	0	0	0	intergen
17	41695933	41696271	MACS_peak_8197	422.19	338	0	0	0	intergen
17	41738098	41738303	MACS_peak_8198	629.38	205	0	0	0	intergen
17	41801659	41801867	MACS_peak_8199	1108.27	208	1	0	0	promoter
17	41985418	41985550	MACS_peak_8200	1116.4	132	0	1	0	gen
17	42144922	42145150	MACS_peak_8201	519.64	228	0	2	0	gen
17	42322818	42323081	MACS_peak_8202	837.49	263	0	1	0	gen
17	42413466	42413610	MACS_peak_8203	612.57	144	0	1	0	gen
17	42540589	42540829	MACS_peak_8204	960.62	240	1	0	1	promoter
17	42721082	42721265	MACS_peak_8205	666.39	183	0	1	0	gen
17	43222929	43223267	MACS_peak_8206	522.76	338	0	1	0	gen
17	43350169	43350482	MACS_peak_8207	260.52	313	0	0	0	intergen
17	43393936	43394222	MACS_peak_8208	702.3	286	0	0	0	intergen
17	43483568	43483891	MACS_peak_8209	488.85	323	1	0	0	promoter
17	43576719	43576944	MACS_peak_8210	548.55	225	0	2	0	gen
17	43766451	43766759	MACS_peak_8211	1089.02	308	1	0	0	promoter
17	43887048	43887180	MACS_peak_8212	1116.4	132	0	1	0	gen
17	43937567	43937882	MACS_peak_8213	380.3	315	1	0	0	promoter
17	44239218	44239545	MACS_peak_8214	155.69	327	0	0	0	intergen
17	44727758	44727899	MACS_peak_8215	1569.18	141	0	1	0	gen
17	45135317	45135562	MACS_peak_8216	501.16	245	1	0	0	promoter
17	45738447	45738812	MACS_peak_8217	523.45	365	0	1	0	gen
17	45852785	45853145	MACS_peak_8218	646.8	360	0	0	1	other
17	46002563	46002781	MACS_peak_8220	580.62	218	1	1	0	promoter
17	46237538	46237904	MACS_peak_8221	114.74	366	0	0	0	intergen
17	46286708	46287045	MACS_peak_8222	359.79	337	0	1	0	gen
17	46641935	46642167	MACS_peak_8223	532.66	232	0	1	0	gen
17	46642378	46642591	MACS_peak_8224	596.79	213	0	1	0	gen
17	46835926	46836212	MACS_peak_8225	1081.1	286	1	0	0	promoter
17	47001232	47001552	MACS_peak_8226	1075.82	320	0	1	2	gen
17	47315626	47316029	MACS_peak_8227	406.81	403	0	1	1	gen
17	47323231	47323485	MACS_peak_8228	1025.76	254	1	1	1	promoter
17	47359612	47359968	MACS_peak_8229	56.38	356	0	1	0	gen
17	47487013	47487244	MACS_peak_8230	446.06	231	0	0	1	other
17	47500632	47500941	MACS_peak_8231	998.42	309	0	0	0	intergen
17	47562310	47562635	MACS_peak_8232	488.85	325	0	1	0	gen
17	47698866	47699182	MACS_peak_8233	694.51	316	0	0	0	intergen
17	47761507	47761668	MACS_peak_8234	512.62	161	0	0	0	intergen
17	47830898	47831256	MACS_peak_8235	648.14	358	1	1	0	promoter
17	47841270	47841467	MACS_peak_8236	662.31	197	2	0	0	promoter
17	47843056	47843450	MACS_peak_8237	625.13	394	1	0	0	promoter
17	47946919	47947190	MACS_peak_8238	1102.85	271	0	1	2	gen
17	48005776	48005938	MACS_peak_8239	944.23	162	0	0	0	intergen
17	48011263	48011624	MACS_peak_8240	755.72	361	0	0	0	intergen
17	48018407	48018822	MACS_peak_8241	1590.78	415	0	0	0	intergen
17	48036859	48037192	MACS_peak_8242	542.34	333	0	1	0	gen
17	48074322	48074646	MACS_peak_8243	399.92	324	1	0	0	promoter
17	48080300	48080516	MACS_peak_8244	683.05	216	0	1	0	gen
17	48097639	48097838	MACS_peak_8245	624.41	199	0	1	0	gen
17	48131351	48131560	MACS_peak_8246	876.89	209	1	0	0	promoter
17	48153712	48154064	MACS_peak_8247	2153.35	352	0	1	0	gen
17	48259750	48260086	MACS_peak_8248	764.45	336	0	1	0	gen
17	48262904	48263369	MACS_peak_8249	1489.77	465	0	1	0	gen
17	48307873	48308194	MACS_peak_8250	611.86	321	0	1	1	gen
17	48351908	48352205	MACS_peak_8251	380.3	297	0	1	0	gen
17	48374668	48374962	MACS_peak_8252	446.16	294	0	1	0	gen
17	48457271	48457578	MACS_peak_8253	547.35	307	0	0	0	intergen
17	48492466	48492760	MACS_peak_8254	691.92	294	0	0	0	intergen
17	48585393	48585666	MACS_peak_8255	458.95	273	0	1	1	gen
17	48593822	48594303	MACS_peak_8256	577.46	481	2	1	1	promoter
17	48636391	48636765	MACS_peak_8257	404.88	374	0	0	1	other
17	48671654	48672003	MACS_peak_8258	496.15	349	0	0	1	other
17	48678388	48678682	MACS_peak_8259	568.08	294	0	0	1	other
17	48791097	48791322	MACS_peak_8260	866.35	225	0	1	0	gen
17	48814381	48814656	MACS_peak_8261	424.27	275	0	1	0	gen
17	48878268	48878564	MACS_peak_8262	380.3	296	0	0	1	other
17	48879048	48879426	MACS_peak_8263	754.53	378	0	0	1	other
17	48940060	48940206	MACS_peak_8265	387.38	146	0	1	0	gen
17	49036140	49036469	MACS_peak_8267	647.23	329	0	1	0	gen
17	49180263	49180606	MACS_peak_8268	1039.3	343	0	0	0	intergen
17	49219684	49219867	MACS_peak_8269	918.92	183	1	1	0	promoter
17	49227529	49227773	MACS_peak_8270	780.06	244	1	0	0	promoter
17	49290783	49291083	MACS_peak_8271	1175.7	300	1	0	0	promoter
17	49315432	49315840	MACS_peak_8272	643.45	408	0	1	0	gen
17	49395036	49395421	MACS_peak_8273	880.99	385	0	0	1	other
17	49407907	49408348	MACS_peak_8274	1095.16	441	1	0	1	promoter
17	49435127	49435334	MACS_peak_8275	949.7	207	0	0	1	other
17	49548557	49548841	MACS_peak_8276	575.25	284	0	0	2	other
17	49570016	49570328	MACS_peak_8278	811.61	312	0	0	2	other
17	49695536	49695841	MACS_peak_8279	953.25	305	0	0	0	intergen
17	49708311	49708693	MACS_peak_8280	1149.5	382	1	1	0	promoter
17	49729394	49729530	MACS_peak_8281	1611.68	136	0	1	0	gen
17	49779816	49780032	MACS_peak_8282	900.67	216	0	1	0	gen
17	50079717	50079925	MACS_peak_8283	594.99	208	0	1	0	gen
17	50085977	50086359	MACS_peak_8284	547.82	382	0	1	0	gen
17	50139965	50140204	MACS_peak_8285	797.18	239	0	1	1	gen
17	50198298	50198692	MACS_peak_8286	1137.79	394	0	1	0	gen
17	50200448	50200776	MACS_peak_8287	427.34	328	0	1	0	gen
17	50398478	50398672	MACS_peak_8288	652.22	194	0	0	0	intergen
17	50482490	50482891	MACS_peak_8289	522.55	401	1	0	0	promoter
17	50501084	50501338	MACS_peak_8290	470.06	254	0	0	0	intergen
17	50783123	50783492	MACS_peak_8291	542.19	369	0	0	1	other
17	50892472	50892817	MACS_peak_8292	594.81	345	0	0	1	other
17	50956830	50957243	MACS_peak_8293	613.85	413	0	0	0	intergen
17	51056849	51057070	MACS_peak_8294	767.82	221	0	1	1	gen
17	51113674	51114037	MACS_peak_8295	389.8	363	0	1	0	gen
17	51153234	51153546	MACS_peak_8296	486.01	312	2	0	0	promoter
17	51298881	51299156	MACS_peak_8297	577.45	275	0	0	0	intergen
17	51322454	51322728	MACS_peak_8298	558.56	274	0	0	1	other
17	51435731	51435931	MACS_peak_8300	814.37	200	0	0	1	other
17	51461503	51461945	MACS_peak_8301	659.09	442	0	0	0	intergen
17	51568591	51568955	MACS_peak_8302	115.7	364	0	0	0	intergen
17	51585569	51585772	MACS_peak_8303	814.37	203	0	0	0	intergen
17	51625532	51625964	MACS_peak_8304	75.1	432	1	0	0	promoter
17	51850188	51850536	MACS_peak_8305	417.2	348	0	1	0	gen
17	51860963	51861280	MACS_peak_8306	265.34	317	0	1	0	gen
17	51876059	51876287	MACS_peak_8307	631.23	228	0	1	0	gen
17	51914964	51915194	MACS_peak_8308	678.9	230	0	1	0	gen
17	52040133	52040265	MACS_peak_8309	932.35	132	0	1	0	gen
17	52106762	52107086	MACS_peak_8310	463.22	324	0	1	0	gen
17	52170882	52171228	MACS_peak_8311	404.98	346	0	0	0	intergen
17	52186260	52186594	MACS_peak_8312	245.25	334	0	0	0	intergen
17	52353118	52353407	MACS_peak_8313	111.55	289	0	0	0	intergen
17	52500082	52500239	MACS_peak_8314	794.19	157	0	0	1	other
17	52513928	52514258	MACS_peak_8315	845.32	330	0	0	1	other
17	52597477	52597827	MACS_peak_8316	397.07	350	0	0	0	intergen
17	52615524	52615789	MACS_peak_8317	90.9	265	0	0	0	intergen
17	52770993	52771279	MACS_peak_8318	503.8	286	0	0	0	intergen
17	53280177	53280646	MACS_peak_8320	532.84	469	0	0	1	other
17	53328398	53328743	MACS_peak_8321	259.8	345	0	0	1	other
17	53346541	53346989	MACS_peak_8322	153.8	448	0	0	1	other
17	53500672	53501112	MACS_peak_8323	235.05	440	0	0	1	other
17	53510821	53511135	MACS_peak_8324	625.44	314	0	0	1	other
17	53587231	53587586	MACS_peak_8325	594.92	355	0	0	1	other
17	53588095	53588335	MACS_peak_8326	697.63	240	0	0	1	other
17	53748466	53748704	MACS_peak_8327	415.95	238	0	0	1	other
17	53842556	53842836	MACS_peak_8328	178.37	280	0	0	1	other
17	53920517	53920835	MACS_peak_8329	222.29	318	0	0	1	other
17	53956270	53956524	MACS_peak_8330	1214.21	254	0	0	1	other
17	53958242	53958454	MACS_peak_8331	536.28	212	0	0	1	other
17	54172787	54173083	MACS_peak_8333	675.94	296	0	0	0	intergen
17	54579841	54580133	MACS_peak_8334	406.81	292	0	0	0	intergen
17	54696128	54696335	MACS_peak_8335	211.96	207	0	0	0	intergen
17	54891340	54891615	MACS_peak_8336	693.11	275	0	0	0	intergen
17	54993158	54993341	MACS_peak_8337	597.36	183	0	1	0	gen
17	55023815	55023957	MACS_peak_8338	2062.26	142	0	1	0	gen
17	55034239	55034495	MACS_peak_8339	576.65	256	0	1	0	gen
17	55053922	55054184	MACS_peak_8340	397.45	262	0	1	0	gen
17	55094167	55094372	MACS_peak_8341	573.39	205	0	1	0	gen
17	55502074	55502412	MACS_peak_8343	107.5	338	0	1	0	gen
17	55503176	55503629	MACS_peak_8344	51.73	453	0	1	0	gen
17	55514022	55514361	MACS_peak_8346	1662.52	339	0	0	0	intergen
17	55526311	55526715	MACS_peak_8347	569.42	404	0	0	0	intergen
17	55527464	55527847	MACS_peak_8348	1445.05	383	0	0	1	other
17	55718212	55718430	MACS_peak_8349	729.14	218	1	0	0	promoter
17	55735826	55736253	MACS_peak_8350	1241.35	427	0	0	0	intergen
17	55749400	55749670	MACS_peak_8351	380.3	270	1	0	0	promoter
17	55770359	55770570	MACS_peak_8352	460.03	211	0	1	0	gen
17	55791715	55792157	MACS_peak_8353	103.41	442	0	1	0	gen
17	55825301	55825582	MACS_peak_8354	506.92	281	0	1	0	gen
17	55839695	55839958	MACS_peak_8355	351.85	263	0	1	0	gen
17	55996870	55997185	MACS_peak_8356	288.64	315	0	1	0	gen
17	56005175	56005554	MACS_peak_8357	75.42	379	0	1	0	gen
17	56085029	56085217	MACS_peak_8358	1079.97	188	0	1	0	gen
17	56126507	56126897	MACS_peak_8359	845.32	390	0	1	0	gen
17	56155893	56156099	MACS_peak_8360	612.68	206	0	1	0	gen
17	56161231	56161432	MACS_peak_8361	478.76	201	0	1	0	gen
17	56192334	56192695	MACS_peak_8362	102.15	361	0	1	0	gen
17	56221388	56221721	MACS_peak_8363	424.75	333	0	1	0	gen
17	56268256	56268460	MACS_peak_8364	1913.8	204	0	1	0	gen
17	56288153	56288470	MACS_peak_8365	552.5	317	0	1	0	gen
17	56305172	56305423	MACS_peak_8366	904.41	251	0	1	0	gen
17	56319605	56319859	MACS_peak_8367	589.22	254	0	1	0	gen
17	56336525	56336895	MACS_peak_8368	72.26	370	0	1	0	gen
17	56478896	56479323	MACS_peak_8369	507.78	427	0	1	0	gen
17	56592549	56592793	MACS_peak_8370	918.92	244	1	0	0	promoter
17	56633154	56633486	MACS_peak_8371	542.96	332	0	0	0	intergen
17	56647831	56648192	MACS_peak_8372	509.85	361	0	0	0	intergen
17	56654069	56654251	MACS_peak_8373	913.84	182	0	0	0	intergen
17	56686967	56687213	MACS_peak_8374	386.6	246	0	0	0	intergen
17	56715991	56716211	MACS_peak_8375	1036.76	220	0	0	0	intergen
17	56780144	56780546	MACS_peak_8376	1100.96	402	0	0	0	intergen
17	56960993	56961316	MACS_peak_8377	1168.96	323	0	0	0	intergen
17	57005054	57005456	MACS_peak_8378	601.83	402	0	1	0	gen
17	57243158	57243399	MACS_peak_8380	2098.37	241	0	0	0	intergen
17	57457912	57458137	MACS_peak_8381	324.92	225	0	1	0	gen
17	57597854	57598116	MACS_peak_8382	859.93	262	0	1	0	gen
17	57747587	57747863	MACS_peak_8384	527.55	276	1	0	0	promoter
17	57783409	57783722	MACS_peak_8385	671.72	313	0	0	1	other
17	57833331	57833645	MACS_peak_8386	1600.31	314	1	0	1	promoter
17	57857949	57858213	MACS_peak_8387	1408.55	264	1	0	0	promoter
17	57875445	57875793	MACS_peak_8388	380.3	348	0	1	0	gen
17	57892404	57892777	MACS_peak_8389	572.27	373	0	1	0	gen
17	57938951	57939291	MACS_peak_8390	348.12	340	0	1	0	gen
17	57999420	57999851	MACS_peak_8391	707.16	431	1	1	0	promoter
17	58113073	58113512	MACS_peak_8392	1229.91	439	0	0	0	intergen
17	58136768	58136969	MACS_peak_8393	991.98	201	0	0	0	intergen
17	58172576	58172926	MACS_peak_8394	713.3	350	0	0	0	intergen
17	58249680	58249878	MACS_peak_8395	831.63	198	0	1	0	gen
17	58277202	58277487	MACS_peak_8396	1053.41	285	0	1	0	gen
17	58317393	58317686	MACS_peak_8397	696.46	293	0	1	0	gen
17	58351155	58351387	MACS_peak_8398	504.09	232	1	2	1	promoter
17	58417615	58418036	MACS_peak_8399	1585.07	421	1	0	0	promoter
17	58433235	58433679	MACS_peak_8400	878.34	444	0	1	0	gen
17	58447539	58447774	MACS_peak_8401	762.02	235	0	1	0	gen
17	58562383	58562667	MACS_peak_8402	360.32	284	0	1	0	gen
17	58587669	58587974	MACS_peak_8404	2291.8	305	0	1	0	gen
17	58591291	58591753	MACS_peak_8405	727.52	462	0	1	0	gen
17	58629101	58629484	MACS_peak_8406	350.24	383	0	1	0	gen
17	58631591	58631924	MACS_peak_8407	217.28	333	0	1	0	gen
17	58659011	58659378	MACS_peak_8408	272.61	367	1	1	0	promoter
17	58667866	58668024	MACS_peak_8409	664.76	158	0	2	0	gen
17	58739760	58740107	MACS_peak_8411	276.87	347	0	0	0	intergen
17	58759515	58759924	MACS_peak_8412	521.48	409	1	0	0	promoter
17	58784930	58785316	MACS_peak_8413	219.35	386	0	1	0	gen
17	58800952	58801372	MACS_peak_8414	1922.18	420	0	1	0	gen
17	58826675	58827046	MACS_peak_8415	159.23	371	0	1	0	gen
17	58857676	58857885	MACS_peak_8416	1211.65	209	0	1	0	gen
17	58860676	58861013	MACS_peak_8417	207.78	337	0	1	0	gen
17	58861182	58861476	MACS_peak_8418	889.09	294	0	1	0	gen
17	58870691	58871023	MACS_peak_8419	333.58	332	0	1	0	gen
17	58917121	58917435	MACS_peak_8420	76.3	314	0	1	0	gen
17	58935237	58935463	MACS_peak_8421	269.36	226	0	1	0	gen
17	58960761	58961072	MACS_peak_8422	326.84	311	0	1	0	gen
17	58995399	58995626	MACS_peak_8423	629.32	227	0	1	0	gen
17	59003404	59003742	MACS_peak_8424	396.63	338	0	1	0	gen
17	59003919	59004210	MACS_peak_8425	222.55	291	0	1	0	gen
17	59038715	59038900	MACS_peak_8427	308.59	185	0	1	0	gen
17	59061423	59061791	MACS_peak_8429	158.24	368	0	1	0	gen
17	59072966	59073262	MACS_peak_8430	162.76	296	0	1	0	gen
17	59076069	59076303	MACS_peak_8431	290.02	234	0	1	0	gen
17	59087603	59087840	MACS_peak_8433	186.7	237	0	1	0	gen
17	59091361	59091804	MACS_peak_8434	356.5	443	0	1	0	gen
17	59097268	59097568	MACS_peak_8435	86.12	300	0	1	0	gen
17	59101020	59101152	MACS_peak_8436	511.39	132	0	1	0	gen
17	59165883	59166164	MACS_peak_8437	237.01	281	0	1	0	gen
17	59310907	59311297	MACS_peak_8438	860.35	390	0	0	0	intergen
17	59316918	59317302	MACS_peak_8439	451.71	384	0	0	0	intergen
17	59435751	59435932	MACS_peak_8441	1097.36	181	0	0	1	other
17	59440902	59441139	MACS_peak_8442	725.97	237	0	0	1	other
17	59521521	59521782	MACS_peak_8443	1059.3	261	0	0	1	other
17	59534575	59534855	MACS_peak_8444	630.48	280	0	0	0	intergen
17	59558920	59559272	MACS_peak_8445	1025.67	352	0	0	0	intergen
17	59569937	59570343	MACS_peak_8446	832.63	406	1	0	0	promoter
17	59574260	59574682	MACS_peak_8447	87.91	422	0	1	0	gen
17	59592253	59592552	MACS_peak_8448	147.3	299	0	1	0	gen
17	59713679	59713811	MACS_peak_8449	797.63	132	0	1	0	gen
17	59746881	59747134	MACS_peak_8450	622.06	253	0	1	0	gen
17	59753518	59753862	MACS_peak_8451	326.65	344	0	1	0	gen
17	59809398	59809719	MACS_peak_8452	207.37	321	0	1	0	gen
17	59812196	59812389	MACS_peak_8453	614.61	193	0	1	0	gen
17	59831823	59832176	MACS_peak_8454	139.31	353	0	1	0	gen
17	59832488	59832800	MACS_peak_8455	210.12	312	0	1	0	gen
17	59837101	59837517	MACS_peak_8456	180.76	416	0	1	0	gen
17	59839131	59839608	MACS_peak_8457	781.73	477	0	1	0	gen
17	59844436	59844702	MACS_peak_8458	286.66	266	0	0	0	intergen
17	59852574	59852969	MACS_peak_8459	123.24	395	0	0	0	intergen
17	59853117	59853570	MACS_peak_8460	1948.59	453	0	0	0	intergen
17	59855498	59855874	MACS_peak_8461	114.09	376	1	0	0	promoter
17	59857379	59857611	MACS_peak_8462	170.22	232	1	0	0	promoter
17	59874709	59875089	MACS_peak_8465	166.6	380	0	1	0	gen
17	59909145	59909299	MACS_peak_8466	508.47	154	0	1	0	gen
17	59918663	59918851	MACS_peak_8468	634.81	188	0	1	0	gen
17	59929362	59929710	MACS_peak_8469	120.35	348	0	1	0	gen
17	59938059	59938495	MACS_peak_8470	100.62	436	1	1	0	promoter
17	59941205	59941430	MACS_peak_8471	309.39	225	1	1	0	promoter
17	59960297	59960568	MACS_peak_8472	116.68	271	0	2	0	gen
17	59966710	59967180	MACS_peak_8473	191.15	470	0	1	2	gen
17	60008457	60008786	MACS_peak_8474	1445.95	329	0	0	2	other
17	60047834	60048283	MACS_peak_8477	339.26	449	0	0	0	intergen
17	60059593	60059953	MACS_peak_8478	137.66	360	0	1	0	gen
17	60068608	60069062	MACS_peak_8479	181.44	454	0	1	0	gen
17	60101869	60102131	MACS_peak_8480	175.17	262	0	0	1	other
17	60108001	60108482	MACS_peak_8481	299.21	481	0	0	0	intergen
17	60142154	60142508	MACS_peak_8483	247.94	354	0	0	0	intergen
17	60142878	60143295	MACS_peak_8484	2705.16	417	0	0	0	intergen
17	60174633	60175035	MACS_peak_8485	1578.28	402	1	0	0	promoter
17	60188293	60188651	MACS_peak_8486	117.9	358	0	1	0	gen
17	60216260	60216640	MACS_peak_8487	74.78	380	0	1	0	gen
17	60229432	60229780	MACS_peak_8488	690.03	348	0	1	0	gen
17	60230183	60230567	MACS_peak_8489	146.15	384	0	1	0	gen
17	60242299	60242506	MACS_peak_8491	211.96	207	0	1	0	gen
17	60254691	60255065	MACS_peak_8493	206.31	374	0	1	0	gen
17	60256426	60256803	MACS_peak_8494	106.43	377	0	1	0	gen
17	60256897	60257131	MACS_peak_8495	174.8	234	0	1	1	gen
17	60281903	60282350	MACS_peak_8496	125.63	447	0	1	0	gen
17	60283139	60283505	MACS_peak_8497	103.45	366	0	1	0	gen
17	60283863	60284101	MACS_peak_8498	415.7	238	0	1	0	gen
17	60284921	60285262	MACS_peak_8499	93.4	341	0	1	0	gen
17	60288113	60288341	MACS_peak_8500	451.74	228	0	1	0	gen
17	60319219	60319553	MACS_peak_8502	84.4	334	0	1	0	gen
17	60329677	60330057	MACS_peak_8503	343.7	380	0	1	0	gen
17	60346663	60347143	MACS_peak_8504	329.83	480	0	1	0	gen
17	60358846	60359214	MACS_peak_8505	181.4	368	0	1	0	gen
17	60362801	60363036	MACS_peak_8506	167.64	235	0	1	0	gen
17	60373331	60373464	MACS_peak_8507	625.5	133	0	1	0	gen
17	60392222	60392545	MACS_peak_8508	221.26	323	1	1	0	promoter
17	60420082	60420422	MACS_peak_8509	171.96	340	0	2	0	gen
17	60421294	60421596	MACS_peak_8510	186.16	302	0	2	0	gen
17	60434912	60435236	MACS_peak_8511	162.32	324	0	0	1	other
17	60435927	60436314	MACS_peak_8512	2993.34	387	0	0	0	intergen
17	60447739	60447871	MACS_peak_8513	517.86	132	1	0	0	promoter
17	60462946	60463283	MACS_peak_8514	126.47	337	0	1	0	gen
17	60463322	60463628	MACS_peak_8515	195.04	306	0	1	0	gen
17	60517657	60518050	MACS_peak_8516	137.55	393	0	1	0	gen
17	60519664	60519932	MACS_peak_8517	651.39	268	0	1	0	gen
17	60549812	60549944	MACS_peak_8518	552.59	132	0	0	1	other
17	60577558	60577836	MACS_peak_8520	283.77	278	0	0	1	other
17	60586349	60586613	MACS_peak_8521	831.45	264	0	0	1	other
17	60589329	60589666	MACS_peak_8522	203.19	337	0	0	0	intergen
17	60610205	60610461	MACS_peak_8524	151	256	0	1	0	gen
17	60638695	60639174	MACS_peak_8525	3100	479	0	1	0	gen
17	60640026	60640283	MACS_peak_8526	198.02	257	0	1	0	gen
17	60641806	60642219	MACS_peak_8528	960.88	413	0	1	0	gen
17	60647378	60647592	MACS_peak_8529	176.28	214	0	1	0	gen
17	60656576	60656789	MACS_peak_8530	185.02	213	0	1	0	gen
17	60656910	60657305	MACS_peak_8531	480.11	395	0	1	0	gen
17	60660222	60660591	MACS_peak_8532	112.17	369	0	1	0	gen
17	60686965	60687287	MACS_peak_8533	3100	322	0	1	0	gen
17	60689910	60690285	MACS_peak_8534	103.45	375	0	1	0	gen
17	60698183	60698332	MACS_peak_8535	437.37	149	0	1	0	gen
17	60714834	60715210	MACS_peak_8536	115.9	376	0	1	0	gen
17	60722758	60722890	MACS_peak_8538	492.84	132	0	1	0	gen
17	60726799	60727239	MACS_peak_8539	144.72	440	0	1	0	gen
17	60739813	60740177	MACS_peak_8540	2670.37	364	0	1	0	gen
17	60741348	60741800	MACS_peak_8541	92.97	452	0	1	0	gen
17	60748026	60748388	MACS_peak_8543	55.81	362	0	1	0	gen
17	60748729	60749143	MACS_peak_8544	73.19	414	0	1	0	gen
17	60756496	60756823	MACS_peak_8545	87.56	327	0	1	0	gen
17	60881979	60882355	MACS_peak_8549	100.83	376	0	1	0	gen
17	60885587	60886069	MACS_peak_8552	70.44	482	0	1	0	gen
17	60896758	60897121	MACS_peak_8553	389.8	363	0	1	0	gen
17	60901074	60901462	MACS_peak_8554	304.93	388	0	1	0	gen
17	60905312	60905575	MACS_peak_8555	303.97	263	0	1	0	gen
17	60971777	60972227	MACS_peak_8556	917.81	450	0	1	0	gen
17	60977651	60977945	MACS_peak_8557	158.81	294	0	1	0	gen
17	61000765	61001118	MACS_peak_8558	256.13	353	0	1	0	gen
17	61002326	61002544	MACS_peak_8559	352.93	218	0	1	0	gen
17	61045793	61046015	MACS_peak_8560	565.98	222	0	1	1	gen
17	61052459	61052842	MACS_peak_8561	385.88	383	0	1	1	gen
17	61114398	61114755	MACS_peak_8562	111.73	357	0	1	0	gen
17	61151098	61151523	MACS_peak_8563	419.25	425	0	1	0	gen
17	61215869	61216245	MACS_peak_8564	85.85	376	0	1	0	gen
17	61225925	61226267	MACS_peak_8565	154.86	342	0	1	0	gen
17	61230809	61231189	MACS_peak_8566	88.52	380	0	1	0	gen
17	61231250	61231616	MACS_peak_8567	298.35	366	0	1	0	gen
17	61241306	61241664	MACS_peak_8568	130.06	358	0	1	0	gen
17	61247282	61247555	MACS_peak_8569	84.4	273	0	1	0	gen
17	61265488	61265830	MACS_peak_8570	109.03	342	0	1	0	gen
17	61269849	61270208	MACS_peak_8571	109.88	359	0	1	0	gen
17	61274381	61274717	MACS_peak_8572	110.17	336	0	1	0	gen
17	61276804	61277003	MACS_peak_8573	304.66	199	0	1	0	gen
17	61349455	61349720	MACS_peak_8575	219.35	265	0	1	0	gen
17	61356686	61357072	MACS_peak_8576	1384.18	386	0	1	0	gen
17	61358303	61358733	MACS_peak_8578	154.75	430	0	1	0	gen
17	61359176	61359466	MACS_peak_8579	289.22	290	0	1	0	gen
17	61393641	61394120	MACS_peak_8582	1555.43	479	0	0	2	other
17	61409068	61409339	MACS_peak_8583	249.49	271	0	1	1	gen
17	61410804	61411040	MACS_peak_8585	266.23	236	0	0	1	other
17	61412340	61412746	MACS_peak_8586	3100	406	0	0	1	other
17	61425865	61426319	MACS_peak_8588	285.63	454	0	0	0	intergen
17	61431912	61432377	MACS_peak_8590	161.81	465	0	0	0	intergen
17	61433542	61433918	MACS_peak_8591	68.61	376	0	0	0	intergen
17	61434921	61435242	MACS_peak_8592	179.53	321	0	0	0	intergen
17	61436834	61437023	MACS_peak_8593	165.88	189	0	0	0	intergen
17	61439007	61439453	MACS_peak_8594	143.8	446	0	0	0	intergen
17	61450689	61451012	MACS_peak_8595	162.11	323	1	0	0	promoter
17	61464136	61464508	MACS_peak_8597	120.57	372	0	1	0	gen
17	61470700	61470975	MACS_peak_8598	128.87	275	0	1	0	gen
17	61489276	61489606	MACS_peak_8599	91.52	330	0	0	0	intergen
17	61497960	61498299	MACS_peak_8600	76.95	339	0	0	0	intergen
17	61500079	61500539	MACS_peak_8601	193.23	460	0	0	0	intergen
17	61506425	61506807	MACS_peak_8603	54.49	382	0	0	0	intergen
17	61513308	61513663	MACS_peak_8604	124.6	355	0	0	0	intergen
17	61523616	61523944	MACS_peak_8605	89.24	328	0	0	0	intergen
17	61531598	61531873	MACS_peak_8606	89	275	0	0	0	intergen
17	61534956	61535287	MACS_peak_8607	62.17	331	0	0	0	intergen
17	61537867	61538091	MACS_peak_8608	142.72	224	0	0	0	intergen
17	61540378	61540681	MACS_peak_8609	3100	303	0	0	0	intergen
17	61540955	61541318	MACS_peak_8610	57.61	363	0	0	0	intergen
17	61547039	61547326	MACS_peak_8611	88.4	287	0	0	0	intergen
17	61549108	61549457	MACS_peak_8612	75.7	349	0	0	0	intergen
17	61549582	61549963	MACS_peak_8613	65.99	381	0	0	0	intergen
17	61552967	61553394	MACS_peak_8615	2190.35	427	0	0	0	intergen
17	61553509	61553766	MACS_peak_8616	148.57	257	0	0	0	intergen
17	61561956	61562185	MACS_peak_8617	303.01	229	0	0	0	intergen
17	61568573	61568987	MACS_peak_8619	822.4	414	0	0	0	intergen
17	61573167	61573396	MACS_peak_8620	134.97	229	0	0	0	intergen
17	61575649	61576027	MACS_peak_8622	57.95	378	0	0	0	intergen
17	61577448	61577898	MACS_peak_8624	180.4	450	0	0	0	intergen
17	61595011	61595438	MACS_peak_8627	79.26	427	0	0	0	intergen
17	61595846	61596248	MACS_peak_8628	71.85	402	0	0	0	intergen
17	61610318	61610635	MACS_peak_8630	72.32	317	0	0	0	intergen
17	61614646	61614975	MACS_peak_8631	57.35	329	0	0	0	intergen
17	61622327	61622715	MACS_peak_8632	66.62	388	0	0	0	intergen
17	61625416	61625759	MACS_peak_8633	59.76	343	0	0	0	intergen
17	61633004	61633281	MACS_peak_8635	90.12	277	0	0	0	intergen
17	61634554	61634926	MACS_peak_8636	79.35	372	0	0	0	intergen
17	61645569	61645961	MACS_peak_8639	64.48	392	0	0	0	intergen
17	61650697	61651025	MACS_peak_8641	1014.06	328	0	0	0	intergen
17	61676846	61677289	MACS_peak_8642	64.68	443	1	0	0	promoter
17	61678138	61678510	MACS_peak_8643	92.17	372	1	0	0	promoter
17	61680291	61680610	MACS_peak_8644	93.82	319	1	0	0	promoter
17	61687279	61687725	MACS_peak_8645	371.68	446	0	1	0	gen
17	61688394	61688754	MACS_peak_8646	58.9	360	0	1	0	gen
17	61697223	61697702	MACS_peak_8648	66.39	479	0	1	0	gen
17	61713130	61713524	MACS_peak_8650	133.25	394	0	1	0	gen
17	61714970	61715358	MACS_peak_8651	62.5	388	0	1	0	gen
17	61723088	61723523	MACS_peak_8652	105.42	435	0	1	0	gen
17	61729731	61730135	MACS_peak_8653	417.23	404	0	1	0	gen
17	61730612	61730911	MACS_peak_8654	51.77	299	0	1	0	gen
17	61744118	61744480	MACS_peak_8655	50.92	362	0	1	0	gen
17	61745751	61745975	MACS_peak_8656	290.28	224	0	1	0	gen
17	61748872	61749148	MACS_peak_8657	61.68	276	0	1	0	gen
17	61757174	61757512	MACS_peak_8659	133.59	338	0	1	0	gen
17	61765936	61766296	MACS_peak_8661	54.82	360	0	1	0	gen
17	61768363	61768757	MACS_peak_8662	70.01	394	0	1	0	gen
17	61783074	61783369	MACS_peak_8664	80.61	295	0	1	0	gen
17	61783902	61784235	MACS_peak_8665	72.43	333	0	1	0	gen
17	61803488	61803731	MACS_peak_8667	153.99	243	0	1	0	gen
17	61810772	61811145	MACS_peak_8668	67.08	373	0	1	0	gen
17	61811284	61811605	MACS_peak_8669	54.52	321	0	1	0	gen
17	61813045	61813403	MACS_peak_8670	73.11	358	0	1	0	gen
17	61819330	61819706	MACS_peak_8671	50.79	376	0	1	0	gen
17	61824308	61824760	MACS_peak_8673	62.57	452	0	1	0	gen
17	61825506	61825826	MACS_peak_8674	74.54	320	0	1	0	gen
17	61826334	61826774	MACS_peak_8675	52.06	440	0	1	0	gen
17	61829574	61829949	MACS_peak_8676	60.82	375	0	1	0	gen
17	61837918	61838231	MACS_peak_8678	145.8	313	0	1	0	gen
17	61840595	61840909	MACS_peak_8680	68.03	314	0	1	0	gen
17	61843309	61843668	MACS_peak_8681	55.04	359	0	1	0	gen
17	61847914	61848290	MACS_peak_8682	56.1	376	0	1	0	gen
17	61849703	61850100	MACS_peak_8684	81.33	397	0	1	0	gen
17	61853135	61853420	MACS_peak_8685	67.31	285	0	1	0	gen
17	61863604	61863946	MACS_peak_8686	72.36	342	1	0	0	promoter
17	61865299	61865736	MACS_peak_8687	187.59	437	1	0	0	promoter
17	61875561	61875809	MACS_peak_8688	97.98	248	0	1	0	gen
17	61878674	61879056	MACS_peak_8689	62.39	382	0	1	0	gen
17	61879394	61879827	MACS_peak_8690	150.9	433	0	1	0	gen
17	61880708	61881009	MACS_peak_8691	83.91	301	0	1	0	gen
17	61891949	61892310	MACS_peak_8692	100.3	361	0	1	0	gen
17	61893087	61893396	MACS_peak_8693	76.3	309	0	1	0	gen
17	61906959	61907094	MACS_peak_8695	753.78	135	0	1	0	gen
17	61908343	61908736	MACS_peak_8696	67.53	393	0	1	0	gen
17	61992198	61992575	MACS_peak_8697	342.79	377	0	1	0	gen
17	62030622	62030866	MACS_peak_8699	491.61	244	0	1	0	gen
17	62066079	62066343	MACS_peak_8700	775.74	264	0	0	0	intergen
17	62109504	62109904	MACS_peak_8701	678.95	400	0	0	0	intergen
17	62130120	62130557	MACS_peak_8702	132.2	437	0	0	0	intergen
17	62135974	62136317	MACS_peak_8703	312.47	343	0	0	0	intergen
17	62265037	62265366	MACS_peak_8705	1515.87	329	0	0	1	other
17	62326871	62327189	MACS_peak_8706	96.1	318	0	0	0	intergen
17	62416773	62417023	MACS_peak_8707	414.19	250	0	0	0	intergen
17	62421392	62421871	MACS_peak_8708	2036.87	479	1	0	0	promoter
17	62421988	62422294	MACS_peak_8709	233.14	306	1	0	0	promoter
17	62423683	62423963	MACS_peak_8710	334.08	280	1	0	0	promoter
17	62484116	62484332	MACS_peak_8711	1396.66	216	0	1	0	gen
17	62484836	62485248	MACS_peak_8712	2259.35	412	0	1	0	gen
17	62553056	62553446	MACS_peak_8713	1258.57	390	0	1	0	gen
17	62592684	62592969	MACS_peak_8714	398.02	285	0	1	0	gen
17	62693247	62693593	MACS_peak_8716	1002.18	346	0	1	0	gen
17	62720510	62720834	MACS_peak_8717	312.33	324	0	1	1	gen
17	62780143	62780540	MACS_peak_8718	287.82	397	0	1	0	gen
17	62784223	62784573	MACS_peak_8719	62.38	350	0	1	0	gen
17	62799746	62799973	MACS_peak_8720	442.89	227	0	1	0	gen
17	62903398	62903696	MACS_peak_8721	389.13	298	0	0	0	intergen
17	62963015	62963265	MACS_peak_8722	793.01	250	0	0	1	other
17	62995299	62995764	MACS_peak_8724	535.35	465	0	0	0	intergen
17	63011699	63012041	MACS_peak_8725	571.37	342	1	0	0	promoter
17	63014538	63014815	MACS_peak_8726	312.33	277	0	0	0	intergen
17	63082254	63082600	MACS_peak_8727	603.06	346	0	1	0	gen
17	63113226	63113518	MACS_peak_8728	566.01	292	0	1	0	gen
17	63144993	63145371	MACS_peak_8729	265.34	378	0	1	0	gen
17	63208103	63208345	MACS_peak_8730	477.68	242	0	1	1	gen
17	63210117	63210302	MACS_peak_8731	771.26	185	0	1	1	gen
17	63246412	63246610	MACS_peak_8732	923.54	198	0	1	1	gen
17	63276486	63276618	MACS_peak_8733	893.03	132	0	1	1	gen
17	63405699	63406030	MACS_peak_8734	2191.88	331	0	1	2	gen
17	63425314	63425715	MACS_peak_8735	1554.8	401	0	1	1	gen
17	63497967	63498300	MACS_peak_8736	542.34	333	0	2	0	gen
17	63612274	63612663	MACS_peak_8737	1336.42	389	0	0	0	intergen
17	63688767	63689011	MACS_peak_8738	483.55	244	0	2	0	gen
17	63697911	63698170	MACS_peak_8739	594.37	259	2	1	0	promoter
17	63809780	63810025	MACS_peak_8740	986.28	245	0	1	0	gen
17	63866142	63866401	MACS_peak_8741	1804.99	259	0	0	0	intergen
17	63866599	63866941	MACS_peak_8742	380.71	342	0	0	0	intergen
17	63874058	63874334	MACS_peak_8743	644.51	276	1	0	0	promoter
17	63882214	63882495	MACS_peak_8744	648	281	1	0	0	promoter
17	63888940	63889250	MACS_peak_8745	2181.06	310	0	0	0	intergen
17	63896955	63897231	MACS_peak_8746	611.86	276	1	0	0	promoter
17	63903741	63904054	MACS_peak_8747	1642.27	313	0	0	0	intergen
17	63919223	63919569	MACS_peak_8748	769.41	346	2	0	0	promoter
17	63950920	63951230	MACS_peak_8749	557.12	310	0	1	0	gen
17	63990443	63990723	MACS_peak_8750	383.72	280	0	0	0	intergen
17	64016802	64017081	MACS_peak_8751	573.89	279	0	1	0	gen
17	64017416	64017768	MACS_peak_8752	310.84	352	0	1	0	gen
17	64025882	64026097	MACS_peak_8753	799.34	215	0	0	0	intergen
17	64028918	64029244	MACS_peak_8754	1641.19	326	0	0	0	intergen
17	64133713	64133990	MACS_peak_8755	386.36	277	0	0	0	intergen
17	64196874	64197008	MACS_peak_8756	1586.79	134	0	1	0	gen
17	64282097	64282358	MACS_peak_8757	793.88	261	0	0	0	intergen
17	64306782	64307176	MACS_peak_8758	490.83	394	0	0	0	intergen
17	64320989	64321426	MACS_peak_8759	1922.83	437	1	0	0	promoter
17	64323334	64323656	MACS_peak_8760	163.82	322	1	0	0	promoter
17	64473346	64473478	MACS_peak_8761	940.81	132	1	0	0	promoter
17	64480337	64480638	MACS_peak_8762	790.81	301	1	0	0	promoter
17	64492581	64492799	MACS_peak_8764	666.39	218	0	1	0	gen
17	64507448	64507801	MACS_peak_8765	611.86	353	1	1	0	promoter
17	64514415	64514762	MACS_peak_8766	1129.64	347	0	1	0	gen
17	64540658	64540794	MACS_peak_8767	927.9	136	1	1	0	promoter
17	64580217	64580611	MACS_peak_8768	1893.8	394	0	1	0	gen
17	64602367	64602832	MACS_peak_8769	1202.81	465	0	1	0	gen
17	64627106	64627297	MACS_peak_8770	415.8	191	0	1	0	gen
17	64649187	64649529	MACS_peak_8771	1699.95	342	0	1	0	gen
17	64700880	64701174	MACS_peak_8772	401.65	294	0	0	0	intergen
17	64707994	64708315	MACS_peak_8773	306.6	321	0	0	0	intergen
17	64776899	64777210	MACS_peak_8774	436.49	311	0	0	1	other
17	64919414	64919630	MACS_peak_8775	1446.15	216	0	0	0	intergen
17	64927596	64927897	MACS_peak_8776	691.11	301	0	0	0	intergen
17	64961770	64962176	MACS_peak_8777	476.21	406	0	0	0	intergen
17	64963842	64964048	MACS_peak_8778	486.85	206	0	0	0	intergen
17	65027243	65027599	MACS_peak_8779	1091.17	356	0	1	0	gen
17	65100568	65100773	MACS_peak_8780	734.26	205	1	0	0	promoter
17	65137126	65137429	MACS_peak_8781	1094.68	303	0	1	0	gen
17	65198789	65199165	MACS_peak_8782	382.81	376	0	1	0	gen
17	65219172	65219529	MACS_peak_8783	972.38	357	0	1	0	gen
17	65231769	65232057	MACS_peak_8784	487.22	288	0	0	0	intergen
17	65294240	65294605	MACS_peak_8785	768.37	365	0	0	0	intergen
17	65313582	65313715	MACS_peak_8786	936.97	133	0	0	0	intergen
17	65315319	65315556	MACS_peak_8787	481.5	237	0	0	0	intergen
17	65409584	65409993	MACS_peak_8788	510.43	409	0	0	0	intergen
17	65422660	65423060	MACS_peak_8789	445.11	400	0	0	0	intergen
17	65455904	65456229	MACS_peak_8790	312.33	325	0	0	0	intergen
17	65501010	65501144	MACS_peak_8791	1621.76	134	0	0	0	intergen
17	65503055	65503187	MACS_peak_8792	950.58	132	0	0	0	intergen
17	65523390	65523605	MACS_peak_8793	1032.2	215	0	0	0	intergen
17	65556463	65556748	MACS_peak_8794	451.52	285	0	2	0	gen
17	65588178	65588548	MACS_peak_8795	999.16	370	0	1	0	gen
17	65634173	65634589	MACS_peak_8796	1106.44	416	1	1	0	promoter
17	65726593	65726800	MACS_peak_8797	561.45	207	0	1	0	gen
17	65810581	65810853	MACS_peak_8798	1364.13	272	0	1	0	gen
17	65941406	65941806	MACS_peak_8799	982.39	400	0	1	0	gen
17	66040425	66040633	MACS_peak_8800	993.56	208	0	1	0	gen
17	66094652	66094943	MACS_peak_8801	476.54	291	0	1	0	gen
17	66117843	66118079	MACS_peak_8802	527.28	236	0	1	0	gen
17	66165539	66165879	MACS_peak_8803	502.27	340	0	1	0	gen
17	66365584	66365778	MACS_peak_8804	619.53	194	0	1	0	gen
17	66403645	66403925	MACS_peak_8805	441.26	280	0	1	1	gen
17	66482750	66482980	MACS_peak_8806	604.83	230	0	1	0	gen
17	66567280	66567638	MACS_peak_8807	716.55	358	0	1	0	gen
17	66597213	66597487	MACS_peak_8808	71.7	274	0	1	0	gen
17	66597646	66597904	MACS_peak_8809	101.11	258	0	1	0	gen
17	66601097	66601437	MACS_peak_8810	65.49	340	0	1	0	gen
17	66625343	66625682	MACS_peak_8811	988.19	339	0	1	0	gen
17	66673843	66674134	MACS_peak_8812	523.63	291	0	1	0	gen
17	66715638	66716005	MACS_peak_8813	642.17	367	0	1	0	gen
17	66727934	66728209	MACS_peak_8814	803.89	275	0	1	0	gen
17	66844970	66845188	MACS_peak_8815	363.4	218	0	1	0	gen
17	66900048	66900511	MACS_peak_8816	721.05	463	0	0	0	intergen
17	66906724	66907187	MACS_peak_8817	807.88	463	0	0	0	intergen
17	67195832	67195974	MACS_peak_8818	921.89	142	0	1	0	gen
17	67200729	67201043	MACS_peak_8819	322.23	314	0	1	0	gen
17	67272535	67272936	MACS_peak_8820	349.84	401	0	0	1	other
17	67359898	67360112	MACS_peak_8821	460.03	214	0	1	0	gen
17	67374655	67374969	MACS_peak_8822	1069.78	314	1	0	0	promoter
17	67386983	67387282	MACS_peak_8823	609.88	299	0	1	0	gen
17	67475496	67475817	MACS_peak_8824	521.07	321	0	1	0	gen
17	67479549	67479766	MACS_peak_8825	538.37	217	0	1	0	gen
17	67559369	67559610	MACS_peak_8826	628.77	241	0	1	0	gen
17	67603050	67603346	MACS_peak_8827	550.71	296	0	1	0	gen
17	67630002	67630231	MACS_peak_8828	455.24	229	0	1	0	gen
17	67689620	67690074	MACS_peak_8829	476.21	454	0	1	0	gen
17	67690263	67690577	MACS_peak_8830	506.92	314	0	1	0	gen
17	67717692	67717989	MACS_peak_8831	626.7	297	1	0	0	promoter
17	67779063	67779275	MACS_peak_8832	1228.02	212	0	0	0	intergen
17	67800470	67800751	MACS_peak_8833	504.05	281	0	0	0	intergen
17	67825308	67825565	MACS_peak_8834	714.38	257	1	0	0	promoter
17	67891813	67892260	MACS_peak_8835	1617	447	0	1	0	gen
17	67942865	67943071	MACS_peak_8836	655.89	206	0	1	0	gen
17	67953862	67954086	MACS_peak_8837	86.67	224	0	1	0	gen
17	67963280	67963650	MACS_peak_8838	911.5	370	0	1	0	gen
17	68011068	68011498	MACS_peak_8839	722.05	430	0	0	0	intergen
17	68039804	68040102	MACS_peak_8840	270.5	298	1	0	0	promoter
17	68172369	68172714	MACS_peak_8842	2237.24	345	0	0	0	intergen
17	68200770	68201133	MACS_peak_8843	409.98	363	0	0	0	intergen
17	68205310	68205577	MACS_peak_8844	1328.19	267	0	0	0	intergen
17	68263146	68263347	MACS_peak_8845	478.76	201	2	0	0	promoter
17	68410865	68411260	MACS_peak_8846	87.49	395	0	1	0	gen
17	68436481	68436685	MACS_peak_8847	617.05	204	0	1	1	gen
17	68466187	68466442	MACS_peak_8848	553.63	255	0	0	1	other
17	68665389	68665761	MACS_peak_8852	392.63	372	0	0	1	other
17	68740899	68741106	MACS_peak_8853	554.69	207	0	0	1	other
17	68759998	68760310	MACS_peak_8854	1057.89	312	0	0	1	other
17	68777398	68777777	MACS_peak_8855	539.27	379	0	0	0	intergen
17	68794628	68795009	MACS_peak_8856	843.52	381	0	0	1	other
17	68916185	68916551	MACS_peak_8857	534.92	366	0	1	0	gen
17	68969414	68969581	MACS_peak_8859	588.24	167	0	0	1	other
17	68972197	68972514	MACS_peak_8860	731.28	317	1	0	1	promoter
17	69085062	69085457	MACS_peak_8862	825.48	395	0	1	0	gen
17	69138762	69138984	MACS_peak_8863	103.93	222	0	1	0	gen
17	69235488	69235760	MACS_peak_8864	735.52	272	0	1	0	gen
17	69246888	69247083	MACS_peak_8865	740.45	195	1	0	0	promoter
17	69279456	69279807	MACS_peak_8866	56.38	351	0	1	0	gen
17	69295393	69295738	MACS_peak_8867	340.49	345	0	1	0	gen
17	69335096	69335375	MACS_peak_8868	1271.3	279	0	0	0	intergen
17	69336667	69336857	MACS_peak_8869	944.15	190	0	0	0	intergen
17	69429111	69429306	MACS_peak_8870	662.31	195	0	1	0	gen
17	69497755	69497955	MACS_peak_8871	645.81	200	0	1	1	gen
17	69523376	69523600	MACS_peak_8872	564.54	224	0	1	0	gen
17	69525993	69526348	MACS_peak_8873	776.01	355	0	1	0	gen
17	69569106	69569296	MACS_peak_8874	994.68	190	0	0	0	intergen
17	69609618	69609867	MACS_peak_8875	337.12	249	0	0	1	other
17	69614436	69614756	MACS_peak_8876	115.17	320	0	0	1	other
17	69617018	69617289	MACS_peak_8878	211.76	271	0	0	1	other
17	69741673	69741975	MACS_peak_8879	64.55	302	0	0	1	other
17	69742066	69742382	MACS_peak_8880	136.4	316	0	0	1	other
17	69920679	69920831	MACS_peak_8881	586.77	152	0	0	0	intergen
17	69938102	69938309	MACS_peak_8882	603.96	207	0	0	0	intergen
17	69983834	69984040	MACS_peak_8883	612.68	206	0	0	1	other
17	70024797	70024948	MACS_peak_8884	1402.54	151	0	0	1	other
17	70292832	70293026	MACS_peak_8885	1009.27	194	0	0	0	intergen
17	70548123	70548494	MACS_peak_8887	52.63	371	0	0	0	intergen
17	70622511	70622928	MACS_peak_8888	731.8	417	0	0	0	intergen
17	70629845	70630197	MACS_peak_8889	371.07	352	0	0	0	intergen
17	70715963	70716191	MACS_peak_8890	778.31	228	0	0	0	intergen
17	71074897	71075339	MACS_peak_8892	1065.16	442	0	0	0	intergen
17	71205734	71206199	MACS_peak_8893	172.39	465	0	0	0	intergen
17	71356583	71357016	MACS_peak_8894	62.68	433	0	0	0	intergen
17	71410929	71411306	MACS_peak_8895	1292.82	377	0	0	0	intergen
17	71607839	71608222	MACS_peak_8896	877.85	383	0	0	0	intergen
17	71608368	71608672	MACS_peak_8897	449.06	304	0	0	0	intergen
17	71628718	71628960	MACS_peak_8898	649.85	242	0	0	0	intergen
17	71643314	71643679	MACS_peak_8899	953.02	365	0	0	0	intergen
17	71645651	71645985	MACS_peak_8900	314.21	334	0	0	0	intergen
17	71688888	71689129	MACS_peak_8901	402.63	241	0	0	0	intergen
17	71701128	71701335	MACS_peak_8902	332.68	207	0	0	0	intergen
17	71764532	71764833	MACS_peak_8903	821.52	301	0	0	0	intergen
17	71784541	71784873	MACS_peak_8904	794.47	332	0	0	0	intergen
17	71793434	71793700	MACS_peak_8905	588.83	266	0	0	0	intergen
17	72118657	72118963	MACS_peak_8907	559.8	306	1	0	1	promoter
17	72560280	72560514	MACS_peak_8908	532.66	234	0	0	1	other
17	73310853	73311235	MACS_peak_8909	401.26	382	0	1	0	gen
17	73427532	73427668	MACS_peak_8910	1945.17	136	0	1	0	gen
17	73809056	73809262	MACS_peak_8911	270.08	206	0	0	1	other
17	74019544	74019970	MACS_peak_8912	606.43	426	0	0	0	intergen
17	74368376	74368660	MACS_peak_8913	704	284	1	0	0	promoter
17	74533182	74533405	MACS_peak_8914	513.05	223	0	0	0	intergen
17	74791471	74791762	MACS_peak_8915	549.74	291	0	1	0	gen
17	75105889	75106114	MACS_peak_8916	529.68	225	1	1	0	promoter
17	75201808	75202112	MACS_peak_8917	488.85	304	1	0	0	promoter
17	75323091	75323362	MACS_peak_8918	599.17	271	0	1	0	gen
17	75404247	75404629	MACS_peak_8919	1320.51	382	0	1	0	gen
17	75426318	75426631	MACS_peak_8920	453.55	313	0	0	0	intergen
17	75504212	75504542	MACS_peak_8921	928.77	330	1	0	0	promoter
17	75515679	75516087	MACS_peak_8922	616.76	408	1	0	0	promoter
17	75589107	75589347	MACS_peak_8923	502.51	240	1	0	0	promoter
17	75601149	75601558	MACS_peak_8924	486.59	409	0	1	0	gen
17	75625906	75626236	MACS_peak_8925	1642.21	330	1	1	0	promoter
17	75632955	75633204	MACS_peak_8926	1162.47	249	1	1	0	promoter
17	75633794	75634087	MACS_peak_8927	828.97	293	1	1	0	promoter
17	75653031	75653250	MACS_peak_8928	528	219	0	1	0	gen
17	75674928	75675209	MACS_peak_8929	460.95	281	0	1	0	gen
17	75747855	75748140	MACS_peak_8930	462.15	285	1	1	0	promoter
17	75749772	75750250	MACS_peak_8931	684.54	478	1	1	0	promoter
17	75778977	75779166	MACS_peak_8932	616.5	189	1	0	0	promoter
17	75783440	75783688	MACS_peak_8933	1399.91	248	1	1	0	promoter
17	75792110	75792406	MACS_peak_8934	810.4	296	0	1	0	gen
17	76062424	76062732	MACS_peak_8935	1576.26	308	0	1	0	gen
17	76398044	76398364	MACS_peak_8936	550.56	320	0	1	0	gen
17	76547267	76547647	MACS_peak_8937	380.3	380	0	2	1	gen
17	76681313	76681590	MACS_peak_8938	1125.73	277	0	1	0	gen
17	76935711	76935974	MACS_peak_8939	591.18	263	0	1	0	gen
17	77011142	77011457	MACS_peak_8940	434.29	315	0	0	0	intergen
17	77066871	77067066	MACS_peak_8941	639.26	195	0	0	0	intergen
17	77912113	77912416	MACS_peak_8942	161.03	303	0	0	0	intergen
17	78013860	78014212	MACS_peak_8943	415.24	352	0	1	0	gen
17	78019424	78019636	MACS_peak_8944	936.57	212	0	1	0	gen
17	78084973	78085302	MACS_peak_8945	796.97	329	0	1	0	gen
17	78250923	78251290	MACS_peak_8946	766.87	367	0	0	2	other
17	78289703	78290050	MACS_peak_8947	380.3	347	0	0	0	intergen
17	78422051	78422433	MACS_peak_8948	388.11	382	1	1	0	promoter
17	78479929	78480150	MACS_peak_8949	1441.15	221	0	1	0	gen
17	78745455	78745693	MACS_peak_8950	662.31	238	0	1	0	gen
17	78971353	78971527	MACS_peak_8951	1415.25	174	1	0	0	promoter
17	79019599	79019939	MACS_peak_8952	380.3	340	1	0	1	promoter
17	79065271	79065447	MACS_peak_8953	743.63	176	0	0	0	intergen
17	79401162	79401411	MACS_peak_8954	485.56	249	0	1	0	gen
17	79741957	79742202	MACS_peak_8955	780.06	245	0	1	0	gen
17	79960595	79960814	MACS_peak_8956	901.33	219	0	1	0	gen
17	79991744	79991938	MACS_peak_8957	678.9	194	0	1	0	gen
17	80005783	80006062	MACS_peak_8958	455.19	279	0	1	0	gen
17	80307659	80307979	MACS_peak_8959	439.97	320	0	1	0	gen
17	80467122	80467256	MACS_peak_8960	1666.76	134	1	0	0	promoter
17	80548071	80548414	MACS_peak_8961	419.68	343	1	0	0	promoter
17	80575402	80575594	MACS_peak_8962	866.35	192	0	1	0	gen
17	80672259	80672489	MACS_peak_8963	429.38	230	0	1	0	gen
17	80740639	80740937	MACS_peak_8964	960.47	298	0	1	0	gen
17	81101820	81102026	MACS_peak_8965	1153.04	206	0	1	0	gen
17	81200911	81201149	MACS_peak_8966	516.86	238	0	1	0	gen
17	81484282	81484627	MACS_peak_8967	418.68	345	0	0	0	intergen
17	81675927	81676165	MACS_peak_8968	468.86	238	0	0	0	intergen
17	81821830	81822006	MACS_peak_8969	763.02	176	1	0	0	promoter
17	82021198	82021436	MACS_peak_8970	662.31	238	2	0	0	promoter
17	82424497	82424939	MACS_peak_8971	964.62	442	0	1	0	gen
17	82551819	82552087	MACS_peak_8972	442.05	268	0	1	0	gen
17	82777869	82778128	MACS_peak_8973	953.02	259	0	1	0	gen
17	82781811	82782005	MACS_peak_8974	1434.33	194	0	1	0	gen
17	82963262	82963485	MACS_peak_8975	564.54	223	0	1	0	gen
17	83228954	83229360	MACS_peak_8978	1054.11	406	0	0	1	other
17	83164619	83164874	MACS_peak_8987	729.14	255	0	0	1	other
18	39507	39802	MACS_peak_8988	108.87	295	0	0	0	intergen
18	171006	171251	MACS_peak_8991	629.38	245	0	1	0	gen
18	286445	286736	MACS_peak_8992	919.95	291	0	0	0	intergen
18	539833	540078	MACS_peak_8993	59.85	245	0	0	0	intergen
18	624124	624308	MACS_peak_8994	918.92	184	0	1	0	gen
18	730101	730397	MACS_peak_8995	438.73	296	0	1	0	gen
18	864852	865177	MACS_peak_8996	428.92	325	0	0	0	intergen
18	952275	952586	MACS_peak_8997	164.26	311	0	0	0	intergen
18	973213	973524	MACS_peak_8998	66.16	311	0	0	1	other
18	1102520	1102805	MACS_peak_8999	229.83	285	0	0	1	other
18	1145467	1145851	MACS_peak_9000	138.14	384	0	0	1	other
18	1196409	1196750	MACS_peak_9001	142.05	341	0	0	0	intergen
18	1354366	1354658	MACS_peak_9002	56.38	292	0	0	1	other
18	1519420	1519751	MACS_peak_9003	61.06	331	0	0	1	other
18	1641810	1642107	MACS_peak_9005	92.75	297	0	0	1	other
18	1642388	1642641	MACS_peak_9006	111.63	253	0	0	1	other
18	1642870	1643193	MACS_peak_9007	76.3	323	0	0	1	other
18	2251801	2252095	MACS_peak_9008	62.38	294	0	0	1	other
18	2541999	2542346	MACS_peak_9009	843.52	347	1	0	0	promoter
18	2692486	2692707	MACS_peak_9010	564.54	221	0	1	1	gen
18	3246135	3246338	MACS_peak_9011	814.37	203	1	0	1	promoter
18	3323000	3323211	MACS_peak_9012	543.04	211	0	0	1	other
18	3600657	3600981	MACS_peak_9013	429.45	324	0	1	0	gen
18	3602394	3602736	MACS_peak_9014	483.6	342	0	1	0	gen
18	3736707	3737173	MACS_peak_9015	50.57	466	0	1	0	gen
18	3738867	3739245	MACS_peak_9016	57.73	378	0	1	0	gen
18	3998866	3999113	MACS_peak_9017	485.56	247	0	1	1	gen
18	4233985	4234322	MACS_peak_9018	422.7	337	0	1	0	gen
18	5008413	5008799	MACS_peak_9019	84.11	386	0	0	0	intergen
18	5280974	5281379	MACS_peak_9020	147.82	405	0	0	0	intergen
18	5333776	5334233	MACS_peak_9022	70.09	457	0	0	0	intergen
18	5431010	5431244	MACS_peak_9023	532.66	234	0	1	0	gen
18	5566467	5566852	MACS_peak_9024	131.54	385	0	1	0	gen
18	5600417	5600690	MACS_peak_9025	458.95	273	0	1	0	gen
18	5972815	5973028	MACS_peak_9026	715.22	213	0	1	0	gen
18	6419581	6419895	MACS_peak_9027	83.3	314	0	0	0	intergen
18	6420037	6420225	MACS_peak_9028	367.54	188	0	0	0	intergen
18	6701985	6702367	MACS_peak_9029	63.6	382	0	0	0	intergen
18	7402525	7402975	MACS_peak_9030	67.95	450	0	0	0	intergen
18	7971078	7971426	MACS_peak_9031	71.4	348	0	1	0	gen
18	7971430	7971800	MACS_peak_9032	106.72	370	0	1	0	gen
18	8480567	8480855	MACS_peak_9033	833.73	288	0	0	0	intergen
18	8654543	8654810	MACS_peak_9034	406.81	267	0	0	0	intergen
18	9444029	9444251	MACS_peak_9035	712.32	222	0	0	0	intergen
18	9549383	9549770	MACS_peak_9036	511.42	387	1	0	0	promoter
18	9951360	9951542	MACS_peak_9037	729.14	182	0	1	0	gen
18	9978927	9979247	MACS_peak_9038	120.16	320	0	0	0	intergen
18	10652954	10653260	MACS_peak_9039	104.15	306	0	0	0	intergen
18	11059274	11059737	MACS_peak_9040	63.24	463	0	1	0	gen
18	11222654	11222851	MACS_peak_9041	662.31	197	0	0	0	intergen
18	11608963	11609337	MACS_peak_9042	93.4	374	1	0	0	promoter
18	11761695	11761906	MACS_peak_9044	763.02	211	0	1	0	gen
18	12135614	12135999	MACS_peak_9045	122.09	385	0	0	0	intergen
18	12184414	12184753	MACS_peak_9046	67.13	339	0	0	0	intergen
18	12186940	12187209	MACS_peak_9047	124.53	269	0	0	0	intergen
18	12203112	12203478	MACS_peak_9048	58.9	366	0	0	1	other
18	12333048	12333422	MACS_peak_9050	518.44	374	1	1	0	promoter
18	12391675	12391931	MACS_peak_9051	729.14	256	0	0	0	intergen
18	12827756	12828134	MACS_peak_9052	403.06	378	0	1	0	gen
18	13003452	13003657	MACS_peak_9053	797.18	205	0	1	0	gen
18	13031110	13031266	MACS_peak_9054	840.92	156	0	1	0	gen
18	13795201	13795457	MACS_peak_9055	79.5	256	0	0	0	intergen
18	13909503	13909763	MACS_peak_9056	467.38	260	0	1	0	gen
18	13976085	13976421	MACS_peak_9057	53.69	336	0	0	0	intergen
18	14003774	14004178	MACS_peak_9059	72.89	404	0	0	0	intergen
18	14395601	14395837	MACS_peak_9060	1036.74	236	0	0	0	intergen
18	14415886	14416065	MACS_peak_9061	746.04	179	0	0	0	intergen
18	14638113	14638293	MACS_peak_9062	746.04	180	0	0	0	intergen
18	14689180	14689573	MACS_peak_9063	967.93	393	0	0	0	intergen
18	14822866	14823020	MACS_peak_9064	987.58	154	0	1	1	gen
18	15028070	15028374	MACS_peak_9065	440.4	304	0	0	0	intergen
18	15175024	15175410	MACS_peak_9066	786.46	386	0	0	0	intergen
18	15175862	15176133	MACS_peak_9067	196.98	271	0	0	0	intergen
18	15178380	15178724	MACS_peak_9068	63.29	344	0	0	0	intergen
18	15189419	15189726	MACS_peak_9069	50.74	307	0	0	0	intergen
18	15285884	15286256	MACS_peak_9071	125.63	372	0	0	0	intergen
18	15367406	15367776	MACS_peak_9072	76.3	370	0	0	0	intergen
18	15393202	15393512	MACS_peak_9073	121.57	310	0	0	0	intergen
18	15395336	15395730	MACS_peak_9074	75.42	394	0	0	0	intergen
18	15404853	15405230	MACS_peak_9075	69.92	377	0	0	0	intergen
18	20958793	20959235	MACS_peak_9077	1094.3	442	0	1	0	gen
18	20972026	20972277	MACS_peak_9078	485.56	251	0	1	0	gen
18	21591605	21591991	MACS_peak_9079	89.02	386	0	1	0	gen
18	21738805	21738957	MACS_peak_9080	446.36	152	0	1	0	gen
18	21805889	21806031	MACS_peak_9081	877.38	142	0	1	0	gen
18	21884873	21885254	MACS_peak_9082	56.65	381	0	0	1	other
18	21914803	21915041	MACS_peak_9084	662.31	238	0	0	0	intergen
18	21987560	21987820	MACS_peak_9085	467.38	260	0	0	1	other
18	21997733	21998077	MACS_peak_9086	535.64	344	0	0	1	other
18	22351351	22351578	MACS_peak_9087	255.8	227	0	0	0	intergen
18	22529937	22530280	MACS_peak_9088	109.03	343	0	0	0	intergen
18	22535147	22535479	MACS_peak_9089	223.85	332	0	0	0	intergen
18	22665686	22666045	MACS_peak_9090	1246.17	359	0	0	0	intergen
18	22809089	22809417	MACS_peak_9091	86.33	328	0	1	2	gen
18	22811644	22811957	MACS_peak_9092	94.4	313	0	1	2	gen
18	22828442	22828698	MACS_peak_9093	127.5	256	0	1	2	gen
18	22864275	22864597	MACS_peak_9094	380.3	322	0	1	2	gen
18	22888324	22888714	MACS_peak_9095	118.92	390	0	1	2	gen
18	23083213	23083352	MACS_peak_9096	902.92	139	0	0	0	intergen
18	23248503	23248644	MACS_peak_9097	676.31	141	0	2	0	gen
18	23565733	23566021	MACS_peak_9098	681.96	288	0	1	0	gen
18	24176841	24177137	MACS_peak_9099	826.15	296	0	1	0	gen
18	24186905	24187039	MACS_peak_9100	877.68	134	0	1	0	gen
18	24315612	24315863	MACS_peak_9101	746.04	251	0	1	0	gen
18	24488996	24489222	MACS_peak_9102	548.55	226	0	0	0	intergen
18	24711979	24712158	MACS_peak_9103	71.47	179	0	0	0	intergen
18	25440092	25440331	MACS_peak_9104	516.86	239	0	0	0	intergen
18	25486673	25487105	MACS_peak_9105	114.19	432	0	0	0	intergen
18	25720200	25720538	MACS_peak_9106	125.63	338	0	0	0	intergen
18	25906447	25906580	MACS_peak_9107	1396.21	133	0	0	0	intergen
18	26393353	26393489	MACS_peak_9108	413.07	136	0	0	0	intergen
18	26816509	26816818	MACS_peak_9109	129.04	309	0	0	1	other
18	26848046	26848424	MACS_peak_9110	102.43	378	1	0	1	promoter
18	26963391	26963727	MACS_peak_9111	423.21	336	0	1	1	gen
18	27280423	27280817	MACS_peak_9112	68.83	394	0	0	0	intergen
18	27283070	27283465	MACS_peak_9114	85.21	395	0	0	0	intergen
18	27283686	27284034	MACS_peak_9115	57.84	348	0	0	0	intergen
18	27512772	27513150	MACS_peak_9117	56.7	378	0	0	1	other
18	27531555	27531964	MACS_peak_9118	248.85	409	0	0	1	other
18	27532007	27532327	MACS_peak_9119	55.02	320	0	0	1	other
18	27532424	27532775	MACS_peak_9120	146.18	351	0	0	1	other
18	27738227	27738576	MACS_peak_9121	81.8	349	0	0	0	intergen
18	27855311	27855781	MACS_peak_9124	702.98	470	0	0	0	intergen
18	28240883	28241148	MACS_peak_9126	154.99	265	0	0	0	intergen
18	28242484	28242937	MACS_peak_9127	50.87	453	0	0	0	intergen
18	28294827	28295232	MACS_peak_9128	114.31	405	0	0	0	intergen
18	28295505	28295874	MACS_peak_9129	64.92	369	0	0	0	intergen
18	28416727	28417027	MACS_peak_9130	110.4	300	0	0	0	intergen
18	29221047	29221430	MACS_peak_9131	246.29	383	0	0	0	intergen
18	29949073	29949445	MACS_peak_9135	55.09	372	0	0	0	intergen
18	30022297	30022713	MACS_peak_9136	121.39	416	0	0	0	intergen
18	30742042	30742286	MACS_peak_9139	398.3	244	0	0	0	intergen
18	30938228	30938520	MACS_peak_9141	447.34	292	0	0	0	intergen
18	31001466	31001677	MACS_peak_9142	591.86	211	0	1	0	gen
18	31506292	31506616	MACS_peak_9143	338.74	324	0	1	0	gen
18	32231239	32231600	MACS_peak_9144	63.13	361	0	1	0	gen
18	32399790	32400141	MACS_peak_9145	121.42	351	0	1	0	gen
18	32858695	32858911	MACS_peak_9146	62.26	216	0	0	1	other
18	32862055	32862280	MACS_peak_9147	170.15	225	0	0	1	other
18	32919805	32920146	MACS_peak_9148	420.68	341	0	0	1	other
18	33278659	33279054	MACS_peak_9149	105.65	395	0	1	0	gen
18	33839578	33839813	MACS_peak_9150	516.86	235	0	0	0	intergen
18	33861849	33862226	MACS_peak_9151	158.58	377	0	1	0	gen
18	34162273	34162573	MACS_peak_9153	117.17	300	0	1	0	gen
18	34322744	34323023	MACS_peak_9154	455.19	279	0	0	0	intergen
18	34333394	34333743	MACS_peak_9155	53.6	349	0	0	0	intergen
18	34668542	34668948	MACS_peak_9157	78.38	406	0	1	0	gen
18	34713929	34714188	MACS_peak_9158	55.64	259	0	1	0	gen
18	35033076	35033471	MACS_peak_9161	109.53	395	0	1	0	gen
18	35143863	35144252	MACS_peak_9162	467.82	389	0	0	0	intergen
18	35765106	35765547	MACS_peak_9164	94.4	441	0	0	0	intergen
18	36133793	36133929	MACS_peak_9165	753.52	136	1	0	0	promoter
18	36136822	36137145	MACS_peak_9166	845.32	323	0	1	0	gen
18	36238410	36238715	MACS_peak_9167	88.44	305	0	1	0	gen
18	36284795	36285037	MACS_peak_9168	645.81	242	0	0	0	intergen
18	36411590	36411931	MACS_peak_9169	420.68	341	0	1	0	gen
18	36463254	36463532	MACS_peak_9170	1106.44	278	0	1	0	gen
18	36553062	36553384	MACS_peak_9171	58.06	322	0	1	0	gen
18	37027744	37028126	MACS_peak_9172	76.3	382	0	1	0	gen
18	37053873	37054076	MACS_peak_9173	814.37	203	0	1	0	gen
18	37075318	37075727	MACS_peak_9174	69.67	409	0	1	0	gen
18	37076432	37076850	MACS_peak_9175	70.01	418	0	1	0	gen
18	37078545	37078821	MACS_peak_9176	125.63	276	0	1	0	gen
18	37215080	37215356	MACS_peak_9177	107.89	276	0	1	0	gen
18	37820032	37820398	MACS_peak_9178	61.12	366	0	0	0	intergen
18	37824877	37825143	MACS_peak_9179	74.87	266	0	0	0	intergen
18	37827440	37827902	MACS_peak_9180	75.42	462	0	0	0	intergen
18	39125178	39125539	MACS_peak_9182	60.35	361	0	0	0	intergen
18	39254314	39254663	MACS_peak_9184	129.98	349	0	0	1	other
18	39255338	39255570	MACS_peak_9185	131.91	232	0	0	1	other
18	39477116	39477415	MACS_peak_9186	953.02	299	0	0	1	other
18	39567089	39567486	MACS_peak_9187	57.73	397	0	0	1	other
18	39925474	39925900	MACS_peak_9188	79.6	426	0	0	0	intergen
18	39971031	39971420	MACS_peak_9189	628.19	389	0	0	0	intergen
18	39971567	39971956	MACS_peak_9190	1008.5	389	0	0	0	intergen
18	40192574	40192970	MACS_peak_9191	114.5	396	0	0	0	intergen
18	40845382	40845816	MACS_peak_9192	53	434	0	0	0	intergen
18	40872512	40872854	MACS_peak_9193	420.18	342	0	0	0	intergen
18	41348826	41349237	MACS_peak_9194	615.01	411	0	0	0	intergen
18	41349514	41349925	MACS_peak_9195	615.01	411	0	0	0	intergen
18	41577317	41577645	MACS_peak_9196	659.69	328	0	0	1	other
18	41637016	41637441	MACS_peak_9197	72.48	425	0	0	0	intergen
18	41780021	41780412	MACS_peak_9199	98.53	391	0	0	0	intergen
18	42542377	42542702	MACS_peak_9200	96.54	325	0	0	1	other
18	42596280	42596560	MACS_peak_9201	454.58	280	0	0	1	other
18	43216645	43216782	MACS_peak_9202	1162.25	137	0	0	0	intergen
18	43299498	43299860	MACS_peak_9203	77.98	362	0	0	0	intergen
18	43299872	43300234	MACS_peak_9204	124.34	362	0	0	0	intergen
18	43324036	43324496	MACS_peak_9205	67.89	460	0	0	0	intergen
18	43325291	43325648	MACS_peak_9206	55.2	357	0	0	0	intergen
18	43697104	43697325	MACS_peak_9207	432.48	221	0	0	0	intergen
18	43918107	43918509	MACS_peak_9208	186.44	402	0	0	0	intergen
18	45028200	45028575	MACS_peak_9212	245.03	375	0	1	0	gen
18	45225951	45226261	MACS_peak_9213	82.21	310	0	1	0	gen
18	45532875	45533272	MACS_peak_9214	91.37	397	0	1	1	gen
18	45796718	45797073	MACS_peak_9215	50.04	355	0	0	0	intergen
18	45797292	45797702	MACS_peak_9216	159.7	410	0	0	0	intergen
18	45839350	45839746	MACS_peak_9217	506.71	396	0	1	0	gen
18	45910457	45910796	MACS_peak_9218	421.69	339	0	1	0	gen
18	45974858	45975065	MACS_peak_9219	423.24	207	0	0	0	intergen
18	46044462	46044714	MACS_peak_9220	108.7	252	0	1	0	gen
18	46044785	46045195	MACS_peak_9221	85.66	410	0	1	0	gen
18	46081430	46081785	MACS_peak_9222	269.22	355	1	0	0	promoter
18	46195469	46195694	MACS_peak_9223	346.64	225	0	1	0	gen
18	47205000	47205255	MACS_peak_9224	470.06	255	1	0	0	promoter
18	47349802	47350140	MACS_peak_9225	74.71	338	0	0	1	other
18	47642888	47643314	MACS_peak_9228	203.24	426	0	0	0	intergen
18	47684699	47685057	MACS_peak_9230	903.5	358	0	0	0	intergen
18	48651980	48652298	MACS_peak_9232	142.05	318	0	1	0	gen
18	48891442	48891699	MACS_peak_9233	265.34	257	0	0	0	intergen
18	48983265	48983398	MACS_peak_9234	1396.21	133	0	0	0	intergen
18	49219087	49219423	MACS_peak_9236	57.49	336	0	1	0	gen
18	49292572	49292955	MACS_peak_9238	678.93	383	0	1	0	gen
18	49447902	49448114	MACS_peak_9240	596.79	212	0	1	0	gen
18	49720129	49720504	MACS_peak_9241	88.77	375	0	0	0	intergen
18	50043267	50043674	MACS_peak_9243	584.98	407	0	1	0	gen
18	51173818	51173950	MACS_peak_9245	1116.4	132	1	0	0	promoter
18	51360475	51360840	MACS_peak_9246	178.37	365	0	0	1	other
18	51384650	51384924	MACS_peak_9247	534.92	274	0	0	1	other
18	51969975	51970260	MACS_peak_9248	122.91	285	0	0	0	intergen
18	52272110	52272524	MACS_peak_9249	613.27	414	0	0	0	intergen
18	52288510	52288714	MACS_peak_9250	629.38	204	0	0	1	other
18	52962076	52962432	MACS_peak_9251	123.02	356	0	1	0	gen
18	52962541	52962830	MACS_peak_9252	105.65	289	0	1	0	gen
18	53176105	53176489	MACS_peak_9253	72.78	384	0	1	0	gen
18	53512440	53512761	MACS_peak_9255	89.2	321	0	1	1	gen
18	54346042	54346385	MACS_peak_9256	329.23	343	0	1	0	gen
18	54444278	54444624	MACS_peak_9257	534.45	346	0	0	0	intergen
18	54559142	54559299	MACS_peak_9258	883.81	157	0	0	0	intergen
18	54728799	54729012	MACS_peak_9259	671.02	213	0	1	0	gen
18	54769673	54769884	MACS_peak_9260	596.79	211	0	1	0	gen
18	55046532	55046762	MACS_peak_9261	1491.86	230	0	0	0	intergen
18	55215620	55215782	MACS_peak_9262	793.81	162	0	0	0	intergen
18	55621382	55621729	MACS_peak_9263	972.38	347	0	1	0	gen
18	55889776	55890206	MACS_peak_9264	66.96	430	0	0	1	other
18	56526018	56526292	MACS_peak_9265	142.05	274	0	0	0	intergen
18	56530804	56531154	MACS_peak_9266	104.52	350	0	0	0	intergen
18	56716026	56716162	MACS_peak_9267	1061.85	136	0	1	0	gen
18	56869131	56869444	MACS_peak_9268	435.38	313	0	1	0	gen
18	57264332	57264623	MACS_peak_9269	98.15	291	0	0	0	intergen
18	57264703	57265076	MACS_peak_9270	71.35	373	0	0	0	intergen
18	57721664	57722031	MACS_peak_9271	84.48	367	0	1	1	gen
18	57723292	57723603	MACS_peak_9272	72.19	311	0	1	1	gen
18	58262435	58262651	MACS_peak_9273	746.04	216	0	1	0	gen
18	59115721	59116184	MACS_peak_9274	181.92	463	0	0	0	intergen
18	59117675	59117988	MACS_peak_9275	69	313	0	0	0	intergen
18	59996413	59996718	MACS_peak_9276	439.84	305	0	0	0	intergen
18	60032628	60033040	MACS_peak_9277	51.01	412	0	0	0	intergen
18	60035046	60035261	MACS_peak_9278	231.27	215	0	0	0	intergen
18	60304482	60304809	MACS_peak_9279	93.4	327	0	0	0	intergen
18	60523379	60523759	MACS_peak_9280	57.18	380	0	0	1	other
18	60684932	60685122	MACS_peak_9282	695.57	190	0	0	1	other
18	60767802	60768047	MACS_peak_9283	501.16	245	0	0	1	other
18	61052021	61052264	MACS_peak_9285	214.81	243	0	0	0	intergen
18	61088786	61089006	MACS_peak_9286	564.54	220	0	0	0	intergen
18	61145177	61145544	MACS_peak_9287	102.28	367	0	0	0	intergen
18	61716643	61717054	MACS_peak_9288	64.17	411	0	0	1	other
18	62052374	62052713	MACS_peak_9290	220.21	339	0	1	0	gen
18	62183627	62183927	MACS_peak_9291	1387.53	300	1	1	0	promoter
18	62584353	62584612	MACS_peak_9292	468.05	259	0	1	0	gen
18	62911236	62911681	MACS_peak_9295	87.54	445	0	1	0	gen
18	62911864	62912091	MACS_peak_9296	164.16	227	0	1	0	gen
18	63063499	63063840	MACS_peak_9297	733.8	341	0	0	0	intergen
18	63864566	63864861	MACS_peak_9298	75.96	295	0	0	0	intergen
18	63865025	63865361	MACS_peak_9299	59.47	336	0	0	0	intergen
18	63973318	63973698	MACS_peak_9301	113.19	380	1	1	0	promoter
18	64227349	64227697	MACS_peak_9302	68.94	348	0	0	2	other
18	64289609	64289963	MACS_peak_9303	83.04	354	0	0	1	other
18	64575487	64575813	MACS_peak_9304	75.01	326	0	0	0	intergen
18	64880238	64880500	MACS_peak_9305	97.52	262	0	0	0	intergen
18	65296053	65296326	MACS_peak_9306	82.87	273	0	0	0	intergen
18	65722405	65722663	MACS_peak_9307	468.72	258	0	0	0	intergen
18	65780429	65780793	MACS_peak_9308	79.76	364	0	1	0	gen
18	65866025	65866434	MACS_peak_9309	137.06	409	0	1	0	gen
18	66162953	66163256	MACS_peak_9311	219.35	303	0	0	0	intergen
18	66705353	66705671	MACS_peak_9312	432.66	318	0	0	0	intergen
18	66717444	66717719	MACS_peak_9313	50.92	275	0	0	0	intergen
18	66718024	66718288	MACS_peak_9314	91.52	264	0	0	0	intergen
18	66937051	66937329	MACS_peak_9315	114.74	278	0	0	0	intergen
18	67687964	67688256	MACS_peak_9316	127.5	292	0	0	1	other
18	68209989	68210379	MACS_peak_9317	556.94	390	0	0	0	intergen
18	68227225	68227662	MACS_peak_9318	58.14	437	0	0	0	intergen
18	68856948	68857427	MACS_peak_9319	996.54	479	0	1	0	gen
18	68859499	68859925	MACS_peak_9320	72.18	426	0	1	0	gen
18	69471149	69471385	MACS_peak_9323	655.71	236	0	1	1	gen
18	69548914	69549219	MACS_peak_9324	426.57	305	0	1	1	gen
18	69712277	69712418	MACS_peak_9325	543.1	141	0	1	1	gen
18	70460811	70461175	MACS_peak_9326	380.3	364	0	0	0	intergen
18	70668410	70668747	MACS_peak_9327	147.82	337	0	0	0	intergen
18	70719535	70719805	MACS_peak_9329	158.81	270	0	0	0	intergen
18	70800954	70801179	MACS_peak_9330	298.92	225	0	0	0	intergen
18	71344823	71344968	MACS_peak_9331	304.52	145	0	0	0	intergen
18	71657489	71657712	MACS_peak_9332	144.09	223	0	0	0	intergen
18	72970266	72970667	MACS_peak_9333	52.66	401	0	0	0	intergen
18	73628705	73629045	MACS_peak_9334	66.81	340	0	0	0	intergen
18	73842775	73843251	MACS_peak_9335	1066.34	476	0	0	0	intergen
18	74196496	74196824	MACS_peak_9336	427.34	328	0	0	0	intergen
18	74751826	74752169	MACS_peak_9337	149.97	343	0	1	0	gen
18	75592835	75593052	MACS_peak_9338	901.33	217	0	0	0	intergen
18	75909400	75909548	MACS_peak_9339	522.42	148	0	0	0	intergen
18	76508367	76508791	MACS_peak_9340	727.24	424	0	0	0	intergen
18	76763114	76763260	MACS_peak_9341	1084.72	146	0	0	0	intergen
18	77545413	77545805	MACS_peak_9342	508.79	392	0	0	1	other
18	77579895	77580227	MACS_peak_9343	253.14	332	0	0	0	intergen
18	77650883	77651119	MACS_peak_9344	516.86	236	0	0	0	intergen
18	78875615	78875812	MACS_peak_9345	662.31	197	0	0	0	intergen
18	79287494	79287786	MACS_peak_9346	62.38	292	0	1	0	gen
18	79287817	79288155	MACS_peak_9347	57.94	338	0	1	0	gen
19	116032	116353	MACS_peak_9350	143.16	321	0	1	0	gen
19	116389	116770	MACS_peak_9351	56.91	381	0	1	0	gen
19	137719	137982	MACS_peak_9352	238.44	263	0	0	0	intergen
19	155070	155466	MACS_peak_9354	839.74	396	0	0	0	intergen
19	180558	180896	MACS_peak_9355	127.9	338	0	0	0	intergen
19	182841	183287	MACS_peak_9356	430.53	446	0	0	0	intergen
19	202156	202393	MACS_peak_9357	799.32	237	0	0	1	other
19	205570	205807	MACS_peak_9358	927.21	237	0	0	1	other
19	240919	241288	MACS_peak_9359	263.74	369	0	0	0	intergen
19	267440	267630	MACS_peak_9360	695.57	190	0	0	0	intergen
19	1194579	1194950	MACS_peak_9361	262.11	371	0	1	0	gen
19	1448438	1448669	MACS_peak_9362	414.64	231	1	0	0	promoter
19	1795821	1796024	MACS_peak_9363	629.38	203	0	1	0	gen
19	1813030	1813193	MACS_peak_9364	848.95	163	1	0	0	promoter
19	2872260	2872581	MACS_peak_9365	756.52	321	0	0	0	intergen
19	2950951	2951235	MACS_peak_9366	438.82	284	0	0	0	intergen
19	3021062	3021224	MACS_peak_9367	270.22	162	0	1	0	gen
19	3545169	3545442	MACS_peak_9368	458.95	273	0	1	1	gen
19	3987879	3988062	MACS_peak_9369	1477.14	183	0	0	0	intergen
19	4139799	4140122	MACS_peak_9370	385.64	323	0	0	0	intergen
19	4167608	4167812	MACS_peak_9371	562.91	204	0	1	0	gen
19	4208737	4209093	MACS_peak_9372	413.31	356	0	1	0	gen
19	4352504	4352913	MACS_peak_9373	616.18	409	0	1	1	gen
19	4463874	4464102	MACS_peak_9374	463.07	228	0	0	1	other
19	4558490	4558738	MACS_peak_9375	613.04	248	0	1	0	gen
19	5084363	5084614	MACS_peak_9376	746.04	251	0	1	0	gen
19	5873031	5873374	MACS_peak_9377	419.68	343	0	1	0	gen
19	6354195	6354516	MACS_peak_9378	368	321	0	0	1	other
19	6488776	6489055	MACS_peak_9379	441.88	279	0	0	0	intergen
19	7053603	7053872	MACS_peak_9381	461.5	269	2	0	0	promoter
19	7054220	7054601	MACS_peak_9382	514.63	381	1	0	0	promoter
19	7062771	7063177	MACS_peak_9384	617.94	406	0	0	0	intergen
19	7547709	7547854	MACS_peak_9385	768.94	145	0	1	0	gen
19	8058348	8058681	MACS_peak_9386	424.75	333	0	1	0	gen
19	8180575	8180924	MACS_peak_9387	376.7	349	0	0	0	intergen
19	8268521	8268768	MACS_peak_9388	335.73	247	0	0	0	intergen
19	8580741	8581033	MACS_peak_9389	402.82	292	1	0	0	promoter
19	8820607	8820871	MACS_peak_9390	603.02	264	0	1	0	gen
19	9401232	9401614	MACS_peak_9391	170.04	382	0	0	1	other
19	9435520	9435819	MACS_peak_9392	564.59	299	0	0	0	intergen
19	10000237	10000504	MACS_peak_9393	843.52	267	0	1	0	gen
19	10099569	10099952	MACS_peak_9394	180.64	383	0	1	0	gen
19	10269475	10269696	MACS_peak_9395	820.41	221	1	0	1	promoter
19	10297598	10297730	MACS_peak_9396	932.35	132	0	0	0	intergen
19	10388884	10389170	MACS_peak_9397	450.92	286	1	0	0	promoter
19	10404195	10404569	MACS_peak_9398	404.88	374	0	1	0	gen
19	10413596	10413847	MACS_peak_9399	272.3	251	1	1	0	promoter
19	10510193	10510408	MACS_peak_9400	596.79	215	1	0	0	promoter
19	10551698	10551831	MACS_peak_9401	1396.21	133	1	1	0	promoter
19	10581053	10581363	MACS_peak_9402	803.33	310	0	1	0	gen
19	10676095	10676391	MACS_peak_9403	476.21	296	0	1	0	gen
19	10936761	10936993	MACS_peak_9404	633.59	232	0	0	0	intergen
19	11203959	11204133	MACS_peak_9405	780.06	174	1	0	1	promoter
19	11293782	11293992	MACS_peak_9406	760.34	210	1	0	0	promoter
19	11700192	11700428	MACS_peak_9407	662.31	236	0	0	0	intergen
19	11939141	11939451	MACS_peak_9408	102.5	310	0	2	0	gen
19	11954888	11955116	MACS_peak_9409	304.09	228	0	1	0	gen
19	12394068	12394276	MACS_peak_9410	613.04	208	2	1	0	promoter
19	12493695	12494040	MACS_peak_9411	84.4	345	0	2	0	gen
19	12532287	12532664	MACS_peak_9412	340	377	0	3	1	gen
19	12676353	12676635	MACS_peak_9413	453.35	282	1	1	0	promoter
19	12711818	12712261	MACS_peak_9414	1539.37	443	0	1	0	gen
19	12717027	12717293	MACS_peak_9415	452.25	266	0	1	0	gen
19	12796642	12797039	MACS_peak_9416	871.49	397	1	1	0	promoter
19	12885395	12885740	MACS_peak_9417	418.68	345	1	0	0	promoter
19	13206842	13206977	MACS_peak_9418	925.76	135	1	0	0	promoter
19	13234342	13234484	MACS_peak_9419	1642.4	142	0	1	0	gen
19	13299827	13300059	MACS_peak_9420	532.66	232	0	1	0	gen
19	13832127	13832264	MACS_peak_9421	1309.25	137	0	0	1	other
19	13862373	13862664	MACS_peak_9422	447.93	291	1	0	0	promoter
19	13880190	13880413	MACS_peak_9423	564.54	223	1	1	0	promoter
19	13903223	13903435	MACS_peak_9424	593.6	212	1	1	0	promoter
19	14067116	14067549	MACS_peak_9425	579.39	433	0	0	0	intergen
19	14196077	14196404	MACS_peak_9426	427.87	327	0	1	0	gen
19	14214883	14215218	MACS_peak_9427	476.21	335	0	0	0	intergen
19	14888933	14889227	MACS_peak_9429	695.63	294	0	0	0	intergen
19	15091854	15092213	MACS_peak_9430	861.24	359	0	1	0	gen
19	15150506	15150707	MACS_peak_9431	628.77	201	0	0	0	intergen
19	15264161	15264409	MACS_peak_9432	901.33	248	0	1	0	gen
19	15278366	15278681	MACS_peak_9433	312.33	315	0	1	0	gen
19	15302654	15302801	MACS_peak_9434	1836.32	147	0	1	0	gen
19	15419199	15419447	MACS_peak_9435	613.04	248	1	0	0	promoter
19	15492035	15492312	MACS_peak_9436	95.53	277	0	1	0	gen
19	15714288	15714635	MACS_peak_9437	165.6	347	0	0	0	intergen
19	15812134	15812422	MACS_peak_9438	971.09	288	0	1	0	gen
19	16182628	16183097	MACS_peak_9439	454.75	469	1	0	0	promoter
19	16714749	16714999	MACS_peak_9440	482.84	250	0	0	0	intergen
19	16739316	16739459	MACS_peak_9441	463.04	143	0	1	0	gen
19	16771662	16771851	MACS_peak_9442	1079.97	189	0	1	0	gen
19	17052568	17052737	MACS_peak_9443	814.37	169	1	0	1	promoter
19	17067522	17067729	MACS_peak_9444	941.49	207	0	1	0	gen
19	17407915	17408168	MACS_peak_9445	263.44	253	1	0	1	promoter
19	17775425	17775676	MACS_peak_9446	485.56	251	0	1	0	gen
19	17870275	17870520	MACS_peak_9447	573.39	245	1	0	0	promoter
19	18006913	18007209	MACS_peak_9448	386.87	296	0	1	0	gen
19	18113021	18113332	MACS_peak_9449	556.45	311	0	1	0	gen
19	18226496	18226630	MACS_peak_9450	1666.76	134	0	2	0	gen
19	18279491	18279773	MACS_peak_9451	705.71	282	1	0	0	promoter
19	18349595	18349834	MACS_peak_9452	777.13	239	0	1	0	gen
19	18847226	18847522	MACS_peak_9453	445	296	0	1	0	gen
19	19139665	19139947	MACS_peak_9454	576.71	282	0	0	0	intergen
19	19342746	19343074	MACS_peak_9455	545.46	328	0	1	0	gen
19	19366920	19367138	MACS_peak_9456	862.64	218	0	0	0	intergen
19	19724567	19724922	MACS_peak_9458	71.69	355	0	1	0	gen
19	19737141	19737281	MACS_peak_9459	1025.76	140	0	0	0	intergen
19	19869659	19869792	MACS_peak_9460	877.68	133	1	0	0	promoter
19	19919832	19920135	MACS_peak_9461	60.7	303	0	1	0	gen
19	19920989	19921210	MACS_peak_9462	140.69	221	0	1	0	gen
19	19959365	19959586	MACS_peak_9463	492.22	221	0	1	0	gen
19	20229785	20230134	MACS_peak_9464	62.38	349	0	0	1	other
19	20628016	20628236	MACS_peak_9465	227.1	220	0	1	1	gen
19	20813126	20813544	MACS_peak_9466	142.89	418	0	0	0	intergen
19	20822668	20823097	MACS_peak_9467	702.91	429	0	0	0	intergen
19	20893220	20893552	MACS_peak_9468	202.06	332	0	0	0	intergen
19	21078096	21078318	MACS_peak_9470	488.66	222	1	0	0	promoter
19	21718560	21718692	MACS_peak_9471	963	132	1	0	0	promoter
19	21722547	21722840	MACS_peak_9472	132.1	293	1	0	0	promoter
19	21872257	21872433	MACS_peak_9473	1627.6	176	0	0	0	intergen
19	22001793	22002017	MACS_peak_9474	398.38	224	0	1	0	gen
19	22476433	22476775	MACS_peak_9475	380.3	342	0	1	0	gen
19	23265439	23265744	MACS_peak_9476	201.59	305	0	1	2	gen
19	23266200	23266343	MACS_peak_9477	1619.65	143	0	1	2	gen
19	23289353	23289672	MACS_peak_9478	229.83	319	0	0	0	intergen
19	23362291	23362544	MACS_peak_9479	378.3	253	0	1	0	gen
19	23430800	23431114	MACS_peak_9480	100.87	314	0	0	0	intergen
19	24014315	24014633	MACS_peak_9482	252.15	318	0	0	0	intergen
19	24114721	24115194	MACS_peak_9483	134.63	473	0	1	0	gen
19	24198789	24199127	MACS_peak_9484	101.68	338	0	0	0	intergen
19	24235048	24235383	MACS_peak_9485	142.05	335	0	0	0	intergen
19	24343260	24343505	MACS_peak_9486	354.81	245	0	0	0	intergen
19	24396088	24396470	MACS_peak_9487	98.75	382	0	0	0	intergen
19	24412378	24412755	MACS_peak_9490	152.74	377	0	0	0	intergen
19	24436929	24437398	MACS_peak_9491	76.29	469	0	0	0	intergen
19	27258579	27258871	MACS_peak_9494	79.84	292	0	0	0	intergen
19	27260294	27260677	MACS_peak_9495	101.19	383	0	0	0	intergen
19	27265550	27265789	MACS_peak_9496	68.64	239	0	0	0	intergen
19	27277461	27277746	MACS_peak_9498	76.59	285	0	0	0	intergen
19	27280012	27280259	MACS_peak_9499	135.91	247	0	0	0	intergen
19	27290696	27290918	MACS_peak_9500	273.89	222	0	0	0	intergen
19	27305043	27305335	MACS_peak_9502	59.19	292	0	0	0	intergen
19	27305537	27305908	MACS_peak_9503	148.8	371	0	0	0	intergen
19	27308683	27309025	MACS_peak_9504	59.66	342	0	0	0	intergen
19	27310610	27310987	MACS_peak_9505	79.52	377	0	0	0	intergen
19	27311724	27311935	MACS_peak_9506	170.1	211	0	0	0	intergen
19	27323322	27323595	MACS_peak_9507	68.83	273	0	0	0	intergen
19	27330777	27330973	MACS_peak_9508	205.28	196	0	0	0	intergen
19	27340140	27340592	MACS_peak_9509	170.04	452	0	0	0	intergen
19	27340872	27341275	MACS_peak_9510	118	403	0	0	0	intergen
19	27342181	27342659	MACS_peak_9511	139.27	478	0	0	0	intergen
19	27346088	27346479	MACS_peak_9512	177.51	391	0	0	0	intergen
19	27379253	27379659	MACS_peak_9513	184.91	406	0	0	0	intergen
19	27397439	27397694	MACS_peak_9514	60.3	255	0	0	0	intergen
19	27427892	27428265	MACS_peak_9516	108.22	373	0	0	0	intergen
19	27496945	27497218	MACS_peak_9517	349.84	273	0	0	0	intergen
19	27597217	27597558	MACS_peak_9518	115.8	341	0	0	0	intergen
19	27605455	27605734	MACS_peak_9519	380.3	279	0	0	0	intergen
19	27974070	27974272	MACS_peak_9521	989.9	202	0	0	2	other
19	28179978	28180250	MACS_peak_9522	216.6	272	0	0	0	intergen
19	28180552	28180931	MACS_peak_9523	74.45	379	0	0	0	intergen
19	28182684	28182930	MACS_peak_9524	93.49	246	0	0	0	intergen
19	28433507	28433771	MACS_peak_9525	229.83	264	0	0	0	intergen
19	28466141	28466403	MACS_peak_9526	1754.09	262	0	0	2	other
19	28633792	28634048	MACS_peak_9527	470.06	256	0	0	2	other
19	28678952	28679209	MACS_peak_9528	191.2	257	0	0	1	other
19	28689735	28690110	MACS_peak_9529	142.05	375	0	0	2	other
19	28768556	28768932	MACS_peak_9530	78.93	376	0	0	0	intergen
19	29084326	29084560	MACS_peak_9531	532.66	234	0	0	0	intergen
19	29230885	29231272	MACS_peak_9532	114.96	387	0	0	0	intergen
19	29459779	29460196	MACS_peak_9533	144.9	417	0	0	1	other
19	29464762	29465085	MACS_peak_9534	100.58	323	0	0	1	other
19	29467883	29468187	MACS_peak_9535	239.18	304	0	0	1	other
19	29472460	29472846	MACS_peak_9536	488.85	386	0	0	1	other
19	29597370	29597554	MACS_peak_9537	918.92	184	0	0	0	intergen
19	30188672	30188924	MACS_peak_9539	97.84	252	0	0	0	intergen
19	30650120	30650426	MACS_peak_9540	559.8	306	0	1	0	gen
19	30666310	30666627	MACS_peak_9541	433.2	317	0	1	1	gen
19	30683039	30683265	MACS_peak_9542	848.95	226	0	1	0	gen
19	30769826	30770110	MACS_peak_9543	142.05	284	0	0	0	intergen
19	30770367	30770591	MACS_peak_9544	171.03	224	0	0	0	intergen
19	31653532	31653904	MACS_peak_9545	65.49	372	0	0	0	intergen
19	31932644	31932857	MACS_peak_9546	484	213	0	0	1	other
19	32347520	32347652	MACS_peak_9547	1116.4	132	1	0	0	promoter
19	32377223	32377434	MACS_peak_9548	711.6	211	0	1	0	gen
19	32464213	32464468	MACS_peak_9549	1080.52	255	0	1	0	gen
19	32570292	32570648	MACS_peak_9551	673.97	356	0	0	0	intergen
19	33302507	33302854	MACS_peak_9552	417.69	347	1	0	0	promoter
19	33406936	33407178	MACS_peak_9553	936.57	242	0	1	0	gen
19	33900727	33900863	MACS_peak_9554	1061.85	136	0	0	0	intergen
19	34078541	34078931	MACS_peak_9555	89.02	390	0	0	0	intergen
19	34336934	34337118	MACS_peak_9556	1320.51	184	0	1	0	gen
19	34501484	34501831	MACS_peak_9557	417.69	347	0	1	0	gen
19	34616180	34616611	MACS_peak_9558	114.31	431	0	1	0	gen
19	34701839	34702212	MACS_peak_9559	66.19	373	0	0	0	intergen
19	34861723	34862103	MACS_peak_9560	55.09	380	0	0	0	intergen
19	35510351	35510660	MACS_peak_9561	437.6	309	0	1	0	gen
19	35572642	35573028	MACS_peak_9562	439.97	386	0	0	1	other
19	35597189	35597330	MACS_peak_9563	354.32	141	0	0	0	intergen
19	36378771	36379021	MACS_peak_9564	485.56	250	1	1	0	promoter
19	36736399	36736678	MACS_peak_9565	281.19	279	0	1	0	gen
19	37021808	37021971	MACS_peak_9566	772.28	163	0	1	0	gen
19	37120130	37120571	MACS_peak_9567	129.96	441	0	3	0	gen
19	37288757	37289093	MACS_peak_9568	81.77	336	0	0	0	intergen
19	37293872	37294144	MACS_peak_9569	103.79	272	0	0	0	intergen
19	37722113	37722375	MACS_peak_9570	1536.61	262	0	0	0	intergen
19	37840753	37841182	MACS_peak_9572	68.06	429	0	0	1	other
19	38243448	38243595	MACS_peak_9574	1578.74	147	1	0	0	promoter
19	38243880	38244075	MACS_peak_9575	1402.54	195	1	0	0	promoter
19	38884097	38884399	MACS_peak_9577	311.23	302	0	1	0	gen
19	38930301	38930545	MACS_peak_9578	629.38	244	1	2	0	promoter
19	39000281	39000534	MACS_peak_9579	596.79	253	0	1	0	gen
19	39443973	39444314	MACS_peak_9580	216.22	341	0	1	0	gen
19	39627766	39628106	MACS_peak_9581	276.21	340	0	0	0	intergen
19	39766792	39767029	MACS_peak_9582	1509.93	237	0	0	0	intergen
19	39881548	39881855	MACS_peak_9583	685.18	307	0	1	0	gen
19	40099779	40100248	MACS_peak_9585	101.68	469	0	0	0	intergen
19	40662814	40663233	MACS_peak_9586	982.96	419	1	0	0	promoter
19	40819747	40820052	MACS_peak_9587	953.25	305	0	1	1	gen
19	40933490	40933679	MACS_peak_9588	695.57	189	0	0	1	other
19	40974509	40974892	MACS_peak_9589	631.92	383	0	0	0	intergen
19	40998904	40999342	MACS_peak_9590	104.86	438	0	1	0	gen
19	41124149	41124301	MACS_peak_9591	521.97	152	0	1	0	gen
19	41126713	41127053	MACS_peak_9592	1193.69	340	0	1	0	gen
19	41144535	41144735	MACS_peak_9593	927.02	200	0	0	0	intergen
19	41154068	41154293	MACS_peak_9594	515.03	225	0	0	0	intergen
19	41449412	41449703	MACS_peak_9595	447.93	291	0	0	0	intergen
19	41489029	41489359	MACS_peak_9596	122.66	330	0	0	1	other
19	41597661	41597867	MACS_peak_9597	629.38	206	0	0	0	intergen
19	41646557	41646932	MACS_peak_9598	517.89	375	0	0	0	intergen
19	41821204	41821522	MACS_peak_9599	527.85	318	0	0	0	intergen
19	42081640	42081912	MACS_peak_9600	584.2	272	1	0	0	promoter
19	42438440	42438698	MACS_peak_9601	687.21	258	0	1	1	gen
19	42563412	42563681	MACS_peak_9602	717.14	269	0	0	1	other
19	42693761	42694207	MACS_peak_9603	713.39	446	0	0	0	intergen
19	42769733	42770187	MACS_peak_9604	140.34	454	0	1	0	gen
19	42810025	42810355	MACS_peak_9607	149.63	330	0	1	0	gen
19	42885058	42885361	MACS_peak_9608	561.84	303	0	0	0	intergen
19	43084347	43084538	MACS_peak_9609	1061.85	191	0	0	1	other
19	43207295	43207678	MACS_peak_9610	400.82	383	1	0	0	promoter
19	43745317	43745587	MACS_peak_9613	585.73	270	0	1	0	gen
19	43865920	43866352	MACS_peak_9614	71.2	432	0	0	0	intergen
19	43946447	43946702	MACS_peak_9615	349.08	255	1	0	0	promoter
19	44095210	44095482	MACS_peak_9616	584.2	272	1	0	0	promoter
19	44224816	44225123	MACS_peak_9617	129.01	307	1	1	0	promoter
19	44409225	44409677	MACS_peak_9618	694.93	452	0	0	1	other
19	44415352	44415722	MACS_peak_9619	383.44	370	1	0	1	promoter
19	44459007	44459315	MACS_peak_9620	400.54	308	0	0	0	intergen
19	44667525	44667833	MACS_peak_9621	424.89	308	0	1	1	gen
19	44723801	44724217	MACS_peak_9623	612.12	416	0	0	0	intergen
19	44800396	44800741	MACS_peak_9624	348.48	345	0	0	0	intergen
19	44951585	44951870	MACS_peak_9625	574.52	285	1	0	1	promoter
19	45131073	45131266	MACS_peak_9626	678.9	193	0	2	0	gen
19	45143762	45143986	MACS_peak_9627	564.54	224	0	2	0	gen
19	45248592	45248979	MACS_peak_9628	511.42	387	0	1	0	gen
19	45439541	45439764	MACS_peak_9629	582.91	223	0	1	0	gen
19	45493538	45493816	MACS_peak_9630	709.17	278	0	1	0	gen
19	45558503	45558819	MACS_peak_9631	1221.51	316	0	1	0	gen
19	45607376	45607551	MACS_peak_9632	972.07	175	1	0	0	promoter
19	45643097	45643398	MACS_peak_9633	563.21	301	0	1	0	gen
19	45681594	45681797	MACS_peak_9634	629.38	203	0	1	0	gen
19	45799075	45799337	MACS_peak_9635	723.53	262	1	0	0	promoter
19	45883352	45883667	MACS_peak_9636	1222.71	315	1	0	0	promoter
19	46039470	46039813	MACS_peak_9637	59.35	343	1	0	0	promoter
19	46247224	46247389	MACS_peak_9638	1036.76	165	0	0	0	intergen
19	46395602	46395957	MACS_peak_9639	1210.46	355	0	0	0	intergen
19	46537528	46537800	MACS_peak_9640	459.58	272	0	1	0	gen
19	46596641	46597005	MACS_peak_9641	524.01	364	1	1	1	promoter
19	46622961	46623101	MACS_peak_9642	1025.76	140	1	0	0	promoter
19	46638604	46638783	MACS_peak_9643	746.04	179	1	0	1	promoter
19	46728830	46729085	MACS_peak_9644	470.06	255	0	1	1	gen
19	46753808	46754084	MACS_peak_9645	581.17	276	0	1	0	gen
19	46840595	46840747	MACS_peak_9646	1965.34	152	1	0	0	promoter
19	47012959	47013311	MACS_peak_9647	847.12	352	0	0	0	intergen
19	47032210	47032486	MACS_peak_9648	454.41	276	0	1	0	gen
19	47033894	47034105	MACS_peak_9649	165.48	211	0	1	0	gen
19	47230536	47230806	MACS_peak_9650	460.86	270	0	1	0	gen
19	47247504	47247784	MACS_peak_9651	640.85	280	0	0	0	intergen
19	47305305	47305609	MACS_peak_9652	797.47	304	0	1	0	gen
19	47367325	47367621	MACS_peak_9653	170.16	296	0	1	0	gen
19	47788863	47789089	MACS_peak_9654	848.95	226	0	0	0	intergen
19	47863352	47863706	MACS_peak_9655	529.74	354	0	0	0	intergen
19	47908368	47908656	MACS_peak_9658	69	288	0	0	0	intergen
19	47909885	47910214	MACS_peak_9660	227.1	329	0	0	0	intergen
19	47912756	47913216	MACS_peak_9661	1645.15	460	0	0	0	intergen
19	47913758	47914031	MACS_peak_9662	72.11	273	0	0	0	intergen
19	47920008	47920477	MACS_peak_9665	3100	469	0	0	0	intergen
19	47920684	47920947	MACS_peak_9666	63.45	263	0	0	0	intergen
19	47924515	47924851	MACS_peak_9668	50.92	336	0	0	0	intergen
19	47925977	47926304	MACS_peak_9670	100.53	327	0	0	0	intergen
19	47928523	47928983	MACS_peak_9671	1794.8	460	0	0	0	intergen
19	47929525	47929892	MACS_peak_9672	63.13	367	0	0	0	intergen
19	47930411	47930877	MACS_peak_9673	2457.07	466	0	0	0	intergen
19	47935898	47936270	MACS_peak_9675	1673.79	372	0	0	0	intergen
19	47936435	47936725	MACS_peak_9676	80.01	290	0	0	0	intergen
19	47939246	47939544	MACS_peak_9677	793.71	298	0	0	0	intergen
19	47940250	47940694	MACS_peak_9678	52.99	444	0	0	0	intergen
19	47943923	47944249	MACS_peak_9680	58.49	326	0	0	0	intergen
19	47947122	47947449	MACS_peak_9683	142.99	327	0	0	0	intergen
19	47948020	47948269	MACS_peak_9684	88.96	249	0	0	0	intergen
19	47949350	47949626	MACS_peak_9685	173.92	276	0	0	0	intergen
19	47950002	47950299	MACS_peak_9686	2135.79	297	0	0	0	intergen
19	47951001	47951368	MACS_peak_9687	63.13	367	0	0	0	intergen
19	47951894	47952345	MACS_peak_9688	3169.12	451	0	0	0	intergen
19	47952513	47952840	MACS_peak_9689	56.46	327	0	0	0	intergen
19	47953409	47953846	MACS_peak_9690	87.14	437	0	0	0	intergen
19	47954597	47955012	MACS_peak_9691	62.88	415	0	0	0	intergen
19	47955387	47955685	MACS_peak_9692	2251.6	298	0	0	0	intergen
19	47956389	47956662	MACS_peak_9693	84.4	273	0	0	0	intergen
19	47957896	47958220	MACS_peak_9695	135.29	324	0	0	0	intergen
19	48187390	48187712	MACS_peak_9696	413.88	322	0	2	0	gen
19	48260294	48260496	MACS_peak_9697	645.81	202	0	0	0	intergen
19	48320105	48320319	MACS_peak_9698	596.79	214	1	1	0	promoter
19	48424163	48424518	MACS_peak_9699	186.49	355	0	1	0	gen
19	48584320	48584652	MACS_peak_9700	489.66	332	0	1	0	gen
19	48876892	48877262	MACS_peak_9701	611.86	370	2	0	0	promoter
19	48993218	48993580	MACS_peak_9702	410.45	362	1	0	0	promoter
19	48999729	49000179	MACS_peak_9703	622.87	450	0	1	0	gen
19	49074770	49075190	MACS_peak_9704	730.17	420	0	0	0	intergen
19	49208871	49209170	MACS_peak_9705	426.58	299	0	1	0	gen
19	49821817	49821949	MACS_peak_9706	771.26	132	1	0	0	promoter
19	49937634	49937919	MACS_peak_9707	380.3	285	0	1	0	gen
19	50088807	50089082	MACS_peak_9708	275.68	275	0	0	0	intergen
19	50090734	50091205	MACS_peak_9709	1204.91	471	0	0	0	intergen
19	50091630	50091918	MACS_peak_9710	62.38	288	0	0	0	intergen
19	50096873	50097255	MACS_peak_9713	63.13	382	0	0	0	intergen
19	50098972	50099312	MACS_peak_9715	1873.17	340	0	0	0	intergen
19	50099938	50100320	MACS_peak_9716	75.42	382	0	0	0	intergen
19	50102050	50102521	MACS_peak_9718	3100	471	0	0	0	intergen
19	50103097	50103385	MACS_peak_9719	56.38	288	0	0	0	intergen
19	50110457	50110913	MACS_peak_9723	2893.16	456	0	0	0	intergen
19	50116860	50117148	MACS_peak_9726	69	288	0	0	0	intergen
19	50129186	50129473	MACS_peak_9732	75.57	287	0	0	0	intergen
19	50133791	50134259	MACS_peak_9734	1100.51	468	0	0	0	intergen
19	50137212	50137507	MACS_peak_9735	3061.86	295	0	0	0	intergen
19	50139164	50139632	MACS_peak_9736	1877.66	468	0	0	0	intergen
19	50258926	50259306	MACS_peak_9737	402.16	380	0	1	0	gen
19	50461166	50461484	MACS_peak_9738	551.85	318	0	1	0	gen
19	50479159	50479349	MACS_peak_9739	695.57	190	1	0	0	promoter
19	50486952	50487211	MACS_peak_9740	594.37	259	0	1	1	gen
19	50604729	50604948	MACS_peak_9741	1139.8	219	0	0	0	intergen
19	50663411	50663765	MACS_peak_9742	529.74	354	1	0	0	promoter
19	50747436	50747876	MACS_peak_9743	598.7	440	0	0	0	intergen
19	50783663	50783887	MACS_peak_9744	537.61	224	0	1	0	gen
19	51016751	51017099	MACS_peak_9745	912.29	348	1	0	0	promoter
19	51094837	51095031	MACS_peak_9746	1245.57	194	1	0	0	promoter
19	51158374	51158688	MACS_peak_9747	679.74	314	0	0	1	other
19	51259415	51259647	MACS_peak_9748	1320.51	232	0	1	1	gen
19	51398105	51398480	MACS_peak_9749	360.38	375	0	0	2	other
19	51471303	51471508	MACS_peak_9750	628.07	205	0	0	0	intergen
19	51618791	51618923	MACS_peak_9751	826.38	132	0	2	0	gen
19	52047721	52047938	MACS_peak_9754	553.1	217	0	1	0	gen
19	52237821	52238124	MACS_peak_9755	688.35	303	0	0	0	intergen
19	53189856	53190159	MACS_peak_9756	1232.34	303	0	1	0	gen
19	53227231	53227587	MACS_peak_9757	96.97	356	0	0	0	intergen
19	53360618	53360902	MACS_peak_9758	229.83	284	0	0	0	intergen
19	53587401	53587725	MACS_peak_9759	299.64	324	0	0	0	intergen
19	53793059	53793390	MACS_peak_9760	458.88	331	1	0	0	promoter
19	54172924	54173286	MACS_peak_9761	410.92	362	1	0	0	promoter
19	54325219	54325470	MACS_peak_9762	1025.49	251	0	0	1	other
19	54580430	54580744	MACS_peak_9763	183.74	314	0	1	0	gen
19	54674092	54674271	MACS_peak_9764	746.04	179	0	0	0	intergen
19	54919589	54920006	MACS_peak_9765	1120.25	417	1	0	0	promoter
19	54998519	54998665	MACS_peak_9766	520.68	146	0	1	0	gen
19	55029362	55029508	MACS_peak_9767	847.1	146	0	1	2	gen
19	55418152	55418510	MACS_peak_9768	386.06	358	0	0	0	intergen
19	55632401	55632742	MACS_peak_9769	659.85	341	2	0	0	promoter
19	55653647	55654038	MACS_peak_9770	1006.73	391	1	0	0	promoter
19	55736894	55737123	MACS_peak_9771	522.21	229	0	1	0	gen
19	56333594	56333911	MACS_peak_9772	915.23	317	0	1	1	gen
19	56396244	56396572	MACS_peak_9773	429.01	328	1	0	1	promoter
19	56609535	56609873	MACS_peak_9774	422.19	338	0	1	0	gen
19	57005448	57005734	MACS_peak_9775	153.62	286	0	0	0	intergen
19	58310850	58311182	MACS_peak_9776	978.69	332	0	3	1	gen
19	58436647	58436798	MACS_peak_9777	577.33	151	1	0	0	promoter
19	58513933	58514161	MACS_peak_9778	695.57	228	1	0	0	promoter
19	58519003	58519241	MACS_peak_9779	516.86	238	0	1	0	gen
19	58606364	58606640	MACS_peak_9780	274.43	276	0	0	0	intergen
20	1744109	1744531	MACS_peak_11674	115.17	422	0	0	0	intergen
20	1797261	1797402	MACS_peak_11675	1001.34	141	0	0	0	intergen
20	2506039	2506401	MACS_peak_11676	72.08	362	0	2	0	gen
20	2646989	2647157	MACS_peak_11677	1025.76	168	0	0	0	intergen
20	2910206	2910637	MACS_peak_11678	306.6	431	0	1	0	gen
20	3494337	3494614	MACS_peak_11679	250.69	277	0	1	0	gen
20	3496247	3496668	MACS_peak_11680	108.17	421	0	1	0	gen
20	3513723	3513988	MACS_peak_11681	56.38	265	0	1	0	gen
20	3563662	3563991	MACS_peak_11682	426.82	329	0	1	0	gen
20	3630832	3631057	MACS_peak_11683	442.71	225	0	1	0	gen
20	3753100	3753289	MACS_peak_11684	695.57	189	1	0	0	promoter
20	4008258	4008553	MACS_peak_11685	567.38	295	0	1	0	gen
20	4386686	4386983	MACS_peak_11686	125.63	297	0	0	0	intergen
20	5276783	5277134	MACS_peak_11687	89.02	351	0	0	0	intergen
20	5380219	5380602	MACS_peak_11688	94.4	383	0	0	0	intergen
20	5394404	5394722	MACS_peak_11689	103.45	318	0	0	0	intergen
20	5515097	5515564	MACS_peak_11690	60	467	0	0	0	intergen
20	6011560	6011709	MACS_peak_11691	843.6	149	0	1	0	gen
20	6170253	6170633	MACS_peak_11692	228.54	380	0	0	0	intergen
20	6222212	6222568	MACS_peak_11693	143.62	356	0	0	0	intergen
20	6583098	6583399	MACS_peak_11694	442.11	301	0	0	0	intergen
20	7376019	7376245	MACS_peak_11695	848.95	226	0	0	0	intergen
20	7754646	7755006	MACS_peak_11696	411.4	360	0	0	0	intergen
20	7859382	7859821	MACS_peak_11697	599.25	439	0	0	0	intergen
20	7936561	7936765	MACS_peak_11698	797.18	204	0	1	0	gen
20	7980709	7981026	MACS_peak_11699	552.5	317	1	0	0	promoter
20	8661893	8662287	MACS_peak_11701	873.84	394	0	1	0	gen
20	8759524	8759906	MACS_peak_11702	603.02	382	0	1	0	gen
20	8790537	8790783	MACS_peak_11703	927.9	246	0	1	0	gen
20	8853889	8854083	MACS_peak_11704	778.31	194	0	1	0	gen
20	9468087	9468309	MACS_peak_11705	381.31	222	0	1	0	gen
20	9618049	9618246	MACS_peak_11706	433.73	197	0	1	0	gen
20	9796866	9797234	MACS_peak_11707	175.22	368	0	1	0	gen
20	9891763	9891949	MACS_peak_11708	901.33	186	0	0	0	intergen
20	9902949	9903362	MACS_peak_11709	498.1	413	0	0	0	intergen
20	9912905	9913192	MACS_peak_11710	763.11	287	0	0	0	intergen
20	9973273	9973572	MACS_peak_11711	312.88	299	0	0	0	intergen
20	9978391	9978747	MACS_peak_11712	380.3	356	0	0	0	intergen
20	10090439	10090883	MACS_peak_11713	714.62	444	0	0	1	other
20	10155023	10155334	MACS_peak_11715	436.49	311	0	0	1	other
20	11274171	11274399	MACS_peak_11716	677.53	228	0	0	1	other
20	11300896	11301030	MACS_peak_11717	690.46	134	0	0	1	other
20	11483785	11483920	MACS_peak_11718	1358.26	135	0	0	0	intergen
20	11637214	11637564	MACS_peak_11719	68.3	350	0	0	0	intergen
20	11676590	11676830	MACS_peak_11720	516.86	240	0	0	0	intergen
20	11677219	11677352	MACS_peak_11721	1396.21	133	0	0	0	intergen
20	12125566	12126036	MACS_peak_11722	61.22	470	0	0	0	intergen
20	12126580	12126883	MACS_peak_11723	139.27	303	0	0	0	intergen
20	12127891	12128161	MACS_peak_11724	91.24	270	0	0	0	intergen
20	12223911	12224253	MACS_peak_11725	722.05	342	0	0	0	intergen
20	12362721	12363093	MACS_peak_11727	62.38	372	0	0	0	intergen
20	12496831	12497157	MACS_peak_11728	162.03	326	0	0	0	intergen
20	12587347	12587687	MACS_peak_11729	94.16	340	0	0	0	intergen
20	12925187	12925442	MACS_peak_11730	596.79	255	0	0	1	other
20	12966499	12966811	MACS_peak_11731	555.79	312	0	0	0	intergen
20	13206099	13206399	MACS_peak_11732	442.68	300	0	0	0	intergen
20	13436978	13437388	MACS_peak_11733	60	410	0	1	0	gen
20	13458815	13459186	MACS_peak_11734	763.88	371	0	1	0	gen
20	13483671	13483882	MACS_peak_11735	386.13	211	0	1	0	gen
20	13788273	13788427	MACS_peak_11736	918.92	154	1	0	0	promoter
20	14142160	14142390	MACS_peak_11737	532.66	230	0	1	0	gen
20	14189742	14190108	MACS_peak_11738	522.88	366	0	1	0	gen
20	14273681	14274050	MACS_peak_11739	91.24	369	0	1	0	gen
20	14463910	14464200	MACS_peak_11740	76.3	290	0	1	0	gen
20	14640052	14640316	MACS_peak_11741	464.74	264	0	1	0	gen
20	15088193	15088479	MACS_peak_11744	437.62	286	0	1	0	gen
20	15134472	15134853	MACS_peak_11745	124.57	381	0	1	0	gen
20	15136125	15136518	MACS_peak_11746	82.68	393	0	1	0	gen
20	15254825	15254961	MACS_peak_11747	1358.26	136	0	1	0	gen
20	15378272	15378407	MACS_peak_11749	1079.97	135	0	1	0	gen
20	15654205	15654432	MACS_peak_11750	548.55	227	0	1	0	gen
20	15810116	15810382	MACS_peak_11751	129.67	266	0	1	0	gen
20	15930237	15930595	MACS_peak_11752	903.5	358	0	1	0	gen
20	16232123	16232333	MACS_peak_11753	765.5	210	0	0	0	intergen
20	16518378	16518693	MACS_peak_11754	361.4	315	0	1	0	gen
20	16634772	16635074	MACS_peak_11755	689.14	302	0	0	0	intergen
20	16821493	16821880	MACS_peak_11758	1010.27	387	0	0	0	intergen
20	16909163	16909483	MACS_peak_11759	108.7	320	0	0	0	intergen
20	17146805	17147071	MACS_peak_11760	349.84	266	0	0	0	intergen
20	17277517	17277942	MACS_peak_11761	59.76	425	0	1	0	gen
20	17413697	17414019	MACS_peak_11762	94.54	322	0	1	0	gen
20	17431891	17432089	MACS_peak_11763	662.31	198	0	1	0	gen
20	17447260	17447394	MACS_peak_11764	1098.16	134	0	1	0	gen
20	17504897	17505265	MACS_peak_11765	521.76	368	0	1	0	gen
20	17996056	17996460	MACS_peak_11766	785.42	404	0	1	0	gen
20	18247341	18247691	MACS_peak_11767	57.24	350	0	0	0	intergen
20	18537247	18537546	MACS_peak_11768	265.34	299	0	1	0	gen
20	18632264	18632570	MACS_peak_11770	559.8	306	0	2	0	gen
20	18718185	18718443	MACS_peak_11771	468.72	258	0	2	0	gen
20	18756544	18756896	MACS_peak_11772	53.29	352	0	1	0	gen
20	18757568	18757879	MACS_peak_11773	65.72	311	0	1	0	gen
20	18937817	18938126	MACS_peak_11774	499.98	309	0	0	0	intergen
20	18950191	18950536	MACS_peak_11775	110.06	345	0	0	0	intergen
20	19034059	19034517	MACS_peak_11776	211.33	458	0	0	1	other
20	19069434	19069566	MACS_peak_11777	893.03	132	0	0	0	intergen
20	19087983	19088431	MACS_peak_11778	100.3	448	0	0	0	intergen
20	19088493	19088826	MACS_peak_11779	52.99	333	0	0	0	intergen
20	19197970	19198243	MACS_peak_11780	312.33	273	0	0	0	intergen
20	19206031	19206293	MACS_peak_11781	466.05	262	0	0	0	intergen
20	19662578	19662871	MACS_peak_11783	828.97	293	0	1	0	gen
20	19802610	19803051	MACS_peak_11784	473.06	441	0	1	0	gen
20	19853805	19854213	MACS_peak_11785	80.5	408	0	1	0	gen
20	20054006	20054140	MACS_peak_11786	1666.76	134	1	1	0	promoter
20	20314651	20315069	MACS_peak_11787	181.04	418	0	1	0	gen
20	20320324	20320619	MACS_peak_11788	501.66	295	0	1	0	gen
20	20408041	20408246	MACS_peak_11789	629.38	205	0	1	0	gen
20	20458449	20458654	MACS_peak_11790	605.24	205	0	1	0	gen
20	20568586	20568993	MACS_peak_11791	555.48	407	0	1	0	gen
20	20664842	20665270	MACS_peak_11792	605.31	428	0	1	0	gen
20	20864440	20864687	MACS_peak_11793	901.33	247	0	0	0	intergen
20	21236119	21236385	MACS_peak_11794	719.85	266	0	1	0	gen
20	21253826	21254175	MACS_peak_11795	189.47	349	0	0	0	intergen
20	21451897	21452030	MACS_peak_11797	1291.76	133	0	0	0	intergen
20	21496875	21497119	MACS_peak_11798	511.42	244	0	0	0	intergen
20	21505200	21505445	MACS_peak_11799	501.16	245	0	0	0	intergen
20	21719784	21720067	MACS_peak_11800	408.17	283	0	0	0	intergen
20	21721286	21721654	MACS_peak_11801	407.64	368	0	0	0	intergen
20	21891582	21891973	MACS_peak_11802	91.76	391	0	0	0	intergen
20	21911909	21912232	MACS_peak_11803	74.32	323	0	0	0	intergen
20	21912856	21913276	MACS_peak_11804	71.37	420	0	0	0	intergen
20	22118901	22119245	MACS_peak_11805	103.03	344	0	0	0	intergen
20	22216179	22216458	MACS_peak_11806	578.93	279	0	0	0	intergen
20	22228719	22229012	MACS_peak_11807	568.79	293	0	0	0	intergen
20	22339158	22339412	MACS_peak_11808	596.79	254	0	0	0	intergen
20	22684093	22684313	MACS_peak_11809	564.54	220	0	0	1	other
20	22854271	22854515	MACS_peak_11810	440.77	244	0	0	0	intergen
20	22870153	22870487	MACS_peak_11811	204.76	334	0	0	0	intergen
20	22974488	22974679	MACS_peak_11812	695.57	191	0	0	0	intergen
20	22990856	22991148	MACS_peak_11813	84.26	292	0	0	0	intergen
20	23306751	23307163	MACS_peak_11814	76.47	412	0	0	0	intergen
20	23428531	23428903	MACS_peak_11815	58.75	372	0	0	0	intergen
20	23490218	23490534	MACS_peak_11816	433.75	316	1	0	1	promoter
20	23591179	23591408	MACS_peak_11817	146.78	229	0	0	0	intergen
20	23758257	23758621	MACS_peak_11818	234.8	364	0	0	0	intergen
20	23799245	23799484	MACS_peak_11819	516.86	239	0	0	1	other
20	23900361	23900663	MACS_peak_11820	80.28	302	0	0	0	intergen
20	23984721	23984944	MACS_peak_11821	564.54	223	1	0	0	promoter
20	23996206	23996630	MACS_peak_11822	978.89	424	0	0	0	intergen
20	24552963	24553253	MACS_peak_11823	89.02	290	0	1	0	gen
20	24554914	24555335	MACS_peak_11824	84.14	421	0	1	0	gen
20	24903557	24903907	MACS_peak_11825	101.68	350	0	0	0	intergen
20	24918449	24918653	MACS_peak_11826	617.05	204	0	0	0	intergen
20	24931142	24931350	MACS_peak_11827	791.62	208	0	0	0	intergen
20	25110193	25110488	MACS_peak_11828	250.57	295	0	0	0	intergen
20	25262992	25263438	MACS_peak_11829	86.87	446	0	1	0	gen
20	25332673	25333045	MACS_peak_11830	67.63	372	0	1	0	gen
20	25383850	25384089	MACS_peak_11831	513.53	239	0	1	0	gen
20	25428973	25429112	MACS_peak_11832	741.54	139	0	1	0	gen
20	25716601	25716925	MACS_peak_11833	175.91	324	0	0	1	other
20	25874804	25875156	MACS_peak_11834	198.49	352	0	0	0	intergen
20	26238803	26239193	MACS_peak_11835	68.48	390	0	0	1	other
20	26283630	26283848	MACS_peak_11836	96.95	218	0	0	0	intergen
20	26292459	26292817	MACS_peak_11837	50.57	358	0	0	0	intergen
20	26297056	26297443	MACS_peak_11838	222.58	387	0	0	0	intergen
20	26298388	26298656	MACS_peak_11839	76.3	268	0	0	0	intergen
20	26299574	26299785	MACS_peak_11840	198.27	211	0	0	0	intergen
20	26310711	26311069	MACS_peak_11841	68.83	358	0	0	0	intergen
20	26338687	26338885	MACS_peak_11842	78.26	198	0	0	0	intergen
20	30238103	30238563	MACS_peak_11843	79.68	460	0	0	0	intergen
20	30348934	30349268	MACS_peak_11844	607.08	334	0	0	1	other
20	30403456	30403871	MACS_peak_11846	398.99	415	0	0	0	intergen
20	30409760	30410131	MACS_peak_11847	90.08	371	0	0	0	intergen
20	30416705	30416936	MACS_peak_11848	171.88	231	0	0	0	intergen
20	31217229	31217471	MACS_peak_11851	215.74	242	0	0	0	intergen
20	31218558	31219027	MACS_peak_11852	230.98	469	0	0	0	intergen
20	31224042	31224432	MACS_peak_11853	494.86	390	0	0	0	intergen
20	31224596	31225062	MACS_peak_11854	60.47	466	0	0	0	intergen
20	31225822	31226135	MACS_peak_11855	175.9	313	0	0	0	intergen
20	31226224	31226514	MACS_peak_11856	247.45	290	0	0	0	intergen
20	31230401	31230741	MACS_peak_11858	192.25	340	0	0	0	intergen
20	31233495	31233739	MACS_peak_11859	66.09	244	0	0	0	intergen
20	31233931	31234357	MACS_peak_11860	169.67	426	0	0	0	intergen
20	31234898	31235335	MACS_peak_11861	125.28	437	0	0	0	intergen
20	31244870	31245203	MACS_peak_11865	50.66	333	0	0	0	intergen
20	31313457	31313681	MACS_peak_11866	712.32	224	0	0	0	intergen
20	31335222	31335628	MACS_peak_11867	81.15	406	0	0	0	intergen
20	31335732	31336033	MACS_peak_11868	75.88	301	0	0	0	intergen
20	31560184	31560384	MACS_peak_11869	810.31	200	0	1	0	gen
20	31569623	31569799	MACS_peak_11870	972.07	176	0	1	1	gen
20	31577833	31578198	MACS_peak_11871	201.59	365	0	0	0	intergen
20	31612919	31613335	MACS_peak_11872	896.57	416	0	0	0	intergen
20	31628038	31628336	MACS_peak_11873	114.74	298	0	0	0	intergen
20	31927110	31927312	MACS_peak_11874	705.57	202	0	1	0	gen
20	31951876	31952331	MACS_peak_11875	590.7	455	0	0	0	intergen
20	32054271	32054623	MACS_peak_11876	142.05	352	1	0	0	promoter
20	32178374	32178611	MACS_peak_11877	945.13	237	0	0	0	intergen
20	32674366	32674657	MACS_peak_11879	570.2	291	0	1	0	gen
20	32790112	32790430	MACS_peak_11880	432.66	318	0	1	0	gen
20	32902560	32902795	MACS_peak_11881	814.37	235	0	1	0	gen
20	33262662	33262916	MACS_peak_11882	883.81	254	0	0	0	intergen
20	33792229	33792427	MACS_peak_11883	662.31	198	0	0	1	other
20	34228045	34228256	MACS_peak_11884	519.65	211	0	1	0	gen
20	34255623	34255882	MACS_peak_11885	396.98	259	0	1	1	gen
20	34298276	34298563	MACS_peak_11886	996.37	287	0	1	0	gen
20	34312695	34313017	MACS_peak_11887	549.27	322	0	0	0	intergen
20	34874145	34874342	MACS_peak_11888	831.63	197	1	0	0	promoter
20	35154619	35154985	MACS_peak_11889	114.74	366	0	0	0	intergen
20	35208447	35208696	MACS_peak_11890	596.67	249	0	2	0	gen
20	35511871	35512125	MACS_peak_11891	470.06	254	0	1	0	gen
20	35686859	35687064	MACS_peak_11892	514.2	205	0	1	0	gen
20	35713652	35713789	MACS_peak_11893	1081.35	137	0	1	0	gen
20	35763642	35764047	MACS_peak_11894	469.55	405	0	0	0	intergen
20	35954426	35954782	MACS_peak_11895	413.31	356	2	0	0	promoter
20	35991267	35991510	MACS_peak_11896	645.81	243	0	1	0	gen
20	36134686	36134980	MACS_peak_11897	695.63	294	0	1	0	gen
20	36488090	36488335	MACS_peak_11898	363.13	245	0	1	0	gen
20	36884739	36885137	MACS_peak_11899	678.21	398	0	1	0	gen
20	37368439	37368642	MACS_peak_11900	343.13	203	0	1	0	gen
20	37384743	37384991	MACS_peak_11901	1208.41	248	0	1	0	gen
20	37534486	37534716	MACS_peak_11902	454.39	230	0	0	0	intergen
20	37965283	37965560	MACS_peak_11903	467.94	277	0	0	0	intergen
20	38079975	38080146	MACS_peak_11904	1007.8	171	0	1	0	gen
20	38123935	38124362	MACS_peak_11905	725.31	427	1	1	0	promoter
20	38435304	38435591	MACS_peak_11906	573.07	287	0	0	0	intergen
20	38462902	38463239	MACS_peak_11907	600.41	337	0	0	0	intergen
20	38512188	38512424	MACS_peak_11908	465.7	236	0	1	0	gen
20	38751330	38751685	MACS_peak_11909	529.16	355	1	0	0	promoter
20	39469952	39470298	MACS_peak_11911	72.05	346	0	0	0	intergen
20	40192711	40193163	MACS_peak_11913	640.09	452	0	0	0	intergen
20	40442280	40442556	MACS_peak_11914	457.06	276	0	0	0	intergen
20	40706972	40707222	MACS_peak_11915	485.56	250	0	0	0	intergen
20	40946055	40946249	MACS_peak_11916	678.9	194	0	0	0	intergen
20	40963077	40963505	MACS_peak_11917	680.96	428	0	0	0	intergen
20	40968772	40969038	MACS_peak_11918	1708.59	266	0	0	0	intergen
20	40990547	40990837	MACS_peak_11919	448.52	290	0	0	0	intergen
20	41095420	41095721	MACS_peak_11920	1418.55	301	0	1	0	gen
20	41129491	41129793	MACS_peak_11921	197.33	302	0	0	1	other
20	41135271	41135500	MACS_peak_11922	568.54	229	1	0	1	promoter
20	41173183	41173503	MACS_peak_11923	933.54	320	0	1	0	gen
20	41196280	41196666	MACS_peak_11924	967.93	386	0	2	0	gen
20	41207523	41207826	MACS_peak_11925	136.82	303	0	1	0	gen
20	41210338	41210664	MACS_peak_11926	76.3	326	0	1	0	gen
20	41232441	41232738	MACS_peak_11927	229.23	297	0	1	0	gen
20	41340004	41340311	MACS_peak_11928	946.44	307	1	0	0	promoter
20	41411505	41411742	MACS_peak_11929	516.86	237	0	1	0	gen
20	41571134	41571401	MACS_peak_11930	391.8	267	0	1	0	gen
20	41571994	41572307	MACS_peak_11931	429.13	313	0	1	0	gen
20	41694240	41694420	MACS_peak_11932	701.06	180	0	0	0	intergen
20	41697765	41698066	MACS_peak_11933	1345.88	301	0	0	0	intergen
20	41734493	41734719	MACS_peak_11934	822.5	226	0	0	0	intergen
20	41738612	41738918	MACS_peak_11935	1999.14	306	0	0	0	intergen
20	41808623	41808779	MACS_peak_11936	593.49	156	0	0	0	intergen
20	41812048	41812420	MACS_peak_11937	406.81	372	0	0	0	intergen
20	41848279	41848590	MACS_peak_11938	496.14	311	0	0	0	intergen
20	41956321	41956562	MACS_peak_11939	936.57	241	0	0	0	intergen
20	42041168	42041487	MACS_peak_11940	312.33	319	0	0	1	other
20	42072449	42072877	MACS_peak_11941	680.96	428	1	0	0	promoter
20	42209085	42209412	MACS_peak_11943	111.55	327	0	1	0	gen
20	42211335	42211716	MACS_peak_11944	66.86	381	0	1	0	gen
20	42384874	42385117	MACS_peak_11945	866.01	243	0	1	0	gen
20	42483779	42484158	MACS_peak_11946	370.24	379	0	1	0	gen
20	42530911	42531227	MACS_peak_11948	928.21	316	0	1	0	gen
20	42579588	42579951	MACS_peak_11949	159.06	363	0	1	0	gen
20	42614923	42615283	MACS_peak_11950	105.51	360	0	1	0	gen
20	42633798	42634158	MACS_peak_11952	972.38	360	0	1	0	gen
20	42893019	42893290	MACS_peak_11953	151.79	271	0	1	0	gen
20	43749718	43750031	MACS_peak_11954	555.13	313	0	0	0	intergen
20	43816387	43816641	MACS_peak_11955	59.86	254	0	0	0	intergen
20	43935806	43936059	MACS_peak_11958	484.29	253	0	1	0	gen
20	44047654	44047984	MACS_peak_11959	431.5	330	0	1	0	gen
20	44080707	44081022	MACS_peak_11960	553.81	315	0	0	0	intergen
20	44116739	44117110	MACS_peak_11961	639.57	371	0	1	0	gen
20	44386490	44386785	MACS_peak_11963	963.62	295	0	1	1	gen
20	44460899	44461128	MACS_peak_11965	2417.35	229	0	0	1	other
20	44491065	44491205	MACS_peak_11966	310.64	140	0	1	0	gen
20	44609939	44610384	MACS_peak_11967	836.26	445	0	1	0	gen
20	44867662	44867963	MACS_peak_11968	933.35	301	0	0	0	intergen
20	45044051	45044440	MACS_peak_11969	1142.62	389	0	1	0	gen
20	45111887	45112216	MACS_peak_11970	544.83	329	1	0	0	promoter
20	45300990	45301236	MACS_peak_11971	629.38	246	0	1	0	gen
20	45362870	45363080	MACS_peak_11972	607.01	210	2	0	0	promoter
20	45373958	45374113	MACS_peak_11973	1134.69	155	1	2	0	promoter
20	45422880	45423092	MACS_peak_11974	423.63	212	0	1	0	gen
20	45446030	45446197	MACS_peak_11975	814.37	167	0	1	1	gen
20	45592630	45592968	MACS_peak_11976	1505.23	338	0	0	0	intergen
20	45661154	45661511	MACS_peak_11977	68.55	357	0	1	0	gen
20	45766469	45766744	MACS_peak_11978	380.3	275	0	1	0	gen
20	45771257	45771488	MACS_peak_11979	678.9	231	0	1	0	gen
20	45799222	45799466	MACS_peak_11980	409.44	244	0	1	0	gen
20	45820264	45820445	MACS_peak_11981	746.04	181	1	0	0	promoter
20	45820971	45821119	MACS_peak_11982	1208.41	148	1	0	0	promoter
20	45969730	45970052	MACS_peak_11983	430.51	322	0	1	0	gen
20	46562566	46562804	MACS_peak_11984	662.31	238	1	0	0	promoter
20	46699793	46700052	MACS_peak_11985	726.32	259	0	0	0	intergen
20	46748014	46748200	MACS_peak_11986	901.33	186	0	0	0	intergen
20	46752614	46752902	MACS_peak_11987	833.73	288	0	0	0	intergen
20	46767202	46767474	MACS_peak_11988	459.58	272	0	0	0	intergen
20	47142289	47142608	MACS_peak_11990	138.21	319	0	1	0	gen
20	47157254	47157495	MACS_peak_11991	288.01	241	0	1	0	gen
20	47173941	47174263	MACS_peak_11992	242.14	322	0	1	0	gen
20	47181227	47181538	MACS_peak_11993	128.16	311	0	1	0	gen
20	47192580	47192820	MACS_peak_11994	150.71	240	0	0	0	intergen
20	47219380	47219800	MACS_peak_11997	240.26	420	0	1	0	gen
20	47219980	47220347	MACS_peak_11998	382.21	367	0	1	0	gen
20	47261400	47261697	MACS_peak_11999	232.75	297	0	1	0	gen
20	47265045	47265403	MACS_peak_12000	141.72	358	0	1	0	gen
20	47270599	47271036	MACS_peak_12001	125.8	437	0	1	0	gen
20	47272749	47273231	MACS_peak_12002	3100	482	0	1	0	gen
20	47277911	47278175	MACS_peak_12003	177.34	264	0	1	0	gen
20	47279736	47280117	MACS_peak_12004	83.57	381	0	1	0	gen
20	47296950	47297420	MACS_peak_12005	1540.02	470	0	1	0	gen
20	47304103	47304540	MACS_peak_12006	946.24	437	0	1	0	gen
20	47341105	47341303	MACS_peak_12007	364.69	198	0	1	0	gen
20	47375308	47375596	MACS_peak_12009	156.63	288	0	0	0	intergen
20	47377145	47377390	MACS_peak_12010	273.38	245	0	0	0	intergen
20	47384023	47384415	MACS_peak_12011	3100	392	0	0	0	intergen
20	47391758	47392124	MACS_peak_12012	111.52	366	0	0	0	intergen
20	47413649	47413844	MACS_peak_12013	308.02	195	0	0	0	intergen
20	47418883	47419247	MACS_peak_12014	402.12	364	0	0	0	intergen
20	47432889	47433058	MACS_peak_12015	448.15	169	0	0	0	intergen
20	47433809	47434088	MACS_peak_12016	260.52	279	0	0	0	intergen
20	47448503	47448824	MACS_peak_12017	111.96	321	0	0	0	intergen
20	47455340	47455710	MACS_peak_12018	98.22	370	0	0	0	intergen
20	47464241	47464700	MACS_peak_12019	1912.66	459	0	0	0	intergen
20	47473010	47473367	MACS_peak_12020	88.18	357	0	0	0	intergen
20	47501694	47502024	MACS_peak_12021	616.08	330	1	0	0	promoter
20	47502520	47502780	MACS_peak_12022	169.96	260	1	0	0	promoter
20	47503602	47503975	MACS_peak_12023	136.5	373	1	0	0	promoter
20	47504734	47505030	MACS_peak_12024	301.88	296	1	0	0	promoter
20	47540580	47541041	MACS_peak_12026	247.16	461	0	1	0	gen
20	47544995	47545194	MACS_peak_12027	372.64	199	0	1	0	gen
20	47549383	47549711	MACS_peak_12028	159.09	328	0	1	0	gen
20	47554322	47554675	MACS_peak_12029	52.45	353	0	1	0	gen
20	47557631	47557971	MACS_peak_12030	101.99	340	0	1	0	gen
20	47567065	47567434	MACS_peak_12031	163.2	369	0	1	0	gen
20	47590046	47590390	MACS_peak_12032	103.03	344	0	1	0	gen
20	47594930	47595242	MACS_peak_12033	238.38	312	0	1	0	gen
20	47599620	47600040	MACS_peak_12034	222.18	420	0	1	0	gen
20	47610707	47611087	MACS_peak_12035	175.32	380	0	1	0	gen
20	47623171	47623454	MACS_peak_12037	139.88	283	0	1	0	gen
20	47663679	47664139	MACS_peak_12038	3100	460	0	1	0	gen
20	47703752	47704060	MACS_peak_12040	205.98	308	0	1	0	gen
20	47712378	47712775	MACS_peak_12041	455.48	397	0	1	0	gen
20	47786535	47787010	MACS_peak_12043	398.43	475	0	0	0	intergen
20	47818133	47818371	MACS_peak_12044	342.82	238	0	0	0	intergen
20	47854773	47855155	MACS_peak_12045	316.99	382	0	0	0	intergen
20	47863162	47863369	MACS_peak_12046	892.44	207	0	0	0	intergen
20	47879971	47880422	MACS_peak_12047	260.52	451	0	0	0	intergen
20	47972249	47972456	MACS_peak_12048	421.12	207	0	0	0	intergen
20	48043092	48043315	MACS_peak_12050	273.64	223	0	0	0	intergen
20	48109016	48109302	MACS_peak_12051	269.85	286	0	0	0	intergen
20	48125181	48125429	MACS_peak_12052	213.02	248	0	0	0	intergen
20	48189249	48189577	MACS_peak_12053	1593.98	328	0	0	0	intergen
20	48241304	48241555	MACS_peak_12054	586.01	251	0	0	0	intergen
20	48261240	48261386	MACS_peak_12055	698.96	146	0	0	0	intergen
20	48295622	48295941	MACS_peak_12056	555.62	319	0	0	0	intergen
20	48329957	48330213	MACS_peak_12057	308.41	256	0	0	0	intergen
20	48404654	48405026	MACS_peak_12058	438.95	372	0	0	0	intergen
20	48446915	48447246	MACS_peak_12059	2505.85	331	0	0	0	intergen
20	48485318	48485590	MACS_peak_12060	262.15	272	0	0	0	intergen
20	48561352	48561722	MACS_peak_12061	272.05	370	0	0	0	intergen
20	48578478	48578749	MACS_peak_12062	299.04	271	0	0	0	intergen
20	48620538	48620839	MACS_peak_12063	2554.36	301	1	0	0	promoter
20	48620934	48621364	MACS_peak_12064	2841.36	430	1	0	0	promoter
20	48635820	48636097	MACS_peak_12065	2385.45	277	0	1	0	gen
20	48656874	48657166	MACS_peak_12066	1001.1	292	0	1	0	gen
20	48657732	48658047	MACS_peak_12067	934.07	315	0	1	0	gen
20	48717492	48717662	MACS_peak_12068	640.38	170	0	1	0	gen
20	48745499	48745823	MACS_peak_12069	257.04	324	0	1	0	gen
20	49065208	49065347	MACS_peak_12071	471.15	139	0	1	0	gen
20	49082684	49083032	MACS_peak_12072	480.06	348	0	1	0	gen
20	49132946	49133243	MACS_peak_12073	565.98	297	0	1	0	gen
20	49333876	49334241	MACS_peak_12074	1236.43	365	0	1	1	gen
20	49384428	49384810	MACS_peak_12075	398.65	382	0	1	1	gen
20	49396321	49396531	MACS_peak_12076	1028.85	210	0	1	1	gen
20	49484238	49484546	MACS_peak_12077	438.15	308	0	0	0	intergen
20	49541712	49541971	MACS_peak_12078	1297.26	259	0	1	0	gen
20	49786766	49786992	MACS_peak_12079	1845.39	226	0	0	0	intergen
20	49858144	49858392	MACS_peak_12080	763.02	248	0	1	0	gen
20	49888465	49888806	MACS_peak_12081	659.85	341	0	1	0	gen
20	49928689	49929018	MACS_peak_12082	1978.65	329	0	0	0	intergen
20	49943768	49943908	MACS_peak_12083	1345.15	140	0	1	0	gen
20	49964863	49965146	MACS_peak_12084	463.58	283	0	0	0	intergen
20	49978913	49979347	MACS_peak_12085	574.22	434	1	0	0	promoter
20	50071339	50071667	MACS_peak_12086	1317.25	328	0	0	0	intergen
20	50085439	50085720	MACS_peak_12087	925.1	281	2	0	0	promoter
20	50120862	50121119	MACS_peak_12088	714.38	257	1	1	0	promoter
20	50152393	50152607	MACS_peak_12089	853.56	214	0	2	0	gen
20	50169435	50169685	MACS_peak_12090	970.95	250	0	0	1	other
20	50460820	50461089	MACS_peak_12091	725.24	269	0	0	0	intergen
20	50461166	50461485	MACS_peak_12092	2025.37	319	0	0	0	intergen
20	50464344	50464636	MACS_peak_12093	608.29	292	0	0	0	intergen
20	50479820	50480150	MACS_peak_12094	1065.38	330	0	0	0	intergen
20	50506226	50506450	MACS_peak_12095	435.1	224	1	0	0	promoter
20	50568489	50568737	MACS_peak_12096	471.88	248	0	1	0	gen
20	50575923	50576270	MACS_peak_12097	1492.56	347	0	1	1	gen
20	50580079	50580456	MACS_peak_12098	612.45	377	0	1	0	gen
20	50588121	50588385	MACS_peak_12099	444.64	264	1	0	0	promoter
20	50626010	50626374	MACS_peak_12100	619.89	364	0	1	0	gen
20	50635952	50636311	MACS_peak_12101	1212.36	359	0	1	0	gen
20	50677361	50677699	MACS_peak_12102	229.16	338	0	1	0	gen
20	50717183	50717542	MACS_peak_12105	144.71	359	0	0	0	intergen
20	50718071	50718309	MACS_peak_12106	158.88	238	0	0	0	intergen
20	50720655	50720906	MACS_peak_12108	184.74	251	0	0	0	intergen
20	50721305	50721648	MACS_peak_12109	138.58	343	0	0	0	intergen
20	50738794	50739206	MACS_peak_12110	722	412	0	1	0	gen
20	50744655	50744963	MACS_peak_12111	436.41	308	0	1	0	gen
20	50747257	50747590	MACS_peak_12112	103.58	333	0	1	0	gen
20	50758765	50759092	MACS_peak_12114	125.66	327	0	0	0	intergen
20	50762968	50763335	MACS_peak_12115	124.78	367	0	0	0	intergen
20	50763475	50763796	MACS_peak_12116	186.76	321	0	0	0	intergen
20	50764258	50764572	MACS_peak_12117	270.75	314	0	0	0	intergen
20	50775564	50775992	MACS_peak_12118	2655.87	428	0	0	0	intergen
20	50780992	50781288	MACS_peak_12119	166.69	296	0	0	0	intergen
20	50790661	50791141	MACS_peak_12121	1381.71	480	1	0	0	promoter
20	50794712	50795137	MACS_peak_12123	3100	425	1	0	0	promoter
20	50813006	50813384	MACS_peak_12124	98.54	378	0	1	0	gen
20	50832267	50832535	MACS_peak_12125	380.3	268	0	1	0	gen
20	50929307	50929720	MACS_peak_12126	968.33	413	0	1	0	gen
20	50981531	50981780	MACS_peak_12127	1637.3	249	0	0	0	intergen
20	50987687	50988119	MACS_peak_12128	405.22	432	0	0	0	intergen
20	51015145	51015363	MACS_peak_12129	549.31	218	0	1	0	gen
20	51313601	51313903	MACS_peak_12130	546.57	302	0	0	0	intergen
20	51318123	51318513	MACS_peak_12131	509.84	390	0	0	0	intergen
20	51318814	51319101	MACS_peak_12132	701.46	287	0	0	0	intergen
20	51326333	51326615	MACS_peak_12133	808.23	282	0	0	0	intergen
20	51517906	51518080	MACS_peak_12134	664.25	174	0	1	0	gen
20	51594946	51595390	MACS_peak_12135	388.99	444	1	0	0	promoter
20	51624362	51624600	MACS_peak_12136	415.95	238	0	1	0	gen
20	51700801	51701070	MACS_peak_12137	1091.86	269	0	1	0	gen
20	51704091	51704310	MACS_peak_12138	566.67	219	0	1	0	gen
20	51712505	51712776	MACS_peak_12139	777.55	271	0	1	0	gen
20	51800037	51800418	MACS_peak_12140	784.36	381	0	1	0	gen
20	51961567	51961872	MACS_peak_12141	845.82	305	0	0	0	intergen
20	52031161	52031296	MACS_peak_12142	1468.78	135	0	0	0	intergen
20	52083749	52083958	MACS_peak_12143	525.79	209	0	1	0	gen
20	52150599	52151039	MACS_peak_12144	717.1	440	0	1	0	gen
20	52242524	52242921	MACS_peak_12145	722.05	397	0	0	1	other
20	52312173	52312444	MACS_peak_12146	715.34	271	0	0	1	other
20	52379786	52380029	MACS_peak_12147	651.03	243	0	0	1	other
20	52546539	52546893	MACS_peak_12148	64.7	354	0	0	1	other
20	52553865	52554036	MACS_peak_12149	514.2	171	0	0	1	other
20	53154937	53155069	MACS_peak_12150	1090.31	132	0	1	0	gen
20	53413208	53413413	MACS_peak_12151	629.38	205	0	1	1	gen
20	53500048	53500306	MACS_peak_12153	342.51	258	0	0	1	other
20	53547763	53548036	MACS_peak_12154	749.8	273	0	0	0	intergen
20	53580532	53580994	MACS_peak_12156	415.02	462	0	1	0	gen
20	53586551	53586926	MACS_peak_12157	68.83	375	0	1	0	gen
20	53594032	53594287	MACS_peak_12158	225.39	255	0	1	0	gen
20	53594869	53595201	MACS_peak_12159	115.77	332	0	1	0	gen
20	53597027	53597272	MACS_peak_12160	105.82	245	0	1	0	gen
20	53609241	53609483	MACS_peak_12161	88.89	242	0	1	1	gen
20	53610405	53610715	MACS_peak_12162	170.04	310	0	0	1	other
20	53615639	53615933	MACS_peak_12164	120.95	294	0	0	1	other
20	53621260	53621592	MACS_peak_12166	89.57	332	0	0	1	other
20	53623615	53623991	MACS_peak_12168	58.95	376	0	0	1	other
20	53655518	53655834	MACS_peak_12171	61.98	316	0	0	0	intergen
20	53661974	53662209	MACS_peak_12172	223.12	235	0	0	0	intergen
20	53665202	53665490	MACS_peak_12173	122.85	288	0	0	0	intergen
20	53672122	53672418	MACS_peak_12174	67.08	296	0	0	0	intergen
20	53673614	53673916	MACS_peak_12175	71.08	302	0	0	0	intergen
20	53674339	53674663	MACS_peak_12176	133.66	324	0	0	0	intergen
20	53708609	53708921	MACS_peak_12179	78.93	312	0	0	0	intergen
20	53711935	53712305	MACS_peak_12180	65.35	370	0	0	0	intergen
20	53715417	53715790	MACS_peak_12181	54.81	373	0	0	0	intergen
20	53722836	53723108	MACS_peak_12183	115.17	272	0	0	0	intergen
20	53736659	53736936	MACS_peak_12186	165.99	277	0	0	0	intergen
20	53741808	53742132	MACS_peak_12187	57.42	324	0	0	0	intergen
20	53742679	53742998	MACS_peak_12188	76.45	319	0	0	0	intergen
20	53755995	53756458	MACS_peak_12190	138.78	463	0	0	0	intergen
20	53759310	53759687	MACS_peak_12191	81.72	377	0	0	0	intergen
20	53759698	53760001	MACS_peak_12192	157	303	0	0	0	intergen
20	53760524	53760823	MACS_peak_12193	70.07	299	0	0	0	intergen
20	53776506	53776755	MACS_peak_12194	369.32	249	0	0	0	intergen
20	53781318	53781736	MACS_peak_12195	52.64	418	0	0	0	intergen
20	53782843	53783202	MACS_peak_12196	110.74	359	0	0	0	intergen
20	53785901	53786298	MACS_peak_12198	86.42	397	0	0	0	intergen
20	53787012	53787421	MACS_peak_12199	163.61	409	0	0	0	intergen
20	53787650	53787916	MACS_peak_12200	219.51	266	0	0	0	intergen
20	53791609	53791979	MACS_peak_12201	79.3	370	0	0	0	intergen
20	53796067	53796467	MACS_peak_12202	113.85	400	0	0	0	intergen
20	53798393	53798654	MACS_peak_12203	75.25	261	0	0	0	intergen
20	53805120	53805350	MACS_peak_12204	120.47	230	0	0	0	intergen
20	53807451	53807679	MACS_peak_12205	126.17	228	0	0	0	intergen
20	53822110	53822468	MACS_peak_12206	57.37	358	0	0	0	intergen
20	53824925	53825163	MACS_peak_12207	464.33	238	0	0	0	intergen
20	53826558	53827009	MACS_peak_12208	203.09	451	0	0	0	intergen
20	53828760	53829140	MACS_peak_12209	74.36	380	0	0	0	intergen
20	53831117	53831421	MACS_peak_12210	72.75	304	0	0	0	intergen
20	53831647	53831829	MACS_peak_12211	225.5	182	0	0	0	intergen
20	53832329	53832625	MACS_peak_12212	51.21	296	0	0	0	intergen
20	53836486	53836845	MACS_peak_12213	67.68	359	0	0	0	intergen
20	53845295	53845591	MACS_peak_12214	85.66	296	0	0	0	intergen
20	53846103	53846537	MACS_peak_12215	145.76	434	0	0	0	intergen
20	53852189	53852485	MACS_peak_12216	96.02	296	0	0	0	intergen
20	53866268	53866596	MACS_peak_12218	258.55	328	0	0	0	intergen
20	53867229	53867597	MACS_peak_12219	104.12	368	0	0	0	intergen
20	53878174	53878375	MACS_peak_12222	201.89	201	0	0	0	intergen
20	53882659	53883049	MACS_peak_12223	90.14	390	0	0	0	intergen
20	53883485	53883746	MACS_peak_12224	178.26	261	0	0	0	intergen
20	53900163	53900508	MACS_peak_12225	80.32	345	0	0	0	intergen
20	53923167	53923555	MACS_peak_12227	177.4	388	0	0	0	intergen
20	53923906	53924185	MACS_peak_12228	87.25	279	0	0	0	intergen
20	53925616	53925933	MACS_peak_12229	65.71	317	0	0	0	intergen
20	53933527	53933834	MACS_peak_12230	98.05	307	1	0	0	promoter
20	53934492	53934921	MACS_peak_12231	263.37	429	1	0	0	promoter
20	53964263	53964595	MACS_peak_12235	60.74	332	0	1	0	gen
20	53967364	53967679	MACS_peak_12236	79.56	315	0	1	0	gen
20	53973240	53973541	MACS_peak_12237	1057.24	301	0	1	0	gen
20	53986029	53986433	MACS_peak_12238	53.77	404	0	1	0	gen
20	54003164	54003540	MACS_peak_12239	2134.5	376	0	1	0	gen
20	54007494	54007847	MACS_peak_12240	82.2	353	0	1	0	gen
20	54017291	54017611	MACS_peak_12241	144.48	320	0	1	0	gen
20	54018806	54019222	MACS_peak_12242	83.7	416	0	1	0	gen
20	54031779	54032126	MACS_peak_12243	98.36	347	0	1	0	gen
20	54037037	54037237	MACS_peak_12244	236	200	0	1	0	gen
20	54048786	54049139	MACS_peak_12245	125.26	353	0	1	0	gen
20	54062676	54063140	MACS_peak_12246	3180.83	464	0	1	0	gen
20	54067503	54067885	MACS_peak_12247	120.1	382	0	1	0	gen
20	54078099	54078355	MACS_peak_12248	114.74	256	0	0	0	intergen
20	54079989	54080359	MACS_peak_12249	62.25	370	0	0	0	intergen
20	54092990	54093437	MACS_peak_12250	418.53	447	0	0	0	intergen
20	54109381	54109525	MACS_peak_12253	523.63	144	0	0	0	intergen
20	54110557	54110904	MACS_peak_12254	124.34	347	0	0	0	intergen
20	54118292	54118597	MACS_peak_12255	95.22	305	0	0	0	intergen
20	54122132	54122269	MACS_peak_12256	895.37	137	0	0	0	intergen
20	54145941	54146248	MACS_peak_12257	103.74	307	0	0	0	intergen
20	54148388	54148672	MACS_peak_12258	132.29	284	0	0	0	intergen
20	54153474	54153895	MACS_peak_12259	1757.12	421	1	0	0	promoter
20	54155243	54155604	MACS_peak_12260	182.32	361	1	0	0	promoter
20	54155734	54156079	MACS_peak_12261	181.92	345	1	0	0	promoter
20	54167155	54167428	MACS_peak_12262	115.7	273	0	1	0	gen
20	54196475	54196852	MACS_peak_12264	88.13	377	0	0	0	intergen
20	54207693	54207989	MACS_peak_12267	3100	296	1	0	0	promoter
20	54214769	54215075	MACS_peak_12269	118.28	306	0	1	0	gen
20	54224193	54224327	MACS_peak_12271	514.05	134	0	1	0	gen
20	54233999	54234408	MACS_peak_12272	105.93	409	0	0	0	intergen
20	54240111	54240418	MACS_peak_12273	65.09	307	0	0	0	intergen
20	54296319	54296646	MACS_peak_12275	640.23	327	0	0	0	intergen
20	54301613	54301913	MACS_peak_12276	338.2	300	0	0	0	intergen
20	54302221	54302561	MACS_peak_12277	183.3	340	0	0	0	intergen
20	54308269	54308553	MACS_peak_12278	503.4	284	0	0	0	intergen
20	54314692	54314939	MACS_peak_12279	222.95	247	0	0	0	intergen
20	54335934	54336254	MACS_peak_12280	466.16	320	0	0	0	intergen
20	54344470	54344758	MACS_peak_12281	134.47	288	0	0	0	intergen
20	54354028	54354455	MACS_peak_12282	1994.45	427	0	0	0	intergen
20	54369500	54369826	MACS_peak_12283	113.35	326	0	0	0	intergen
20	54424206	54424562	MACS_peak_12284	2132.86	356	0	0	0	intergen
20	54425498	54425796	MACS_peak_12285	699.68	298	0	0	0	intergen
20	54427581	54427831	MACS_peak_12286	197.52	250	0	0	0	intergen
20	54442841	54443193	MACS_peak_12287	114.95	352	0	0	0	intergen
20	54445279	54445573	MACS_peak_12288	88.56	294	0	0	0	intergen
20	54457030	54457297	MACS_peak_12290	356.03	267	0	0	0	intergen
20	54459923	54460271	MACS_peak_12291	119.48	348	0	0	0	intergen
20	54479683	54479949	MACS_peak_12292	605.61	266	1	0	0	promoter
20	54482180	54482603	MACS_peak_12293	224.6	423	0	1	0	gen
20	54497358	54497818	MACS_peak_12294	119.23	460	0	1	0	gen
20	54524294	54524556	MACS_peak_12295	241.57	262	0	1	0	gen
20	54543393	54543727	MACS_peak_12296	213.11	334	0	1	0	gen
20	54553888	54554023	MACS_peak_12297	623.87	135	0	1	0	gen
20	54564078	54564460	MACS_peak_12298	80.11	382	0	1	0	gen
20	54572935	54573148	MACS_peak_12299	160.33	213	0	1	0	gen
20	54612951	54613429	MACS_peak_12300	257.15	478	0	1	0	gen
20	54614571	54614894	MACS_peak_12301	204.01	323	0	1	0	gen
20	54635214	54635380	MACS_peak_12302	368.19	166	0	1	0	gen
20	54645830	54645966	MACS_peak_12303	672.76	136	0	1	0	gen
20	54646759	54647235	MACS_peak_12304	1706.95	476	0	1	0	gen
20	54680859	54681322	MACS_peak_12307	2008.51	463	0	0	0	intergen
20	54702968	54703274	MACS_peak_12308	144.03	306	0	0	0	intergen
20	54708159	54708497	MACS_peak_12309	1311.3	338	0	0	0	intergen
20	54805856	54806075	MACS_peak_12313	218.58	219	0	0	0	intergen
20	54807558	54807875	MACS_peak_12314	204.97	317	0	0	0	intergen
20	54809405	54809789	MACS_peak_12315	154.31	384	0	0	0	intergen
20	54817557	54817848	MACS_peak_12317	118.65	291	0	0	0	intergen
20	54825417	54825738	MACS_peak_12319	128.17	321	0	0	0	intergen
20	54842234	54842664	MACS_peak_12320	222.37	430	0	0	0	intergen
20	54873358	54873520	MACS_peak_12321	327.5	162	0	0	0	intergen
20	54895489	54895849	MACS_peak_12322	185.16	360	0	0	0	intergen
20	54900919	54901211	MACS_peak_12323	186.49	292	0	0	0	intergen
20	54905331	54905657	MACS_peak_12324	81.52	326	0	0	0	intergen
20	54908421	54908803	MACS_peak_12325	239.42	382	0	0	0	intergen
20	54910325	54910687	MACS_peak_12326	89.73	362	0	0	0	intergen
20	54913040	54913352	MACS_peak_12327	1304.88	312	0	0	0	intergen
20	54925973	54926342	MACS_peak_12328	101.59	369	0	0	0	intergen
20	54927404	54927682	MACS_peak_12329	127.39	278	0	0	0	intergen
20	55182822	55183150	MACS_peak_12330	334.59	328	0	0	0	intergen
20	55229941	55230213	MACS_peak_12331	331.96	272	0	0	0	intergen
20	55293632	55293885	MACS_peak_12332	422.5	253	0	0	0	intergen
20	55309106	55309279	MACS_peak_12333	633.59	173	0	0	0	intergen
20	55341209	55341437	MACS_peak_12334	425.33	228	0	0	0	intergen
20	55379803	55380011	MACS_peak_12335	211.96	208	0	0	0	intergen
20	55380894	55381220	MACS_peak_12336	81.3	326	0	0	0	intergen
20	55415584	55415917	MACS_peak_12337	559.83	333	0	0	1	other
20	55415949	55416218	MACS_peak_12338	367.9	269	0	0	1	other
20	55578406	55578640	MACS_peak_12339	153.4	234	0	0	0	intergen
20	55579036	55579382	MACS_peak_12340	98.72	346	0	0	0	intergen
20	55580897	55581311	MACS_peak_12341	124.79	414	0	0	0	intergen
20	55596534	55596804	MACS_peak_12342	701	270	0	0	0	intergen
20	55804842	55805107	MACS_peak_12343	1059.44	265	0	0	0	intergen
20	55834359	55834602	MACS_peak_12344	483.55	243	0	0	0	intergen
20	55840684	55840905	MACS_peak_12345	526.7	221	0	0	0	intergen
20	55859811	55860186	MACS_peak_12346	72.37	375	0	0	0	intergen
20	55900473	55900760	MACS_peak_12348	69	287	0	0	0	intergen
20	55968253	55968547	MACS_peak_12349	488.85	294	0	0	0	intergen
20	56082826	56083075	MACS_peak_12350	215.43	249	0	0	0	intergen
20	56107009	56107386	MACS_peak_12351	51.7	377	0	0	0	intergen
20	56108776	56109124	MACS_peak_12352	96.54	348	0	0	0	intergen
20	56171143	56171605	MACS_peak_12353	682.69	462	0	0	0	intergen
20	56187908	56188089	MACS_peak_12354	644.42	181	0	0	0	intergen
20	56247949	56248276	MACS_peak_12356	845.32	327	1	0	0	promoter
20	56318859	56319164	MACS_peak_12357	748.12	305	0	0	0	intergen
20	56400108	56400336	MACS_peak_12358	465.76	228	0	1	0	gen
20	56505631	56506022	MACS_peak_12359	594.54	391	0	2	0	gen
20	56516133	56516556	MACS_peak_12360	611.86	423	1	2	0	promoter
20	56550477	56550913	MACS_peak_12361	719.6	436	0	0	0	intergen
20	56567219	56567582	MACS_peak_12362	229.83	363	0	0	0	intergen
20	56577524	56577868	MACS_peak_12363	1004.18	344	0	0	0	intergen
20	56630244	56630422	MACS_peak_12364	763.02	178	1	0	0	promoter
20	56766231	56766475	MACS_peak_12365	600.1	244	0	0	0	intergen
20	56974441	56974765	MACS_peak_12366	1055.39	324	0	0	0	intergen
20	56995615	56995964	MACS_peak_12367	380.3	349	0	0	0	intergen
20	57080790	57081086	MACS_peak_12368	380.3	296	0	0	0	intergen
20	57092030	57092415	MACS_peak_12369	512.49	385	0	0	0	intergen
20	57108652	57109027	MACS_peak_12370	389.66	375	0	0	0	intergen
20	57113231	57113583	MACS_peak_12371	100.11	352	0	0	0	intergen
20	57114452	57114933	MACS_peak_12372	230.23	481	0	0	0	intergen
20	57122705	57123005	MACS_peak_12373	78.64	300	0	0	0	intergen
20	57125801	57126153	MACS_peak_12374	111.22	352	0	0	0	intergen
20	57168936	57169246	MACS_peak_12375	112.84	310	1	0	0	promoter
20	57170970	57171337	MACS_peak_12376	106.21	367	1	0	0	promoter
20	57181041	57181424	MACS_peak_12378	110.79	383	0	1	0	gen
20	57188301	57188656	MACS_peak_12379	106.53	355	0	1	0	gen
20	57223599	57223968	MACS_peak_12381	941.41	369	0	1	0	gen
20	57227058	57227318	MACS_peak_12382	140.51	260	0	1	0	gen
20	57243213	57243679	MACS_peak_12383	136.48	466	0	1	0	gen
20	57243953	57244359	MACS_peak_12384	271.55	406	0	1	0	gen
20	57244505	57244874	MACS_peak_12385	553.55	369	0	1	0	gen
20	57252632	57252906	MACS_peak_12386	205.67	274	0	1	0	gen
20	57253899	57254150	MACS_peak_12387	166.83	251	0	1	0	gen
20	57259417	57259782	MACS_peak_12388	76.85	365	0	1	0	gen
20	57260249	57260622	MACS_peak_12389	74.36	373	0	1	0	gen
20	57264213	57264469	MACS_peak_12390	573.63	256	0	1	0	gen
20	57266532	57266908	MACS_peak_12391	119.61	376	0	0	0	intergen
20	57270181	57270512	MACS_peak_12392	295.72	331	0	0	1	other
20	57276957	57277417	MACS_peak_12393	225.68	460	0	0	1	other
20	57324850	57325084	MACS_peak_12394	451.72	234	1	0	0	promoter
20	57332471	57332876	MACS_peak_12395	1918.54	405	1	0	0	promoter
20	57335480	57335731	MACS_peak_12396	441.56	251	0	1	0	gen
20	57346420	57346691	MACS_peak_12397	1183.08	271	1	0	0	promoter
20	57381770	57382050	MACS_peak_12398	2736.2	280	0	0	0	intergen
20	57489166	57489500	MACS_peak_12399	717.09	334	0	0	0	intergen
20	57495304	57495608	MACS_peak_12400	981.84	304	1	0	0	promoter
20	57509731	57510064	MACS_peak_12401	1009.24	333	0	1	0	gen
20	57514287	57514551	MACS_peak_12402	724.8	264	0	1	0	gen
20	57597022	57597243	MACS_peak_12404	1198.86	221	0	0	0	intergen
20	57622532	57622834	MACS_peak_12405	1140.2	302	0	0	0	intergen
20	57693354	57693762	MACS_peak_12406	1539.63	408	0	1	0	gen
20	58087204	58087582	MACS_peak_12407	2170	378	0	0	0	intergen
20	58179558	58179902	MACS_peak_12408	1358.53	344	0	0	0	intergen
20	58197418	58197553	MACS_peak_12409	1358.26	135	0	0	0	intergen
20	58209799	58210195	MACS_peak_12410	2013.19	396	0	0	0	intergen
20	58233978	58234162	MACS_peak_12411	811.95	184	0	0	1	other
20	58246476	58246679	MACS_peak_12413	458.38	203	0	0	1	other
20	58275665	58275917	MACS_peak_12414	396.55	252	0	0	1	other
20	58304136	58304459	MACS_peak_12415	781.89	323	0	0	1	other
20	58403100	58403341	MACS_peak_12416	208.93	241	0	1	0	gen
20	58447699	58448169	MACS_peak_12417	812.61	470	0	1	0	gen
20	58481438	58481808	MACS_peak_12418	689.02	370	0	1	0	gen
20	58598631	58598911	MACS_peak_12419	659.03	280	0	0	2	other
20	58650547	58650935	MACS_peak_12420	1857.04	388	2	0	0	promoter
20	58807776	58807989	MACS_peak_12421	593.82	213	0	0	0	intergen
20	58836836	58837137	MACS_peak_12422	442.11	301	1	0	1	promoter
20	58870200	58870603	MACS_peak_12423	521.38	403	0	1	1	gen
20	58881055	58881330	MACS_peak_12424	765.83	275	0	1	1	gen
20	58913493	58913837	MACS_peak_12425	265.34	344	0	0	0	intergen
20	59081963	59082377	MACS_peak_12427	1056.71	414	0	0	0	intergen
20	59222426	59222791	MACS_peak_12429	409.04	365	0	1	0	gen
20	59234686	59234941	MACS_peak_12430	506	255	0	1	0	gen
20	59403810	59403996	MACS_peak_12431	712.32	186	0	0	0	intergen
20	59455815	59456005	MACS_peak_12432	665.57	190	0	0	0	intergen
20	59515678	59516050	MACS_peak_12433	758.92	372	0	0	0	intergen
20	59525533	59525823	MACS_peak_12434	1353.26	290	0	0	0	intergen
20	59560628	59560863	MACS_peak_12435	768.86	235	0	0	0	intergen
20	59571618	59571901	MACS_peak_12436	838.58	283	0	0	0	intergen
20	59572628	59572908	MACS_peak_12437	454.58	280	1	0	0	promoter
20	59598569	59598932	MACS_peak_12438	339.96	363	0	1	0	gen
20	59751192	59751374	MACS_peak_12439	729.14	182	0	1	0	gen
20	59783034	59783335	MACS_peak_12441	1007.44	301	0	1	0	gen
20	59856495	59856854	MACS_peak_12443	87.62	359	0	0	0	intergen
20	59948996	59949456	MACS_peak_12444	1932.82	460	0	0	0	intergen
20	60050235	60050580	MACS_peak_12446	722.05	345	0	0	0	intergen
20	60057392	60057648	MACS_peak_12447	484	256	0	0	1	other
20	60206260	60206563	MACS_peak_12448	396.51	303	0	0	1	other
20	60211113	60211406	MACS_peak_12449	885.17	293	0	0	1	other
20	60235262	60235626	MACS_peak_12450	388.99	364	0	0	1	other
20	60453882	60454222	MACS_peak_12452	421.18	340	0	0	1	other
20	60514851	60515245	MACS_peak_12453	74.41	394	0	0	1	other
20	60591033	60591214	MACS_peak_12454	1288.51	181	0	0	0	intergen
20	60616350	60616642	MACS_peak_12455	52.57	292	0	0	0	intergen
20	60781547	60781952	MACS_peak_12456	243.49	405	0	0	0	intergen
20	60851937	60852328	MACS_peak_12457	749.46	391	0	0	0	intergen
20	60982881	60983207	MACS_peak_12458	93.4	326	0	0	0	intergen
20	60993738	60994040	MACS_peak_12459	441.54	302	0	0	0	intergen
20	61141890	61142142	MACS_peak_12460	425.33	252	0	0	0	intergen
20	61229068	61229432	MACS_peak_12461	1307.34	364	0	0	0	intergen
20	61263123	61263421	MACS_peak_12462	565.28	298	0	1	0	gen
20	61422420	61422566	MACS_peak_12464	1011.88	146	0	1	0	gen
20	61675278	61675666	MACS_peak_12465	349.84	388	0	1	0	gen
20	61724562	61724825	MACS_peak_12466	465.4	263	0	1	0	gen
20	61896295	61896543	MACS_peak_12467	485.56	248	0	1	0	gen
20	61981123	61981285	MACS_peak_12468	1320.51	162	0	1	0	gen
20	62010900	62011120	MACS_peak_12469	564.54	220	0	1	0	gen
20	62136887	62137168	MACS_peak_12470	1192.27	281	1	0	0	promoter
20	62156858	62157188	MACS_peak_12471	426.3	330	0	1	0	gen
20	62260264	62260643	MACS_peak_12472	402.61	379	0	1	0	gen
20	62270687	62271076	MACS_peak_12473	202.06	389	0	1	0	gen
20	62302632	62302849	MACS_peak_12474	580.62	217	1	0	0	promoter
20	62668561	62668808	MACS_peak_12475	485.56	247	0	1	0	gen
20	62791573	62791805	MACS_peak_12476	1824.95	232	1	0	0	promoter
20	62808319	62808561	MACS_peak_12477	645.81	242	1	0	0	promoter
20	62822737	62823105	MACS_peak_12478	1444.83	368	0	1	0	gen
20	62900203	62900525	MACS_peak_12479	802.9	322	0	1	0	gen
20	62900776	62901115	MACS_peak_12480	421.69	339	0	1	0	gen
20	62907439	62907645	MACS_peak_12481	629.38	206	0	1	0	gen
20	63009141	63009379	MACS_peak_12482	516.86	238	1	0	0	promoter
20	63056486	63056688	MACS_peak_12483	1171.45	202	0	0	1	other
20	63145694	63145996	MACS_peak_12484	689.14	302	0	0	0	intergen
20	63183428	63183649	MACS_peak_12485	1226.97	221	0	0	0	intergen
20	63309551	63309772	MACS_peak_12486	883.81	221	0	1	0	gen
20	63381889	63382268	MACS_peak_12487	1017.46	379	0	0	0	intergen
20	63515241	63515394	MACS_peak_12488	885.16	153	0	0	0	intergen
20	63614270	63614524	MACS_peak_12489	629.32	254	0	1	0	gen
20	63706798	63707167	MACS_peak_12490	640.87	369	2	1	0	promoter
20	63909644	63909936	MACS_peak_12491	634.74	292	0	1	0	gen
20	64057793	64058047	MACS_peak_12492	470.06	254	0	1	0	gen
20	64102080	64102331	MACS_peak_12493	746.04	251	2	0	0	promoter
20	64117584	64117959	MACS_peak_12494	404.42	375	0	1	0	gen
20	28960169	28960528	MACS_peak_21694	411.87	359	0	0	0	intergen
20	28962024	28962400	MACS_peak_21695	636.35	376	0	0	0	intergen
20	28963896	28964272	MACS_peak_21696	403.97	376	0	0	0	intergen
20	28965768	28966144	MACS_peak_21697	636.35	376	0	0	0	intergen
20	28967640	28968016	MACS_peak_21698	760.2	376	0	0	0	intergen
20	28970533	28970868	MACS_peak_21699	791.99	335	0	0	0	intergen
20	28972405	28972740	MACS_peak_21700	664.12	335	0	0	0	intergen
20	28979893	28980269	MACS_peak_21704	517.34	376	0	0	0	intergen
20	28981765	28982141	MACS_peak_21705	760.2	376	0	0	0	intergen
20	28983637	28983972	MACS_peak_21706	423.72	335	0	0	0	intergen
20	28985509	28985885	MACS_peak_21707	636.35	376	0	0	0	intergen
20	28987381	28987716	MACS_peak_21708	664.12	335	0	0	0	intergen
20	28989253	28989629	MACS_peak_21709	760.2	376	0	0	0	intergen
20	28992997	28993332	MACS_peak_21711	423.72	335	0	0	0	intergen
20	28998613	28998942	MACS_peak_21713	544.83	329	0	0	0	intergen
20	29000485	29000820	MACS_peak_21714	541.11	335	0	0	0	intergen
20	29002357	29002692	MACS_peak_21715	423.72	335	0	0	0	intergen
20	29006101	29006436	MACS_peak_21717	541.11	335	0	0	0	intergen
21	8560176	8560322	MACS_peak_12495	551.28	146	0	0	0	intergen
21	8561391	8561719	MACS_peak_12496	50.92	328	0	0	0	intergen
21	8565297	8565667	MACS_peak_12497	57.77	370	0	0	0	intergen
21	8568219	8568511	MACS_peak_12498	1875.22	292	0	0	0	intergen
21	8703111	8703356	MACS_peak_12502	469.27	245	0	0	0	intergen
21	8996885	8997185	MACS_peak_12504	702.29	300	0	0	1	other
21	9142465	9142771	MACS_peak_12505	237.03	306	0	0	0	intergen
21	9162062	9162407	MACS_peak_12506	410.15	345	0	0	0	intergen
21	9246111	9246564	MACS_peak_12508	165.89	453	0	0	0	intergen
21	9246910	9247117	MACS_peak_12509	115.32	207	0	0	0	intergen
21	9247338	9247599	MACS_peak_12510	87.62	261	0	0	0	intergen
21	9283640	9283909	MACS_peak_12512	162.45	269	0	0	0	intergen
21	9289638	9290021	MACS_peak_12513	86.22	383	0	0	0	intergen
21	9292322	9292770	MACS_peak_12514	995.35	448	0	0	0	intergen
21	9320526	9320801	MACS_peak_12515	679.42	275	0	0	0	intergen
21	9958856	9959142	MACS_peak_12516	327.03	286	0	0	0	intergen
21	10048408	10048711	MACS_peak_12517	102.18	303	0	0	1	other
21	10081034	10081262	MACS_peak_12518	366.24	228	0	0	1	other
21	10166307	10166660	MACS_peak_12520	1311.15	353	0	0	0	intergen
21	10802363	10802790	MACS_peak_12522	57.57	427	0	0	0	intergen
21	10801366	10801674	MACS_peak_12523	81.7	308	0	0	0	intergen
21	10776922	10777212	MACS_peak_12525	62.38	290	0	0	0	intergen
21	10756595	10756996	MACS_peak_12526	87.75	401	0	0	0	intergen
21	10753656	10753998	MACS_peak_12527	59.66	342	0	0	0	intergen
21	10752233	10752520	MACS_peak_12528	139.25	287	0	0	0	intergen
21	10743196	10743561	MACS_peak_12529	63.68	365	0	0	0	intergen
21	10741533	10741800	MACS_peak_12530	68.86	267	0	0	0	intergen
21	10736552	10736894	MACS_peak_12531	122.09	342	0	0	0	intergen
21	10734631	10734879	MACS_peak_12532	140.46	248	0	0	0	intergen
21	10733457	10733782	MACS_peak_12533	93.78	325	0	0	0	intergen
21	10731771	10732090	MACS_peak_12534	90.37	319	0	0	0	intergen
21	10722788	10723226	MACS_peak_12536	165.58	438	0	0	0	intergen
21	10719729	10719953	MACS_peak_12537	191.53	224	0	0	0	intergen
21	10715054	10715376	MACS_peak_12538	164.31	322	0	0	0	intergen
21	10714372	10714767	MACS_peak_12539	139.69	395	0	0	0	intergen
21	10707982	10708364	MACS_peak_12541	114.81	382	0	0	0	intergen
21	10707341	10707802	MACS_peak_12542	259.62	461	0	0	0	intergen
21	10705107	10705561	MACS_peak_12543	462.45	454	0	0	0	intergen
21	10704562	10704960	MACS_peak_12544	125.31	398	0	0	0	intergen
21	10702741	10702959	MACS_peak_12545	157	218	0	0	0	intergen
21	10700440	10700698	MACS_peak_12546	140.79	258	0	0	0	intergen
21	10693463	10693679	MACS_peak_12547	202.93	216	0	0	0	intergen
21	10689700	10689920	MACS_peak_12549	121.64	220	0	0	0	intergen
21	10687292	10687598	MACS_peak_12550	100.3	306	0	0	0	intergen
21	10685167	10685547	MACS_peak_12551	261.56	380	0	0	0	intergen
21	10683184	10683508	MACS_peak_12552	125.17	324	0	0	0	intergen
21	10679314	10679553	MACS_peak_12553	135.91	239	0	0	0	intergen
21	10678897	10679116	MACS_peak_12554	469.54	219	0	0	0	intergen
21	10676543	10677005	MACS_peak_12556	225.73	462	0	0	0	intergen
21	10675968	10676367	MACS_peak_12557	66.96	399	0	0	0	intergen
21	10675491	10675707	MACS_peak_12558	70.15	216	0	0	0	intergen
21	10674478	10674821	MACS_peak_12559	209.34	343	0	0	0	intergen
21	10673944	10674288	MACS_peak_12560	60	344	0	0	0	intergen
21	10673177	10673571	MACS_peak_12561	178.22	394	0	0	0	intergen
21	10668855	10669295	MACS_peak_12563	113.82	440	0	0	0	intergen
21	10667100	10667565	MACS_peak_12565	92.79	465	0	0	0	intergen
21	10666548	10666931	MACS_peak_12566	55.29	383	0	0	0	intergen
21	10665113	10665432	MACS_peak_12567	79.36	319	0	0	0	intergen
21	10656605	10657049	MACS_peak_12573	93.96	444	0	0	0	intergen
21	10656217	10656486	MACS_peak_12574	168.62	269	0	0	0	intergen
21	10653883	10654315	MACS_peak_12576	247.45	432	0	0	0	intergen
21	10652836	10653056	MACS_peak_12577	442.83	220	0	0	0	intergen
21	10614258	10614581	MACS_peak_12578	278.73	323	0	0	0	intergen
21	10581390	10581607	MACS_peak_12579	697.43	217	0	1	1	gen
21	10513066	10513326	MACS_peak_12580	1460.78	260	0	0	2	other
21	10505823	10506041	MACS_peak_12581	266.88	218	0	0	2	other
21	10497092	10497284	MACS_peak_12582	418.87	192	0	0	2	other
21	10495841	10496034	MACS_peak_12583	363.38	193	0	0	2	other
21	10403055	10403419	MACS_peak_12584	226.85	364	0	0	0	intergen
21	10360091	10360326	MACS_peak_12585	359.65	235	0	0	0	intergen
21	12972338	12972657	MACS_peak_12587	78.57	319	0	0	0	intergen
21	12977435	12977785	MACS_peak_12588	89.9	350	0	0	0	intergen
21	12983229	12983519	MACS_peak_12589	63.52	290	0	0	0	intergen
21	13340703	13341007	MACS_peak_12592	423.73	304	0	0	0	intergen
21	13469821	13470190	MACS_peak_12593	168.86	369	0	0	1	other
21	14065568	14065727	MACS_peak_12596	592.81	159	0	0	2	other
21	14161588	14161956	MACS_peak_12597	641.52	368	0	1	0	gen
21	14202479	14202945	MACS_peak_12598	95.09	466	0	1	0	gen
21	14259692	14259962	MACS_peak_12599	585.73	270	0	0	1	other
21	14403704	14404106	MACS_peak_12600	487.83	402	0	0	0	intergen
21	14407999	14408369	MACS_peak_12601	97.48	370	0	0	0	intergen
21	14824674	14824969	MACS_peak_12602	172.39	295	0	0	2	other
21	14862824	14863148	MACS_peak_12603	488.85	324	0	0	2	other
21	14930876	14931292	MACS_peak_12606	79.17	416	0	0	2	other
21	14932236	14932649	MACS_peak_12607	89.5	413	0	0	2	other
21	14941710	14941869	MACS_peak_12608	886.06	159	0	0	2	other
21	15826056	15826411	MACS_peak_12609	529.16	355	0	1	0	gen
21	15894525	15894876	MACS_peak_12610	722.05	351	0	0	0	intergen
21	16150354	16150493	MACS_peak_12611	402.17	139	0	0	1	other
21	16172832	16173167	MACS_peak_12612	348.12	335	0	0	1	other
21	16184388	16184543	MACS_peak_12613	501.14	155	0	0	1	other
21	16295948	16296248	MACS_peak_12614	471.04	300	0	0	2	other
21	16359548	16359952	MACS_peak_12615	406.81	404	0	0	1	other
21	16410422	16410782	MACS_peak_12616	50.92	360	0	0	1	other
21	16544401	16544830	MACS_peak_12617	260.52	429	0	0	1	other
21	16772092	16772232	MACS_peak_12618	1111.4	140	0	0	1	other
21	16845720	16845866	MACS_peak_12619	1923.8	146	0	0	0	intergen
21	16971474	16971744	MACS_peak_12620	585.73	270	0	0	0	intergen
21	17031840	17032065	MACS_peak_12622	501.44	225	0	0	0	intergen
21	17036983	17037339	MACS_peak_12623	76.3	356	0	0	0	intergen
21	17093240	17093704	MACS_peak_12624	75.1	464	0	0	0	intergen
21	17164583	17164819	MACS_peak_12625	108.52	236	0	0	0	intergen
21	17168263	17168602	MACS_peak_12627	82.39	339	0	0	0	intergen
21	17328167	17328522	MACS_peak_12628	51.89	355	0	0	0	intergen
21	17332515	17332948	MACS_peak_12629	63.42	433	0	0	0	intergen
21	17378114	17378585	MACS_peak_12630	86.24	471	0	0	0	intergen
21	17381145	17381528	MACS_peak_12631	54.22	383	0	0	0	intergen
21	17726193	17726460	MACS_peak_12632	462.79	267	0	0	0	intergen
21	18873122	18873533	MACS_peak_12633	137.06	411	0	0	0	intergen
21	18988671	18988964	MACS_peak_12634	344.92	293	0	0	0	intergen
21	19152396	19152767	MACS_peak_12637	102.75	371	0	0	0	intergen
21	19813390	19813658	MACS_peak_12638	84.4	268	0	0	0	intergen
21	20310818	20311084	MACS_peak_12640	588.83	266	0	0	0	intergen
21	20955374	20955800	MACS_peak_12641	247.27	426	0	0	0	intergen
21	20971411	20971673	MACS_peak_12642	723.53	262	0	0	0	intergen
21	21232279	21232585	MACS_peak_12643	439.28	306	0	1	0	gen
21	21452758	21453083	MACS_peak_12644	428.92	325	0	1	0	gen
21	21529919	21530337	MACS_peak_12645	495.64	418	0	1	0	gen
21	22686665	22686954	MACS_peak_12646	129.9	289	0	0	0	intergen
21	22920600	22920983	MACS_peak_12648	115.8	383	0	0	0	intergen
21	23578015	23578319	MACS_peak_12649	507.7	304	0	0	0	intergen
21	23694499	23694717	MACS_peak_12650	580.62	218	0	0	0	intergen
21	24014459	24014698	MACS_peak_12651	931.22	239	0	0	0	intergen
21	24045734	24046012	MACS_peak_12652	709.17	278	0	0	1	other
21	24113392	24113690	MACS_peak_12653	443.84	298	0	0	0	intergen
21	24328804	24329148	MACS_peak_12654	125.63	344	0	0	0	intergen
21	24767304	24767535	MACS_peak_12655	414.64	231	0	0	0	intergen
21	25061356	25061491	MACS_peak_12656	1079.97	135	0	0	1	other
21	25591074	25591210	MACS_peak_12657	1061.85	136	0	1	0	gen
21	25708553	25708821	MACS_peak_12658	462.14	268	0	1	0	gen
21	25801547	25801858	MACS_peak_12659	812.5	311	0	0	0	intergen
21	25873091	25873225	MACS_peak_12660	1187.38	134	0	0	0	intergen
21	25921519	25921881	MACS_peak_12661	84.21	362	0	1	0	gen
21	25923532	25923837	MACS_peak_12662	93.78	305	0	1	0	gen
21	25923915	25924247	MACS_peak_12663	97.53	332	0	1	0	gen
21	26816021	26816242	MACS_peak_12664	883.81	221	0	0	0	intergen
21	26849464	26849731	MACS_peak_12665	1111.72	267	0	0	0	intergen
21	26896470	26896818	MACS_peak_12666	134.48	348	0	0	1	other
21	26897905	26898248	MACS_peak_12667	93.4	343	0	0	1	other
21	27576918	27577366	MACS_peak_12668	70.01	448	0	0	0	intergen
21	27580692	27580963	MACS_peak_12669	177.39	271	0	0	0	intergen
21	27759100	27759433	MACS_peak_12670	424.75	333	0	0	0	intergen
21	27759848	27760121	MACS_peak_12671	458.95	273	0	0	0	intergen
21	28051656	28051917	MACS_peak_12672	466.72	261	0	0	1	other
21	28166068	28166398	MACS_peak_12673	211.91	330	0	0	1	other
21	28681793	28682133	MACS_peak_12674	84.91	340	0	0	0	intergen
21	29090007	29090279	MACS_peak_12675	828.18	272	0	1	0	gen
21	29121637	29121842	MACS_peak_12676	797.18	205	0	1	0	gen
21	29801565	29801837	MACS_peak_12677	988.9	272	0	1	0	gen
21	29900929	29901246	MACS_peak_12678	139.09	317	0	1	0	gen
21	30008817	30008949	MACS_peak_12679	1116.4	132	0	0	0	intergen
21	30044525	30044790	MACS_peak_12680	1141.07	265	0	0	0	intergen
21	30313358	30313634	MACS_peak_12681	443.74	276	0	0	0	intergen
21	30341040	30341297	MACS_peak_12682	1300.21	257	1	0	0	promoter
21	30452139	30452362	MACS_peak_12683	434.23	223	0	0	0	intergen
21	30570779	30571215	MACS_peak_12684	842.56	436	0	0	0	intergen
21	30840906	30841364	MACS_peak_12685	141.21	458	0	0	0	intergen
21	30898699	30898891	MACS_peak_12686	964.09	192	0	0	0	intergen
21	31098570	31098833	MACS_peak_12687	465.4	263	0	0	0	intergen
21	31228123	31228356	MACS_peak_12688	652.42	233	0	1	0	gen
21	31507071	31507226	MACS_peak_12689	501.14	155	0	1	0	gen
21	31683944	31684175	MACS_peak_12690	532.66	231	0	1	0	gen
21	32225791	32226091	MACS_peak_12691	83.55	300	0	0	0	intergen
21	32601128	32601313	MACS_peak_12692	1348.66	185	0	2	0	gen
21	32653360	32653582	MACS_peak_12693	712.32	222	0	1	0	gen
21	32771808	32772042	MACS_peak_12694	548.99	234	0	0	0	intergen
21	33204358	33204591	MACS_peak_12695	299.43	233	0	0	0	intergen
21	33361377	33361574	MACS_peak_12696	1025.76	197	0	0	0	intergen
21	33605689	33606087	MACS_peak_12697	381.26	398	0	2	0	gen
21	33701990	33702233	MACS_peak_12698	333.51	243	0	2	0	gen
21	34201046	34201186	MACS_peak_12699	1663.42	140	0	0	1	other
21	34386590	34386737	MACS_peak_12700	972.07	147	0	1	0	gen
21	34390847	34391072	MACS_peak_12701	548.55	225	0	1	0	gen
21	34793554	34793722	MACS_peak_12702	814.37	168	0	1	0	gen
21	34849182	34849488	MACS_peak_12703	439.28	306	0	1	0	gen
21	35189851	35190145	MACS_peak_12704	506.92	294	0	1	0	gen
21	35342076	35342322	MACS_peak_12705	750.37	246	0	1	0	gen
21	35348579	35348809	MACS_peak_12706	797.17	230	0	1	0	gen
21	35616250	35616605	MACS_peak_12709	413.79	355	0	1	0	gen
21	35769129	35769487	MACS_peak_12710	527.43	358	0	1	0	gen
21	35769719	35770156	MACS_peak_12711	968.52	437	0	1	0	gen
21	35840317	35840570	MACS_peak_12712	470.06	253	0	1	0	gen
21	36123066	36123413	MACS_peak_12713	380.3	347	0	0	1	other
21	36209788	36209983	MACS_peak_12714	821	195	0	1	0	gen
21	36388368	36388596	MACS_peak_12715	675.78	228	1	0	0	promoter
21	36504205	36504495	MACS_peak_12716	698.94	290	0	1	1	gen
21	36685973	36686133	MACS_peak_12718	341.74	160	0	0	0	intergen
21	37776789	37777157	MACS_peak_12720	56.38	368	0	1	0	gen
21	38025679	38026015	MACS_peak_12721	158.81	336	0	1	1	gen
21	38159287	38159642	MACS_peak_12722	488.85	355	1	0	0	promoter
21	38356078	38356355	MACS_peak_12723	456.44	277	0	0	0	intergen
21	38458222	38458560	MACS_peak_12724	377.94	338	0	1	0	gen
21	38740420	38740683	MACS_peak_12725	394.37	263	0	0	1	other
21	38828194	38828514	MACS_peak_12726	158.81	320	0	0	0	intergen
21	39086708	39086902	MACS_peak_12727	827.89	194	0	0	0	intergen
21	39127555	39127782	MACS_peak_12728	533.53	227	0	0	0	intergen
21	39136253	39136507	MACS_peak_12729	580.75	254	0	0	0	intergen
21	39138130	39138491	MACS_peak_12730	1310.77	361	0	0	0	intergen
21	39175224	39175619	MACS_peak_12731	1136.83	395	1	0	0	promoter
21	39244769	39244955	MACS_peak_12732	421.25	186	0	1	0	gen
21	39248547	39248784	MACS_peak_12733	511.17	237	0	1	0	gen
21	39518347	39518704	MACS_peak_12734	1175.17	357	0	0	0	intergen
21	39691029	39691276	MACS_peak_12735	485.56	247	0	0	1	other
21	39788332	39788655	MACS_peak_12736	247.99	323	0	1	0	gen
21	40025645	40026026	MACS_peak_12737	120.95	381	0	1	0	gen
21	40026224	40026525	MACS_peak_12738	63.29	301	0	1	0	gen
21	40026531	40026828	MACS_peak_12739	116.67	297	0	1	0	gen
21	40037150	40037459	MACS_peak_12740	63.46	309	0	1	0	gen
21	40121045	40121252	MACS_peak_12741	1511.13	207	0	1	0	gen
21	40143885	40144121	MACS_peak_12742	670.71	236	0	1	0	gen
21	40345008	40345345	MACS_peak_12743	553.12	337	0	1	0	gen
21	40378455	40378769	MACS_peak_12744	556.94	314	0	1	0	gen
21	40386454	40386643	MACS_peak_12745	664.34	189	0	1	0	gen
21	40416604	40416925	MACS_peak_12746	710.46	321	0	1	0	gen
21	40452239	40452475	MACS_peak_12747	405.46	236	0	1	0	gen
21	40466875	40467212	MACS_peak_12748	780.31	337	0	1	0	gen
21	40637149	40637542	MACS_peak_12749	1075.17	393	0	1	0	gen
21	40725913	40726144	MACS_peak_12750	1306.46	231	0	1	0	gen
21	41121876	41122062	MACS_peak_12751	735.41	186	0	0	0	intergen
21	41170468	41170863	MACS_peak_12752	873.06	395	1	0	0	promoter
21	41347749	41347956	MACS_peak_12753	831.12	207	0	1	0	gen
21	41778293	41778505	MACS_peak_12754	763.02	212	0	0	0	intergen
21	41842674	41842805	MACS_peak_12755	1028.85	131	0	1	0	gen
21	41868552	41868907	MACS_peak_12756	488.85	355	0	1	0	gen
21	41933954	41934209	MACS_peak_12757	596.79	255	0	1	0	gen
21	42006340	42006668	MACS_peak_12758	802.83	328	0	1	0	gen
21	42107843	42108108	MACS_peak_12759	464.09	265	0	1	1	gen
21	42125916	42126234	MACS_peak_12760	676.68	318	0	1	0	gen
21	42258622	42258995	MACS_peak_12761	405.33	373	0	1	0	gen
21	43315185	43315396	MACS_peak_12763	543.04	211	0	0	0	intergen
21	43646696	43647133	MACS_peak_12764	600.34	437	0	1	0	gen
21	43789245	43789578	MACS_peak_12765	793.64	333	1	0	0	promoter
21	43810767	43811022	MACS_peak_12766	596.79	255	0	0	1	other
21	43907014	43907157	MACS_peak_12767	2712.67	143	0	1	0	gen
21	43975580	43975856	MACS_peak_12768	845.51	276	0	1	0	gen
21	44305004	44305243	MACS_peak_12769	645.81	239	0	0	0	intergen
21	44445325	44445457	MACS_peak_12770	1116.4	132	0	0	0	intergen
21	44479787	44480119	MACS_peak_12771	635.33	332	0	0	0	intergen
21	44793259	44793626	MACS_peak_12772	394.93	367	0	1	0	gen
21	44800180	44800438	MACS_peak_12773	468.72	258	0	1	0	gen
21	45137117	45137502	MACS_peak_12774	753.71	385	0	1	0	gen
21	45138619	45138975	MACS_peak_12775	587.32	356	0	1	0	gen
21	45140297	45140747	MACS_peak_12776	832.82	450	0	1	0	gen
21	45270236	45270473	MACS_peak_12777	498.83	237	0	1	0	gen
21	45309025	45309384	MACS_peak_12778	411.87	359	0	0	0	intergen
21	45555982	45556299	MACS_peak_12779	552.5	317	0	0	0	intergen
21	45880507	45880734	MACS_peak_12780	548.55	227	0	1	0	gen
21	45923287	45923528	MACS_peak_12781	501.16	241	0	1	0	gen
21	45973708	45973894	MACS_peak_12782	858.56	186	0	0	0	intergen
21	46020959	46021304	MACS_peak_12783	188.18	345	0	0	0	intergen
21	46147417	46147762	MACS_peak_12784	1329.55	345	0	1	0	gen
21	46285548	46285894	MACS_peak_12785	325.68	346	1	1	0	promoter
21	46639921	46640168	MACS_peak_12786	412.67	247	0	0	0	intergen
21	46661219	46661623	MACS_peak_12787	722.05	404	0	1	0	gen
21	46698297	46698592	MACS_peak_12788	220.43	295	0	0	0	intergen
21	9815528	9815729	MACS_peak_15851	645.81	201	0	0	0	intergen
21	9816937	9817138	MACS_peak_15852	645.81	201	0	0	0	intergen
21	9821581	9821954	MACS_peak_15853	405.33	373	0	0	0	intergen
21	13740229	13740407	MACS_peak_21759	763.02	178	0	0	0	intergen
21	13760406	13760652	MACS_peak_21760	1208.41	246	0	0	0	intergen
22	15850731	15850984	MACS_peak_12789	396.92	253	0	0	0	intergen
22	15791536	15791856	MACS_peak_12792	302.07	320	0	0	1	other
22	15777618	15777967	MACS_peak_12793	1197.24	349	0	0	1	other
22	15709865	15710212	MACS_peak_12795	195.48	347	0	1	0	gen
22	15704153	15704526	MACS_peak_12796	276.64	373	0	1	0	gen
22	15519277	15519644	MACS_peak_12797	695.38	367	0	0	0	intergen
22	16367550	16367886	MACS_peak_12798	122	336	0	0	0	intergen
22	16368722	16368935	MACS_peak_12799	136.49	213	0	0	0	intergen
22	16371339	16371652	MACS_peak_12801	58.63	313	0	0	0	intergen
22	16376730	16377113	MACS_peak_12803	112.76	383	0	0	0	intergen
22	16377807	16378090	MACS_peak_12804	105.65	283	0	0	0	intergen
22	16378835	16379121	MACS_peak_12805	96.97	286	0	0	0	intergen
22	16380882	16381277	MACS_peak_12806	394.8	395	0	0	0	intergen
22	16419306	16419562	MACS_peak_12807	597.36	256	0	0	0	intergen
22	16427097	16427328	MACS_peak_12808	577.34	231	0	0	0	intergen
22	16441057	16441310	MACS_peak_12809	1150.67	253	0	0	1	other
22	16448453	16448826	MACS_peak_12810	193.19	373	0	0	1	other
22	16540744	16541023	MACS_peak_12811	290.5	279	0	0	0	intergen
22	16662156	16662458	MACS_peak_12812	50.92	302	0	0	2	other
22	16905851	16906249	MACS_peak_12815	1041.47	398	0	0	0	intergen
22	16911367	16911779	MACS_peak_12816	3100	412	0	0	0	intergen
22	17039427	17039668	MACS_peak_12817	396.1	241	0	0	1	other
22	17227529	17227788	MACS_peak_12818	354.43	259	0	1	0	gen
22	18076134	18076328	MACS_peak_12819	678.9	194	1	0	0	promoter
22	18732658	18732983	MACS_peak_12826	197.81	325	0	0	0	intergen
22	18733037	18733370	MACS_peak_12827	247.3	333	0	0	0	intergen
22	18844973	18845455	MACS_peak_12828	857.07	482	0	0	0	intergen
22	18854337	18854653	MACS_peak_12829	669.42	316	0	0	1	other
22	18895091	18895442	MACS_peak_12832	77.48	351	0	0	0	intergen
22	18908458	18908741	MACS_peak_12833	452.74	283	3	0	0	promoter
22	18940352	18940661	MACS_peak_12834	375.24	309	0	1	1	gen
22	19037038	19037233	MACS_peak_12836	662.31	195	1	0	0	promoter
22	19947829	19948061	MACS_peak_12837	514.21	232	0	1	0	gen
22	20157082	20157255	MACS_peak_12838	780.06	173	0	0	0	intergen
22	20317648	20317932	MACS_peak_12839	575.25	284	1	0	0	promoter
22	20336881	20337215	MACS_peak_12840	129.98	334	0	0	0	intergen
22	18346106	18346367	MACS_peak_12842	380.3	261	0	0	0	intergen
22	18385600	18385892	MACS_peak_12843	451.98	292	0	0	1	other
22	18399298	18399577	MACS_peak_12845	341.94	279	0	0	0	intergen
22	18422784	18423151	MACS_peak_12848	135.94	367	0	0	1	other
22	20460511	20460655	MACS_peak_12849	2638.81	144	0	1	0	gen
22	20496427	20496694	MACS_peak_12850	462.79	267	1	0	0	promoter
22	20564217	20564577	MACS_peak_12851	488.85	360	0	1	0	gen
22	20741940	20742253	MACS_peak_12852	638.96	313	0	1	0	gen
22	20813763	20814081	MACS_peak_12853	432.66	318	0	1	0	gen
22	21119915	21120094	MACS_peak_12854	892.15	179	0	0	2	other
22	21279466	21279948	MACS_peak_12857	877.99	482	0	0	0	intergen
22	21290435	21290599	MACS_peak_12858	1235.97	164	0	0	0	intergen
22	21310211	21310441	MACS_peak_12859	254.88	230	0	0	1	other
22	21773330	21773602	MACS_peak_12861	265.34	272	0	1	0	gen
22	22100290	22100493	MACS_peak_12862	814.37	203	0	0	1	other
22	22156731	22157031	MACS_peak_12863	345.38	300	0	0	1	other
22	22174391	22174686	MACS_peak_12864	88.15	295	0	0	1	other
22	22191094	22191441	MACS_peak_12865	104.52	347	0	0	1	other
22	22277019	22277232	MACS_peak_12866	139.62	213	0	0	0	intergen
22	22280984	22281296	MACS_peak_12868	132.28	312	0	0	0	intergen
22	22636167	22636626	MACS_peak_12869	1080.06	459	0	0	0	intergen
22	22647948	22648235	MACS_peak_12870	701.46	287	1	0	0	promoter
22	22666584	22666915	MACS_peak_12871	795.3	331	0	0	0	intergen
22	22677038	22677241	MACS_peak_12872	629.38	203	0	0	0	intergen
22	22724225	22724522	MACS_peak_12873	444.41	297	0	0	0	intergen
22	22745746	22746003	MACS_peak_12874	469.39	257	0	0	0	intergen
22	22770179	22770495	MACS_peak_12875	433.75	316	0	0	0	intergen
22	22877007	22877356	MACS_peak_12876	101.19	349	0	0	0	intergen
22	23178489	23178702	MACS_peak_12877	1453.47	213	1	0	0	promoter
22	23433377	23433557	MACS_peak_12879	936.57	180	0	0	0	intergen
22	23453970	23454117	MACS_peak_12880	972.07	147	0	0	1	other
22	23591240	23591419	MACS_peak_12881	746.04	179	0	0	0	intergen
22	23666680	23667089	MACS_peak_12882	169.69	409	0	0	3	other
22	24064427	24064842	MACS_peak_12883	115.17	415	0	1	0	gen
22	24238761	24238987	MACS_peak_12885	548.55	226	0	1	0	gen
22	24259623	24259889	MACS_peak_12886	572.81	266	0	0	1	other
22	24650846	24651168	MACS_peak_12888	673.67	322	0	0	2	other
22	24663221	24663422	MACS_peak_12889	629.87	201	0	0	0	intergen
22	24758256	24758487	MACS_peak_12890	989.9	231	0	1	0	gen
22	24837623	24837951	MACS_peak_12892	592.91	328	0	1	0	gen
22	24850374	24850596	MACS_peak_12893	549.18	222	0	1	0	gen
22	25129652	25129882	MACS_peak_12894	517.97	230	0	1	0	gen
22	25202361	25202678	MACS_peak_12895	552.5	317	1	0	0	promoter
22	25867936	25868094	MACS_peak_12896	883.81	158	0	1	0	gen
22	26679086	26679307	MACS_peak_12897	729.14	221	0	0	1	other
22	27880875	27881118	MACS_peak_12898	501.16	243	0	1	0	gen
22	28086228	28086607	MACS_peak_12899	69.12	379	0	1	0	gen
22	28166688	28166941	MACS_peak_12900	113.19	253	0	1	0	gen
22	28168424	28168782	MACS_peak_12901	105.65	358	0	1	0	gen
22	28253237	28253522	MACS_peak_12902	451.52	285	0	1	0	gen
22	28334354	28334667	MACS_peak_12903	101.27	313	0	1	0	gen
22	28335812	28336008	MACS_peak_12904	199.82	196	0	1	0	gen
22	28655665	28655988	MACS_peak_12905	201.59	323	0	1	0	gen
22	28664344	28664616	MACS_peak_12907	58.24	272	0	1	0	gen
22	28781236	28781553	MACS_peak_12909	180.31	317	0	1	0	gen
22	28792047	28792180	MACS_peak_12910	1396.21	133	1	0	0	promoter
22	29040762	29040984	MACS_peak_12911	883.81	222	0	1	0	gen
22	29406094	29406250	MACS_peak_12912	1506.46	156	0	1	1	gen
22	29470463	29470753	MACS_peak_12913	570.92	290	0	0	1	other
22	29851683	29852034	MACS_peak_12915	345.59	351	0	0	0	intergen
22	30088900	30089245	MACS_peak_12916	1049.85	345	0	1	0	gen
22	31345834	31346054	MACS_peak_12918	564.54	220	0	1	0	gen
22	31687710	31688041	MACS_peak_12919	127.5	331	0	1	0	gen
22	32984159	32984481	MACS_peak_12922	430.51	322	0	1	0	gen
22	33000796	33001019	MACS_peak_12923	564.54	223	0	1	0	gen
22	33010705	33010920	MACS_peak_12924	744.83	215	0	1	0	gen
22	33217125	33217260	MACS_peak_12925	1965.34	135	0	1	0	gen
22	33579613	33579883	MACS_peak_12926	460.86	270	0	1	0	gen
22	33796600	33796788	MACS_peak_12927	883.81	188	0	1	0	gen
22	33923603	33923996	MACS_peak_12928	625.74	393	0	0	0	intergen
22	34061033	34061166	MACS_peak_12929	936.97	133	0	0	1	other
22	34414838	34415076	MACS_peak_12930	797.18	238	0	0	0	intergen
22	34613708	34614003	MACS_peak_12931	154.21	295	0	0	0	intergen
22	34625035	34625368	MACS_peak_12932	205.29	333	0	0	0	intergen
22	34677577	34677871	MACS_peak_12933	170.7	294	0	0	0	intergen
22	34701838	34701978	MACS_peak_12934	551.66	140	0	0	0	intergen
22	34749255	34749604	MACS_peak_12935	94.23	349	0	0	0	intergen
22	34790656	34791017	MACS_peak_12936	172.39	361	0	0	0	intergen
22	34821659	34822019	MACS_peak_12937	100.69	360	0	0	0	intergen
22	34877209	34877440	MACS_peak_12938	340.1	231	0	0	0	intergen
22	35550436	35550588	MACS_peak_12939	1434.33	152	0	1	0	gen
22	36730792	36731086	MACS_peak_12940	564.39	294	0	0	0	intergen
22	36757660	36757875	MACS_peak_12941	596.79	215	1	0	0	promoter
22	37201214	37201349	MACS_peak_12942	1054.55	135	1	0	0	promoter
22	38384978	38385365	MACS_peak_12943	74.22	387	0	1	1	gen
22	38385778	38386134	MACS_peak_12944	151.65	356	0	1	1	gen
22	39514453	39514733	MACS_peak_12945	454.58	280	0	1	0	gen
22	39529271	39529452	MACS_peak_12946	936.57	181	1	0	0	promoter
22	39932884	39933098	MACS_peak_12947	746.04	214	0	1	0	gen
22	39982634	39982877	MACS_peak_12948	210.25	243	0	0	0	intergen
22	40372014	40372313	MACS_peak_12949	429.01	299	1	2	0	promoter
22	40487702	40487986	MACS_peak_12950	452.13	284	0	1	0	gen
22	41125015	41125297	MACS_peak_12951	229.83	282	0	1	0	gen
22	42253851	42254109	MACS_peak_12952	380.3	258	0	1	0	gen
22	42820199	42820501	MACS_peak_12953	441.54	302	0	1	0	gen
22	43904569	43904861	MACS_peak_12954	1383.87	292	0	0	0	intergen
22	44735925	44736121	MACS_peak_12955	662.31	196	0	2	0	gen
22	48467216	48467465	MACS_peak_12956	525.98	249	0	0	0	intergen
22	48972015	48972284	MACS_peak_12957	461.5	269	0	0	0	intergen
22	48986167	48986533	MACS_peak_12958	52.27	366	0	0	0	intergen
22	49605030	49605205	MACS_peak_12959	780.06	175	0	0	1	other
22	49764579	49764766	MACS_peak_12960	508.73	187	0	0	0	intergen
22	49874273	49874416	MACS_peak_12961	983.72	143	0	1	0	gen
22	50273284	50273554	MACS_peak_12962	476.21	270	1	0	0	promoter
22	50276153	50276497	MACS_peak_12963	535.64	344	1	0	0	promoter
22	10673144	10673401	MACS_peak_21837	3100	257	0	0	0	intergen
22	10584906	10585130	MACS_peak_21838	866.35	224	0	0	0	intergen
22	10545142	10545413	MACS_peak_21840	1279.99	271	0	0	0	intergen
22	10538302	10538630	MACS_peak_21841	427.34	328	0	0	0	intergen
22	10536862	10537232	MACS_peak_21842	520.65	370	0	0	0	intergen
22	11590942	11591269	MACS_peak_21994	427.87	327	0	0	0	intergen
22	11592227	11592536	MACS_peak_21995	557.79	309	0	0	0	intergen
22	11596589	11596846	MACS_peak_21996	469.39	257	0	0	0	intergen
22	11292111	11292428	MACS_peak_21997	433.2	317	0	0	0	intergen
22	11286716	11286916	MACS_peak_21998	645.81	200	0	0	0	intergen
22	12692137	12692474	MACS_peak_21999	539.88	337	0	0	0	intergen
22	12724087	12724319	MACS_peak_22000	1472.64	232	0	0	0	intergen
22	11154704	11155039	MACS_peak_22001	423.72	335	0	0	0	intergen
22	11055807	11056147	MACS_peak_22002	421.18	340	0	0	0	intergen
22	11023044	11023196	MACS_peak_22003	918.92	152	0	0	0	intergen
22	12805167	12805519	MACS_peak_22004	415.24	352	0	0	0	intergen
22	10932448	10932879	MACS_peak_22005	489.37	431	0	0	0	intergen
22	25057278	25057471	MACS_peak_22007	678.9	193	0	1	1	gen
22	11703332	11703655	MACS_peak_22010	672.92	323	0	0	0	intergen
22	11715291	11715610	MACS_peak_22011	432.12	319	0	0	0	intergen
22	12872369	12872691	MACS_peak_22012	430.51	322	0	0	0	intergen
22	12899827	12900237	MACS_peak_22013	2760.93	410	0	0	0	intergen
22	16770160	16770613	MACS_peak_22014	479.21	453	0	0	0	intergen
X	588641	589082	MACS_peak_22015	388.99	441	0	0	0	intergen
X	932373	932759	MACS_peak_22016	472.62	386	0	0	0	intergen
X	1258666	1258958	MACS_peak_22017	272.05	292	0	0	0	intergen
X	1581313	1581526	MACS_peak_22018	596.79	213	0	0	0	intergen
X	1704308	1704588	MACS_peak_22019	67.19	280	0	0	0	intergen
X	1707795	1708106	MACS_peak_22020	54.41	311	0	0	0	intergen
X	3036716	3036943	MACS_peak_22021	548.55	227	1	0	0	promoter
X	5877211	5877636	MACS_peak_22027	1243.28	425	0	1	0	gen
X	6327768	6327908	MACS_peak_22028	1001.34	140	0	0	0	intergen
X	7132480	7132779	MACS_peak_22030	443.26	299	0	1	0	gen
X	8364788	8365129	MACS_peak_22031	420.68	341	0	0	0	intergen
X	8427342	8427563	MACS_peak_22032	729.14	221	0	0	0	intergen
X	8787267	8787472	MACS_peak_22035	282.79	205	1	0	0	promoter
X	8819314	8819450	MACS_peak_22036	1061.85	136	0	0	0	intergen
X	9021268	9021645	MACS_peak_22037	516.8	377	1	0	0	promoter
X	9427589	9427728	MACS_peak_22039	1220.56	139	0	0	0	intergen
X	9564917	9565147	MACS_peak_22040	218	230	0	1	0	gen
X	9791900	9792225	MACS_peak_22041	1104.73	325	0	1	0	gen
X	9875077	9875236	MACS_peak_22042	485.23	159	0	1	0	gen
X	10119597	10119870	MACS_peak_22043	1130.76	273	0	1	0	gen
X	10312501	10312737	MACS_peak_22044	814.37	236	0	0	1	other
X	10615958	10616288	MACS_peak_22045	426.3	330	0	1	0	gen
X	10643608	10643903	MACS_peak_22046	84.4	295	0	1	0	gen
X	10805065	10805532	MACS_peak_22047	76.84	467	0	1	0	gen
X	10805917	10806268	MACS_peak_22048	62.51	351	0	1	0	gen
X	10873205	10873577	MACS_peak_22049	136.93	372	0	0	1	other
X	10999267	10999482	MACS_peak_22050	138.17	215	0	0	1	other
X	11000599	11000961	MACS_peak_22051	53.5	362	0	0	1	other
X	11020033	11020360	MACS_peak_22052	111.55	327	0	0	1	other
X	11137593	11137857	MACS_peak_22053	464.74	264	1	0	0	promoter
X	11533108	11533520	MACS_peak_22054	1256.11	412	0	1	0	gen
X	11660530	11660674	MACS_peak_22055	831.35	144	0	1	0	gen
X	12109058	12109439	MACS_peak_22057	62.38	381	0	0	0	intergen
X	12109565	12109971	MACS_peak_22058	158.81	406	0	0	0	intergen
X	12362869	12363203	MACS_peak_22060	71.12	334	0	1	0	gen
X	12901535	12901946	MACS_peak_22061	860.78	411	0	0	0	intergen
X	13682877	13683255	MACS_peak_22062	55.51	378	0	0	0	intergen
X	13927278	13927541	MACS_peak_22063	591.18	263	0	1	0	gen
X	14016832	14017083	MACS_peak_22064	356.87	251	0	1	0	gen
X	14109348	14109737	MACS_peak_22065	100.26	389	0	0	0	intergen
X	14646620	14646863	MACS_peak_22067	519.74	243	0	1	0	gen
X	14683436	14683736	MACS_peak_22068	63.65	300	0	1	0	gen
X	14803828	14804196	MACS_peak_22069	60.54	368	0	0	0	intergen
X	15472401	15472632	MACS_peak_22072	532.66	231	0	2	0	gen
X	15647641	15647872	MACS_peak_22073	517.97	231	0	2	0	gen
X	15703943	15704174	MACS_peak_22074	517.97	231	0	1	0	gen
X	16212484	16212778	MACS_peak_22075	446.16	294	0	0	0	intergen
X	16233717	16234108	MACS_peak_22076	93.91	391	0	0	0	intergen
X	16409561	16409796	MACS_peak_22078	108.35	235	0	0	0	intergen
X	16409964	16410192	MACS_peak_22079	618.58	228	0	0	0	intergen
X	16499447	16499795	MACS_peak_22080	75.42	348	0	0	0	intergen
X	16953446	16953660	MACS_peak_22081	1453.47	214	0	1	0	gen
X	17784291	17784745	MACS_peak_22083	51.06	454	0	0	0	intergen
X	17788502	17788674	MACS_peak_22084	353.53	172	0	0	0	intergen
X	18210621	18210848	MACS_peak_22085	548.55	227	0	1	0	gen
X	18499250	18499567	MACS_peak_22086	603.02	317	0	1	0	gen
X	18600084	18600289	MACS_peak_22087	469.81	205	0	1	0	gen
X	18881559	18881822	MACS_peak_22088	591.18	263	0	0	0	intergen
X	19144233	19144679	MACS_peak_22089	87.18	446	0	0	0	intergen
X	19334100	19334455	MACS_peak_22090	1889.64	355	0	0	0	intergen
X	19394715	19394936	MACS_peak_22091	585.18	221	0	1	0	gen
X	19451994	19452347	MACS_peak_22092	2748.76	353	0	1	0	gen
X	19510832	19511116	MACS_peak_22093	101.22	284	0	1	0	gen
X	19544784	19545064	MACS_peak_22094	454.58	280	0	1	0	gen
X	19547226	19547462	MACS_peak_22095	662.31	236	0	1	0	gen
X	19554016	19554491	MACS_peak_22096	562.08	475	0	1	0	gen
X	19790645	19790888	MACS_peak_22097	645.81	243	0	1	0	gen
X	19887511	19887751	MACS_peak_22098	430.02	240	0	0	0	intergen
X	20127498	20127817	MACS_peak_22099	939.3	319	1	0	0	promoter
X	20252938	20253258	MACS_peak_22100	938.33	320	0	1	0	gen
X	20336648	20337084	MACS_peak_22101	69.45	436	0	0	0	intergen
X	20650739	20651152	MACS_peak_22102	52.4	413	0	0	0	intergen
X	20723462	20723780	MACS_peak_22104	55.23	318	0	0	0	intergen
X	20758582	20758848	MACS_peak_22105	73.08	266	0	0	0	intergen
X	20758903	20759301	MACS_peak_22106	68.51	398	0	0	0	intergen
X	20784357	20784645	MACS_peak_22107	149.97	288	0	0	1	other
X	20851275	20851636	MACS_peak_22108	157.2	361	0	0	1	other
X	21331267	21331720	MACS_peak_22109	64.79	453	0	0	1	other
X	21342892	21343242	MACS_peak_22110	69	350	0	0	1	other
X	21985286	21985579	MACS_peak_22111	446.75	293	0	1	0	gen
X	22081519	22081786	MACS_peak_22112	588.05	267	0	1	0	gen
X	22135829	22136227	MACS_peak_22113	622.71	398	0	1	0	gen
X	22898589	22898903	MACS_peak_22114	554.47	314	0	0	1	other
X	22898951	22899211	MACS_peak_22115	467.38	260	0	0	1	other
X	22901939	22902231	MACS_peak_22116	447.34	292	0	0	1	other
X	23089295	23089544	MACS_peak_22117	471.88	249	0	0	1	other
X	23761761	23761981	MACS_peak_22118	259.39	220	0	1	0	gen
X	23997714	23997863	MACS_peak_22119	340.32	149	0	1	0	gen
X	24016336	24016473	MACS_peak_22120	744.12	137	0	1	0	gen
X	24499015	24499350	MACS_peak_22121	791.99	335	0	1	0	gen
X	24805972	24806115	MACS_peak_22122	349.8	143	0	1	0	gen
X	25086261	25086394	MACS_peak_22123	1098.16	133	0	0	0	intergen
X	25191447	25191736	MACS_peak_22125	571.63	289	0	0	0	intergen
X	25523643	25523925	MACS_peak_22126	453.35	282	0	0	0	intergen
X	25668141	25668441	MACS_peak_22127	563.9	300	0	0	0	intergen
X	25848716	25848946	MACS_peak_22129	532.66	230	0	0	0	intergen
X	25938914	25939189	MACS_peak_22130	81.72	275	0	0	0	intergen
X	25988502	25988728	MACS_peak_22131	83.37	226	0	0	0	intergen
X	26180896	26181100	MACS_peak_22133	85.16	204	0	0	0	intergen
X	26183824	26184228	MACS_peak_22134	84.68	404	0	0	0	intergen
X	26235916	26236201	MACS_peak_22135	451.52	285	0	0	0	intergen
X	26651859	26652098	MACS_peak_22136	645.81	239	0	0	0	intergen
X	27403482	27403865	MACS_peak_22138	631.92	383	0	0	0	intergen
X	27685784	27685964	MACS_peak_22139	746.04	180	0	1	0	gen
X	28364513	28364866	MACS_peak_22140	114.28	353	0	0	0	intergen
X	29310009	29310230	MACS_peak_22141	252.33	221	0	1	0	gen
X	30570561	30570778	MACS_peak_22144	564.92	217	0	1	0	gen
X	30713031	30713243	MACS_peak_22145	511.33	212	0	1	2	gen
X	30735860	30736229	MACS_peak_22146	518.05	369	0	0	0	intergen
X	30865937	30866175	MACS_peak_22147	516.86	238	0	1	0	gen
X	31038974	31039147	MACS_peak_22148	780.06	173	0	0	0	intergen
X	31185516	31185723	MACS_peak_22149	473.4	207	0	1	0	gen
X	31333564	31333845	MACS_peak_22150	465.02	281	0	1	0	gen
X	31373039	31373370	MACS_peak_22151	65.84	331	0	1	0	gen
X	31587298	31587562	MACS_peak_22152	857.82	264	0	1	0	gen
X	32252585	32253033	MACS_peak_22153	1804.99	448	0	1	0	gen
X	33336942	33337182	MACS_peak_22155	645.81	240	0	1	0	gen
X	33471023	33471231	MACS_peak_22156	613.04	208	0	0	0	intergen
X	33635992	33636230	MACS_peak_22157	368.42	238	0	0	0	intergen
X	33640099	33640424	MACS_peak_22158	103.18	325	0	0	0	intergen
X	33815279	33815489	MACS_peak_22159	1116.4	210	0	0	1	other
X	34300953	34301307	MACS_peak_22160	1040.97	354	0	0	1	other
X	34419211	34419505	MACS_peak_22161	65.85	294	0	0	0	intergen
X	34419510	34419887	MACS_peak_22162	72.74	377	0	0	0	intergen
X	35433124	35433439	MACS_peak_22163	1236.43	315	0	0	0	intergen
X	35890659	35890996	MACS_peak_22165	312.33	337	0	0	0	intergen
X	36172855	36173109	MACS_peak_22166	58.33	254	0	1	0	gen
X	36465414	36465797	MACS_peak_22167	71.7	383	0	0	0	intergen
X	36470130	36470540	MACS_peak_22168	80.15	410	0	0	0	intergen
X	37563507	37563827	MACS_peak_22169	58.71	320	0	1	0	gen
X	37771772	37772112	MACS_peak_22170	53.94	340	0	1	0	gen
X	37772523	37772919	MACS_peak_22171	54.21	396	0	1	0	gen
X	37773649	37773919	MACS_peak_22172	69.48	270	0	1	0	gen
X	38166562	38166800	MACS_peak_22173	516.86	238	0	2	0	gen
X	38910732	38911081	MACS_peak_22174	99.05	349	0	0	0	intergen
X	39181386	39181703	MACS_peak_22175	75.01	317	0	0	0	intergen
X	39408743	39408971	MACS_peak_22176	342.86	228	0	0	1	other
X	40035042	40035265	MACS_peak_22177	434.23	223	0	0	0	intergen
X	40110566	40110730	MACS_peak_22178	1032.54	164	0	1	0	gen
X	40543859	40544260	MACS_peak_22179	868.4	401	0	0	0	intergen
X	40769863	40770187	MACS_peak_22180	180.31	324	0	0	0	intergen
X	41566996	41567374	MACS_peak_22181	87.81	378	0	1	0	gen
X	41643973	41644190	MACS_peak_22182	169.45	217	0	1	0	gen
X	41648905	41649227	MACS_peak_22183	93.4	322	0	1	0	gen
X	41812805	41813189	MACS_peak_22184	69.92	384	0	1	0	gen
X	41813361	41813795	MACS_peak_22185	78.1	434	0	1	0	gen
X	42007016	42007327	MACS_peak_22186	63.13	311	0	0	0	intergen
X	42205362	42205775	MACS_peak_22187	52.4	413	0	0	0	intergen
X	42562013	42562215	MACS_peak_22188	628.77	202	0	0	1	other
X	42594998	42595335	MACS_peak_22189	120.36	337	0	0	1	other
X	42812197	42812541	MACS_peak_22190	76.3	344	0	0	0	intergen
X	43673373	43673810	MACS_peak_22191	65.22	437	0	1	0	gen
X	43949704	43949970	MACS_peak_22192	463.44	266	1	0	0	promoter
X	44026586	44026958	MACS_peak_22193	327.36	372	0	0	0	intergen
X	45334454	45334927	MACS_peak_22195	1192.27	473	0	0	0	intergen
X	45575045	45575262	MACS_peak_22196	746.04	217	0	0	1	other
X	45604416	45604805	MACS_peak_22197	57.86	389	0	0	1	other
X	45848622	45848870	MACS_peak_22198	213.62	248	0	0	1	other
X	45943108	45943258	MACS_peak_22199	1225.32	150	0	0	0	intergen
X	46002910	46003223	MACS_peak_22200	158.81	313	0	0	0	intergen
X	46413862	46414211	MACS_peak_22202	68.62	349	0	0	0	intergen
X	46975706	46976010	MACS_peak_22203	201.59	304	0	1	0	gen
X	47280503	47280733	MACS_peak_22204	248.92	230	0	0	0	intergen
X	47312363	47312713	MACS_peak_22205	416.22	350	0	0	0	intergen
X	47714518	47714839	MACS_peak_22206	164.27	321	0	0	1	other
X	47790647	47791067	MACS_peak_22207	87.81	420	0	0	0	intergen
X	48205670	48205972	MACS_peak_22208	439.67	302	0	0	0	intergen
X	49338407	49338613	MACS_peak_22209	303.03	206	1	1	0	promoter
X	49529429	49529692	MACS_peak_22213	384.36	263	2	0	0	promoter
X	49624609	49624927	MACS_peak_22214	113.19	318	0	0	0	intergen
X	49884316	49884618	MACS_peak_22215	956.32	302	1	0	0	promoter
X	49915704	49915996	MACS_peak_22216	697.28	292	0	0	0	intergen
X	50580040	50580258	MACS_peak_22218	580.62	218	0	0	0	intergen
X	51016593	51017005	MACS_peak_22219	63.13	412	0	0	0	intergen
X	51248126	51248427	MACS_peak_22220	51.11	301	0	0	0	intergen
X	51267514	51267842	MACS_peak_22221	75.63	328	0	0	0	intergen
X	51275565	51275825	MACS_peak_22222	467.38	260	0	0	0	intergen
X	51420671	51421024	MACS_peak_22223	530.32	353	0	0	1	other
X	51625055	51625423	MACS_peak_22224	91.07	368	0	0	0	intergen
X	52009382	52009707	MACS_peak_22228	67.28	325	0	0	0	intergen
X	52134545	52134829	MACS_peak_22229	67.7	284	0	0	0	intergen
X	52227713	52227961	MACS_peak_22230	100.52	248	0	0	0	intergen
X	52527735	52527935	MACS_peak_22231	983.72	200	0	0	0	intergen
X	52728321	52728655	MACS_peak_22232	54.3	334	0	0	0	intergen
X	52878625	52879002	MACS_peak_22233	68.83	377	0	0	0	intergen
X	53025460	53025797	MACS_peak_22234	219.32	337	0	0	0	intergen
X	53147581	53147835	MACS_peak_22236	75.51	254	0	1	0	gen
X	53595901	53596136	MACS_peak_22237	662.31	235	0	1	0	gen
X	53698479	53698745	MACS_peak_22238	71.15	266	0	0	0	intergen
X	53698888	53699103	MACS_peak_22239	61.66	215	0	0	0	intergen
X	53771862	53772065	MACS_peak_22241	446.88	203	0	0	0	intergen
X	54144562	54144818	MACS_peak_22242	88.17	256	0	1	0	gen
X	54734473	54734733	MACS_peak_22243	136.58	260	0	0	0	intergen
X	54909285	54909629	MACS_peak_22244	51.34	344	0	0	0	intergen
X	54910652	54910940	MACS_peak_22245	628.33	288	0	0	0	intergen
X	54913121	54913402	MACS_peak_22246	250.65	281	0	0	0	intergen
X	54917638	54917920	MACS_peak_22247	75.01	282	1	0	0	promoter
X	54938438	54938749	MACS_peak_22248	137.06	311	0	1	0	gen
X	55049117	55049459	MACS_peak_22249	63.13	342	0	0	0	intergen
X	55830787	55831142	MACS_peak_22250	77	355	0	0	0	intergen
X	55905881	55906232	MACS_peak_22251	389.76	351	0	0	0	intergen
X	56326981	56327302	MACS_peak_22252	104.77	321	0	0	0	intergen
X	56524011	56524369	MACS_peak_22253	94.47	358	0	0	0	intergen
X	56585891	56586193	MACS_peak_22254	209.45	302	0	0	0	intergen
X	56871608	56871983	MACS_peak_22256	79.24	375	0	1	0	gen
X	56879687	56880068	MACS_peak_22257	56.38	381	0	1	0	gen
X	57299360	57299800	MACS_peak_22258	82.78	440	0	1	0	gen
X	57479769	57480143	MACS_peak_22259	198.49	374	0	1	0	gen
X	57633990	57634361	MACS_peak_22260	51.33	371	0	0	0	intergen
X	57697099	57697469	MACS_peak_22261	417.16	370	0	0	0	intergen
X	57697483	57697887	MACS_peak_22262	495.39	404	0	0	0	intergen
X	58482545	58482835	MACS_peak_22265	194.2	290	0	0	0	intergen
X	58487588	58487986	MACS_peak_22266	125.63	398	0	0	0	intergen
X	58488297	58488509	MACS_peak_22267	460.46	212	0	0	0	intergen
X	58494846	58495068	MACS_peak_22268	341.77	222	0	0	0	intergen
X	58496026	58496333	MACS_peak_22269	69	307	0	0	0	intergen
X	58502029	58502319	MACS_peak_22270	194.2	290	0	0	0	intergen
X	58525205	58525441	MACS_peak_22271	51.5	236	0	0	0	intergen
X	58528409	58528614	MACS_peak_22272	244.06	205	0	0	0	intergen
X	58529969	58530310	MACS_peak_22273	266.04	341	0	0	0	intergen
X	62509310	62509596	MACS_peak_22274	127.33	286	0	0	0	intergen
X	62523559	62523873	MACS_peak_22275	51.76	314	0	0	0	intergen
X	62531117	62531354	MACS_peak_22276	135.37	237	0	0	0	intergen
X	62532253	62532453	MACS_peak_22277	144.67	200	0	0	0	intergen
X	62535396	62535754	MACS_peak_22279	150.64	358	0	0	0	intergen
X	62540564	62540946	MACS_peak_22280	125.31	382	0	0	0	intergen
X	62543241	62543599	MACS_peak_22281	54.92	358	0	0	0	intergen
X	62563642	62564082	MACS_peak_22282	79.24	440	0	0	0	intergen
X	62566432	62566656	MACS_peak_22283	171.03	224	0	0	0	intergen
X	62593295	62593504	MACS_peak_22284	123.57	209	0	0	0	intergen
X	62593885	62594316	MACS_peak_22285	207.81	431	0	0	0	intergen
X	62599965	62600213	MACS_peak_22286	53.36	248	0	0	0	intergen
X	62609898	62610247	MACS_peak_22288	124.64	349	0	0	0	intergen
X	62613979	62614196	MACS_peak_22289	106.78	217	0	0	0	intergen
X	62616266	62616587	MACS_peak_22290	109.53	321	0	0	0	intergen
X	62633356	62633744	MACS_peak_22292	129.4	388	0	0	0	intergen
X	62635232	62635542	MACS_peak_22293	137.06	310	0	0	0	intergen
X	62639416	62639691	MACS_peak_22294	113.43	275	0	0	0	intergen
X	62644166	62644521	MACS_peak_22295	50.92	355	0	0	0	intergen
X	62651112	62651529	MACS_peak_22296	63.82	417	0	0	0	intergen
X	62656032	62656360	MACS_peak_22297	113.55	328	0	0	0	intergen
X	62689659	62689851	MACS_peak_22299	189.46	192	0	0	0	intergen
X	62691104	62691403	MACS_peak_22300	75.01	299	0	0	0	intergen
X	62861074	62861529	MACS_peak_22301	89.02	455	0	0	0	intergen
X	62880808	62881188	MACS_peak_22302	61.75	380	0	0	1	other
X	63151187	63151558	MACS_peak_22303	87.75	371	0	0	0	intergen
X	63184560	63184750	MACS_peak_22304	115.56	190	0	0	0	intergen
X	63194384	63194773	MACS_peak_22306	76.01	389	0	0	0	intergen
X	63250341	63250593	MACS_peak_22307	470.06	252	0	0	0	intergen
X	63320103	63320386	MACS_peak_22308	84.4	283	0	0	0	intergen
X	63447981	63448242	MACS_peak_22309	62.38	261	0	0	1	other
X	63523203	63523585	MACS_peak_22310	61.19	382	0	0	1	other
X	63625444	63625861	MACS_peak_22311	341.87	417	0	0	0	intergen
X	63938534	63938872	MACS_peak_22312	119.91	338	0	0	0	intergen
X	63971222	63971503	MACS_peak_22313	63.27	281	0	0	0	intergen
X	64134628	64134956	MACS_peak_22315	52.52	328	0	0	0	intergen
X	64276968	64277342	MACS_peak_22316	96.14	374	0	1	0	gen
X	64319383	64319698	MACS_peak_22317	77.81	315	0	1	0	gen
X	64498132	64498465	MACS_peak_22318	91.73	333	0	0	0	intergen
X	64572135	64572405	MACS_peak_22319	119.44	270	0	0	0	intergen
X	64649972	64650327	MACS_peak_22320	64.79	355	0	0	0	intergen
X	64804240	64804625	MACS_peak_22321	77.4	385	0	0	0	intergen
X	64888813	64889272	MACS_peak_22322	51.48	459	0	0	0	intergen
X	65055039	65055389	MACS_peak_22323	115.17	350	0	0	0	intergen
X	65189047	65189510	MACS_peak_22324	66.96	463	0	0	0	intergen
X	65228290	65228628	MACS_peak_22325	147.82	338	0	0	0	intergen
X	65229623	65229902	MACS_peak_22326	70.96	279	0	0	0	intergen
X	65457802	65458186	MACS_peak_22327	68.83	384	0	1	0	gen
X	65528815	65529016	MACS_peak_22328	645.81	201	0	1	0	gen
X	65824900	65825248	MACS_peak_22329	92.5	348	0	0	0	intergen
X	65834554	65834750	MACS_peak_22330	87.36	196	0	0	0	intergen
X	66066461	66066770	MACS_peak_22332	51.71	309	0	0	0	intergen
X	66067240	66067502	MACS_peak_22333	55.93	262	0	0	0	intergen
X	66186019	66186466	MACS_peak_22334	185.97	447	0	1	0	gen
X	66213262	66213529	MACS_peak_22335	158.81	267	0	1	0	gen
X	66547206	66547555	MACS_peak_22336	158.32	349	0	0	0	intergen
X	66561917	66562248	MACS_peak_22337	121.01	331	0	0	0	intergen
X	66690696	66691071	MACS_peak_22338	107.53	375	0	0	0	intergen
X	66699836	66700060	MACS_peak_22339	614.29	224	0	0	0	intergen
X	66925483	66925940	MACS_peak_22340	84.48	457	0	0	0	intergen
X	66928770	66929132	MACS_peak_22341	75.54	362	0	0	0	intergen
X	67136523	67136934	MACS_peak_22342	114.31	411	0	0	0	intergen
X	67448862	67449082	MACS_peak_22343	273.64	220	0	0	0	intergen
X	67450952	67451254	MACS_peak_22344	136.55	302	0	0	0	intergen
X	67627841	67628209	MACS_peak_22345	60.72	368	0	1	0	gen
X	68217826	68218143	MACS_peak_22347	57.81	317	0	1	0	gen
X	68230129	68230352	MACS_peak_22348	116.6	223	0	1	0	gen
X	68380279	68380548	MACS_peak_22349	62.38	269	0	1	0	gen
X	68813259	68813559	MACS_peak_22351	439.97	300	0	0	0	intergen
X	68822688	68822921	MACS_peak_22352	678.9	233	0	0	0	intergen
X	69352189	69352341	MACS_peak_22353	429.41	152	0	0	0	intergen
X	69354031	69354397	MACS_peak_22354	106.56	366	0	0	0	intergen
X	69434330	69434596	MACS_peak_22355	62.7	266	0	0	0	intergen
X	69434730	69435117	MACS_peak_22356	71.9	387	0	0	0	intergen
X	69458912	69459277	MACS_peak_22357	95.69	365	0	0	0	intergen
X	69679111	69679384	MACS_peak_22358	89.89	273	0	1	0	gen
X	69680836	69681109	MACS_peak_22359	54.74	273	0	1	0	gen
X	69681310	69681788	MACS_peak_22360	92.26	478	0	1	0	gen
X	69749161	69749558	MACS_peak_22361	52.99	397	0	1	0	gen
X	69769205	69769526	MACS_peak_22362	431.05	321	0	1	0	gen
X	69826439	69826822	MACS_peak_22363	57.96	383	0	1	0	gen
X	69923762	69924020	MACS_peak_22364	509.73	258	0	1	0	gen
X	69986015	69986439	MACS_peak_22365	54.85	424	0	1	0	gen
X	70365418	70365750	MACS_peak_22366	79.37	332	0	1	0	gen
X	70517877	70518164	MACS_peak_22367	50.92	287	0	0	0	intergen
X	70554511	70554768	MACS_peak_22368	595.98	257	0	1	0	gen
X	70662392	70662671	MACS_peak_22370	147.82	279	0	1	0	gen
X	70731339	70731690	MACS_peak_22371	56.95	351	0	1	0	gen
X	70733012	70733398	MACS_peak_22372	114.63	386	0	1	0	gen
X	71071467	71071826	MACS_peak_22374	772.93	359	0	1	0	gen
X	71516533	71516858	MACS_peak_22375	405.72	325	0	1	0	gen
X	71652503	71652881	MACS_peak_22376	410.28	378	0	0	0	intergen
X	71697000	71697218	MACS_peak_22377	729.14	218	0	0	0	intergen
X	71702962	71703180	MACS_peak_22378	580.62	218	0	0	1	other
X	71778394	71778612	MACS_peak_22379	580.62	218	0	0	0	intergen
X	71784355	71784573	MACS_peak_22380	580.62	218	0	0	0	intergen
X	71999099	71999343	MACS_peak_22381	629.38	244	0	1	0	gen
X	72271163	72271398	MACS_peak_22382	502.51	235	0	2	0	gen
X	72660657	72661044	MACS_peak_22383	629.43	387	0	1	0	gen
X	72727711	72727975	MACS_peak_22384	464.74	264	0	0	0	intergen
X	72964943	72965286	MACS_peak_22385	63.13	343	0	0	0	intergen
X	73038956	73039317	MACS_peak_22386	69	361	0	0	0	intergen
X	73514503	73514719	MACS_peak_22388	145.8	216	0	0	0	intergen
X	73516514	73516866	MACS_peak_22389	86.73	352	0	0	0	intergen
X	74672985	74673236	MACS_peak_22390	57.61	251	0	0	0	intergen
X	74884263	74884568	MACS_peak_22391	84.4	305	0	1	0	gen
X	74956178	74956528	MACS_peak_22392	69	350	0	0	0	intergen
X	74991977	74992330	MACS_peak_22393	55.51	353	0	0	0	intergen
X	75023451	75023776	MACS_peak_22394	158.81	325	0	0	0	intergen
X	75249511	75249859	MACS_peak_22395	134.48	348	0	0	0	intergen
X	75263713	75264000	MACS_peak_22396	94.21	287	0	0	0	intergen
X	75451984	75452222	MACS_peak_22397	287.9	238	0	1	0	gen
X	75490834	75491251	MACS_peak_22398	80.46	417	0	1	0	gen
X	75492651	75493014	MACS_peak_22399	103.45	363	0	1	0	gen
X	75590118	75590446	MACS_peak_22400	68.83	328	0	0	0	intergen
X	75619520	75619874	MACS_peak_22401	142.05	354	0	0	0	intergen
X	75683548	75683804	MACS_peak_22402	158.81	256	0	0	0	intergen
X	75710129	75710508	MACS_peak_22403	114.74	379	0	0	0	intergen
X	76005198	76005501	MACS_peak_22404	81.1	303	0	0	0	intergen
X	76046951	76047315	MACS_peak_22405	165.41	364	0	0	0	intergen
X	76217206	76217567	MACS_peak_22406	147.41	361	0	0	0	intergen
X	76270748	76271121	MACS_peak_22407	101.95	373	0	0	0	intergen
X	76757722	76757945	MACS_peak_22408	161.29	223	0	0	1	other
X	76817807	76818093	MACS_peak_22409	126.97	286	0	0	1	other
X	76938705	76938882	MACS_peak_22410	233.74	177	0	0	1	other
X	77246167	77246420	MACS_peak_22411	51.21	253	0	0	0	intergen
X	77473878	77474222	MACS_peak_22412	63.29	344	0	0	0	intergen
X	77739953	77740185	MACS_peak_22413	941.25	232	0	1	0	gen
X	78403234	78403674	MACS_peak_22416	51.65	440	0	0	0	intergen
X	78448655	78448955	MACS_peak_22417	59.91	300	0	0	0	intergen
X	78552883	78553301	MACS_peak_22418	137.06	418	0	0	0	intergen
X	78855558	78855925	MACS_peak_22419	96.97	367	0	0	0	intergen
X	79057996	79058371	MACS_peak_22421	107.95	375	0	0	0	intergen
X	79086648	79087019	MACS_peak_22422	141.25	371	0	0	0	intergen
X	79509354	79509700	MACS_peak_22423	50.92	346	0	0	0	intergen
X	79768928	79769347	MACS_peak_22424	51.99	419	0	0	0	intergen
X	80018179	80018456	MACS_peak_22427	456.44	277	1	0	0	promoter
X	80202438	80202639	MACS_peak_22428	645.81	201	0	0	0	intergen
X	80262776	80262908	MACS_peak_22429	950.58	132	0	0	1	other
X	80409022	80409432	MACS_peak_22430	82.65	410	0	1	0	gen
X	80461019	80461333	MACS_peak_22431	996.37	314	0	0	0	intergen
X	80591749	80592122	MACS_peak_22432	142.05	373	0	0	0	intergen
X	81030009	81030356	MACS_peak_22433	56.13	347	0	0	0	intergen
X	81033955	81034275	MACS_peak_22434	56.38	320	0	0	0	intergen
X	81147884	81148140	MACS_peak_22435	127.5	256	0	1	0	gen
X	81673767	81674130	MACS_peak_22436	386.88	363	0	0	0	intergen
X	81748371	81748817	MACS_peak_22437	83.62	446	0	0	0	intergen
X	81772315	81772584	MACS_peak_22438	56.38	269	0	0	0	intergen
X	81795015	81795371	MACS_peak_22439	61.83	356	0	0	0	intergen
X	81795915	81796155	MACS_peak_22440	119.81	240	0	0	0	intergen
X	81841683	81841956	MACS_peak_22441	79.18	273	0	0	0	intergen
X	82551533	82551801	MACS_peak_22442	76.24	268	0	0	0	intergen
X	82995274	82995643	MACS_peak_22443	62.54	369	0	0	0	intergen
X	83030199	83030493	MACS_peak_22444	102.88	294	0	0	0	intergen
X	83085452	83085780	MACS_peak_22445	78.17	328	0	0	0	intergen
X	83282019	83282300	MACS_peak_22446	116.24	281	0	0	0	intergen
X	83291484	83291834	MACS_peak_22447	151.33	350	0	0	0	intergen
X	83753097	83753406	MACS_peak_22448	66.42	309	0	0	0	intergen
X	84560480	84560814	MACS_peak_22451	159.56	334	0	0	0	intergen
X	84729808	84730155	MACS_peak_22452	782.29	347	0	0	0	intergen
X	84874631	84874997	MACS_peak_22453	306.6	366	0	0	0	intergen
X	85060771	85061078	MACS_peak_22455	108.82	307	0	1	0	gen
X	85061279	85061597	MACS_peak_22456	74.3	318	0	1	0	gen
X	85111400	85111630	MACS_peak_22457	831.63	230	0	1	0	gen
X	86113892	86114299	MACS_peak_22459	71.07	407	0	0	0	intergen
X	86115498	86115871	MACS_peak_22460	59.12	373	0	0	0	intergen
X	86116255	86116668	MACS_peak_22461	104.69	413	0	0	0	intergen
X	86784183	86784483	MACS_peak_22462	563.9	300	0	1	0	gen
X	86973872	86974123	MACS_peak_22463	97.98	251	0	0	0	intergen
X	87024818	87025109	MACS_peak_22464	830.86	291	0	0	0	intergen
X	87118506	87118744	MACS_peak_22465	70.11	238	0	0	0	intergen
X	87220662	87221078	MACS_peak_22466	87.75	416	0	0	0	intergen
X	87413123	87413494	MACS_peak_22467	63.13	371	0	0	0	intergen
X	87446955	87447289	MACS_peak_22468	56.17	334	0	0	0	intergen
X	87447298	87447597	MACS_peak_22469	74.41	299	0	0	0	intergen
X	88174803	88174985	MACS_peak_22470	1309.25	182	0	0	0	intergen
X	88202201	88202521	MACS_peak_22471	431.58	320	0	0	0	intergen
X	88321207	88321544	MACS_peak_22472	93.4	337	0	0	0	intergen
X	88904969	88905205	MACS_peak_22473	502.51	236	0	0	0	intergen
X	88905607	88906051	MACS_peak_22474	714.62	444	0	0	0	intergen
X	90456395	90456658	MACS_peak_22476	591.18	263	0	0	0	intergen
X	92210125	92210257	MACS_peak_22478	1116.4	132	0	1	0	gen
X	93310521	93310777	MACS_peak_22479	69	256	0	0	0	intergen
X	93310818	93311159	MACS_peak_22480	80.3	341	0	0	0	intergen
X	93435272	93435615	MACS_peak_22481	265.34	343	0	0	0	intergen
X	93562798	93563143	MACS_peak_22482	164.26	345	0	0	0	intergen
X	93618544	93618963	MACS_peak_22483	70.04	419	0	0	0	intergen
X	93630290	93630606	MACS_peak_22484	116.65	316	0	0	0	intergen
X	94058793	94059118	MACS_peak_22485	428.92	325	0	0	0	intergen
X	94351824	94351986	MACS_peak_22486	848.95	162	0	0	0	intergen
X	94483105	94483329	MACS_peak_22487	262.62	224	0	0	0	intergen
X	94736833	94737066	MACS_peak_22488	290.1	233	0	0	0	intergen
X	94831450	94831662	MACS_peak_22489	623.41	212	0	0	0	intergen
X	95065913	95066195	MACS_peak_22490	453.35	282	0	0	0	intergen
X	95242500	95242700	MACS_peak_22491	628.77	200	0	0	0	intergen
X	95293599	95293893	MACS_peak_22492	828.03	294	0	0	0	intergen
X	95371306	95371670	MACS_peak_22493	76.3	364	0	0	0	intergen
X	95503430	95503582	MACS_peak_22494	834.31	152	0	0	0	intergen
X	95546932	95547295	MACS_peak_22495	94.61	363	0	0	0	intergen
X	95548216	95548570	MACS_peak_22496	50.32	354	0	0	0	intergen
X	95603536	95603912	MACS_peak_22497	206.05	376	0	0	0	intergen
X	95919120	95919352	MACS_peak_22498	532.66	232	0	0	0	intergen
X	96309076	96309362	MACS_peak_22499	835.66	286	0	0	0	intergen
X	96363279	96363620	MACS_peak_22500	158.81	341	0	0	0	intergen
X	96555550	96555801	MACS_peak_22501	596.67	251	0	0	0	intergen
X	96586829	96587062	MACS_peak_22502	74.81	233	0	0	0	intergen
X	96600084	96600419	MACS_peak_22503	54.01	335	0	0	0	intergen
X	97582764	97583078	MACS_peak_22504	103.79	314	0	1	1	gen
X	97974727	97974896	MACS_peak_22505	1025.76	169	0	0	0	intergen
X	98129836	98130042	MACS_peak_22506	573.39	206	0	0	0	intergen
X	98305436	98305727	MACS_peak_22507	70.87	291	0	0	0	intergen
X	98358370	98358758	MACS_peak_22508	117.75	388	0	0	0	intergen
X	98375412	98375589	MACS_peak_22509	1144.35	177	0	0	0	intergen
X	98395803	98396103	MACS_peak_22510	89.02	300	0	0	0	intergen
X	98424272	98424641	MACS_peak_22511	60.26	369	0	0	0	intergen
X	98428794	98429235	MACS_peak_22513	94.4	441	0	0	0	intergen
X	98525590	98525947	MACS_peak_22514	98.33	357	0	0	1	other
X	98534059	98534195	MACS_peak_22515	927.9	136	0	0	1	other
X	98563304	98563674	MACS_peak_22516	72.26	370	0	0	1	other
X	98654061	98654403	MACS_peak_22517	786.29	342	0	0	1	other
X	98669282	98669604	MACS_peak_22518	102.22	322	0	0	1	other
X	98948275	98948563	MACS_peak_22520	722.05	288	0	0	0	intergen
X	99478209	99478434	MACS_peak_22521	498.19	225	0	0	0	intergen
X	99603542	99603886	MACS_peak_22523	419.18	344	0	0	0	intergen
X	99809824	99810229	MACS_peak_22524	57.43	405	0	0	0	intergen
X	99841889	99842230	MACS_peak_22525	84.4	341	0	0	0	intergen
X	100028320	100028557	MACS_peak_22526	203.46	237	0	0	0	intergen
X	100167129	100167518	MACS_peak_22528	63.13	389	0	0	0	intergen
X	100260382	100260753	MACS_peak_22529	68.13	371	0	0	0	intergen
X	100368242	100368508	MACS_peak_22530	463.44	266	0	1	0	gen
X	100413258	100413557	MACS_peak_22531	564.59	299	0	0	0	intergen
X	100447853	100448163	MACS_peak_22532	557.12	310	0	0	0	intergen
X	100502319	100502608	MACS_peak_22533	55.2	289	0	0	0	intergen
X	100671242	100671465	MACS_peak_22534	434.23	223	1	1	0	promoter
X	100768778	100769009	MACS_peak_22535	604.83	231	0	0	0	intergen
X	101439765	101440114	MACS_peak_22536	104.89	349	0	1	0	gen
X	101474638	101474925	MACS_peak_22537	74.44	287	0	1	0	gen
X	101538442	101538678	MACS_peak_22538	305.44	236	0	0	1	other
X	101596080	101596425	MACS_peak_22539	535.04	345	0	0	0	intergen
X	101605500	101605735	MACS_peak_22540	516.86	235	0	0	0	intergen
X	101712998	101713265	MACS_peak_22541	89.02	267	0	0	0	intergen
X	101849386	101849676	MACS_peak_22542	448.52	290	0	1	0	gen
X	101873022	101873319	MACS_peak_22543	188.67	297	0	0	0	intergen
X	102034431	102034822	MACS_peak_22544	52.99	391	0	0	0	intergen
X	102191812	102192224	MACS_peak_22546	95.56	412	0	0	0	intergen
X	102204945	102205278	MACS_peak_22547	312.33	333	0	0	0	intergen
X	102232331	102232732	MACS_peak_22548	123.24	401	0	0	0	intergen
X	102278264	102278519	MACS_peak_22551	470.06	255	0	1	0	gen
X	102346091	102346313	MACS_peak_22552	1208.41	222	0	0	0	intergen
X	102408583	102408805	MACS_peak_22553	883.81	222	0	2	0	gen
X	102453255	102453589	MACS_peak_22554	84.16	334	1	1	0	promoter
X	102481826	102482170	MACS_peak_22555	721.05	344	0	0	0	intergen
X	102594179	102594311	MACS_peak_22557	1116.4	132	1	0	0	promoter
X	102608910	102609131	MACS_peak_22558	911.62	221	0	0	2	other
X	103176470	103176734	MACS_peak_22560	464.74	264	0	0	0	intergen
X	103343145	103343408	MACS_peak_22561	465.4	263	0	0	0	intergen
X	103774128	103774355	MACS_peak_22562	548.55	227	1	0	0	promoter
X	103895855	103896296	MACS_peak_22565	71.19	441	0	0	0	intergen
X	104113168	104113577	MACS_peak_22566	616.18	409	1	1	0	promoter
X	104195479	104195801	MACS_peak_22567	430.51	322	0	1	0	gen
X	104370216	104370577	MACS_peak_22568	771.4	361	0	0	0	intergen
X	104404350	104404748	MACS_peak_22569	63.73	398	0	0	0	intergen
X	104482751	104483063	MACS_peak_22570	435.94	312	0	0	0	intergen
X	104565822	104566043	MACS_peak_22571	564.54	221	1	0	0	promoter
X	104585182	104585492	MACS_peak_22572	737.12	310	0	1	0	gen
X	104675853	104676199	MACS_peak_22573	51.97	346	0	1	0	gen
X	104917078	104917413	MACS_peak_22575	86.69	335	0	1	0	gen
X	104922239	104922427	MACS_peak_22576	1079.97	188	0	1	0	gen
X	104949721	104950099	MACS_peak_22577	70.09	378	0	1	0	gen
X	105039882	105040248	MACS_peak_22578	81.3	366	0	1	0	gen
X	105190296	105190677	MACS_peak_22579	756.57	381	0	1	0	gen
X	105381827	105382160	MACS_peak_22580	79.55	333	0	1	0	gen
X	105739823	105740305	MACS_peak_22581	69.45	482	0	1	0	gen
X	105798851	105799262	MACS_peak_22582	53.76	411	0	0	0	intergen
X	105802298	105802701	MACS_peak_22583	190.52	403	0	0	0	intergen
X	105986272	105986473	MACS_peak_22584	478.76	201	0	0	0	intergen
X	105992794	105993097	MACS_peak_22585	161.42	303	0	0	0	intergen
X	106192289	106192628	MACS_peak_22586	81.83	339	0	1	0	gen
X	106307841	106308262	MACS_peak_22587	1469.99	421	0	0	0	intergen
X	106309671	106309927	MACS_peak_22589	349.84	256	0	0	0	intergen
X	106415386	106415581	MACS_peak_22590	454.71	195	0	0	0	intergen
X	106470159	106470585	MACS_peak_22592	57.41	426	0	0	0	intergen
X	106768467	106768832	MACS_peak_22593	124.55	365	0	1	0	gen
X	106788268	106788510	MACS_peak_22594	645.81	242	0	1	0	gen
X	106788649	106788975	MACS_peak_22595	546.72	326	0	1	0	gen
X	106804963	106805096	MACS_peak_22596	1365.09	133	1	0	0	promoter
X	107106503	107106956	MACS_peak_22597	230.59	453	0	1	0	gen
X	107199467	107199689	MACS_peak_22598	564.54	222	0	1	0	gen
X	107537915	107538116	MACS_peak_22599	645.81	201	0	1	1	gen
X	107691461	107691678	MACS_peak_22600	580.62	217	0	0	0	intergen
X	107718104	107718291	MACS_peak_22601	712.32	187	0	0	0	intergen
X	107777342	107777516	MACS_peak_22602	989.9	174	1	0	0	promoter
X	107782160	107782413	MACS_peak_22603	263.44	253	0	1	0	gen
X	107886450	107886911	MACS_peak_22604	68.47	461	0	1	0	gen
X	107887116	107887329	MACS_peak_22605	91.61	213	0	1	0	gen
X	107887404	107887666	MACS_peak_22606	60.57	262	0	1	0	gen
X	107887772	107888108	MACS_peak_22607	64.01	336	0	1	0	gen
X	108099593	108099890	MACS_peak_22608	380.3	297	0	1	0	gen
X	108530555	108530782	MACS_peak_22609	84.1	227	0	1	0	gen
X	108537173	108537395	MACS_peak_22610	564.54	222	0	1	0	gen
X	108636476	108636673	MACS_peak_22611	688.92	197	0	1	0	gen
X	108773796	108774267	MACS_peak_22612	795.04	471	0	0	0	intergen
X	108775582	108775928	MACS_peak_22613	914.08	346	0	0	0	intergen
X	108800525	108800776	MACS_peak_22614	544.59	251	0	0	0	intergen
X	109055999	109056425	MACS_peak_22615	55.65	426	0	0	0	intergen
X	109111630	109112109	MACS_peak_22616	86.23	479	0	0	0	intergen
X	109115171	109115410	MACS_peak_22617	85.07	239	0	0	0	intergen
X	109118867	109119204	MACS_peak_22618	62.38	337	0	0	0	intergen
X	109384900	109385126	MACS_peak_22620	848.95	226	0	1	0	gen
X	109485803	109486078	MACS_peak_22621	542	275	0	0	0	intergen
X	109523296	109523472	MACS_peak_22622	191.05	176	0	0	0	intergen
X	109633036	109633220	MACS_peak_22623	729.14	184	0	1	0	gen
X	109645148	109645355	MACS_peak_22624	292.5	207	0	1	0	gen
X	109738148	109738323	MACS_peak_22625	713.93	175	0	0	0	intergen
X	109880858	109880990	MACS_peak_22626	1116.4	132	0	0	0	intergen
X	109886251	109886456	MACS_peak_22627	629.38	205	0	0	0	intergen
X	109890947	109891210	MACS_peak_22628	465.4	263	0	0	0	intergen
X	110221784	110222108	MACS_peak_22631	98.24	324	0	1	0	gen
X	110608706	110608958	MACS_peak_22632	77.48	252	0	0	0	intergen
X	110643935	110644248	MACS_peak_22633	65.37	313	0	0	0	intergen
X	110665779	110666002	MACS_peak_22634	601.22	223	0	0	0	intergen
X	110817052	110817325	MACS_peak_22636	54.74	273	0	0	0	intergen
X	110852137	110852484	MACS_peak_22637	417.69	347	0	0	0	intergen
X	111164722	111165076	MACS_peak_22638	348.11	354	0	1	0	gen
X	111314901	111315244	MACS_peak_22639	54.57	343	0	1	0	gen
X	111719912	111720182	MACS_peak_22640	582.54	270	0	1	0	gen
X	111966415	111966681	MACS_peak_22641	89.02	266	0	1	0	gen
X	112242089	112242484	MACS_peak_22642	69.22	395	0	0	0	intergen
X	112243506	112243727	MACS_peak_22643	352.9	221	0	0	0	intergen
X	112310424	112310825	MACS_peak_22644	504.14	401	0	0	0	intergen
X	112327431	112327763	MACS_peak_22645	81.72	332	0	0	0	intergen
X	112351397	112351803	MACS_peak_22646	63.55	406	0	0	0	intergen
X	112351957	112352339	MACS_peak_22647	50.4	382	0	0	0	intergen
X	112432011	112432234	MACS_peak_22648	67.4	223	0	0	0	intergen
X	112507088	112507436	MACS_peak_22649	50.19	348	0	0	0	intergen
X	112595484	112595701	MACS_peak_22650	85.21	217	0	0	0	intergen
X	112685354	112685784	MACS_peak_22651	91.9	430	0	0	0	intergen
X	112709898	112710376	MACS_peak_22652	2046.75	478	0	0	0	intergen
X	112750075	112750447	MACS_peak_22653	90.12	372	0	0	0	intergen
X	112915257	112915722	MACS_peak_22654	69.71	465	0	0	0	intergen
X	112953000	112953378	MACS_peak_22655	403.06	378	0	0	0	intergen
X	113126442	113126674	MACS_peak_22656	532.66	232	0	0	0	intergen
X	113566602	113566892	MACS_peak_22657	106.11	290	0	0	0	intergen
X	114125008	114125244	MACS_peak_22658	98.2	236	0	0	0	intergen
X	114397213	114397412	MACS_peak_22659	192.76	199	0	0	0	intergen
X	114605587	114605846	MACS_peak_22660	178.37	259	0	1	0	gen
X	114702482	114702790	MACS_peak_22661	80.44	308	0	1	0	gen
X	114742912	114743174	MACS_peak_22663	75.01	262	0	1	0	gen
X	114866270	114866544	MACS_peak_22664	582.68	274	0	1	0	gen
X	114959847	114960047	MACS_peak_22665	814.37	200	0	0	0	intergen
X	115018146	115018507	MACS_peak_22666	488.85	361	0	1	0	gen
X	115057587	115057876	MACS_peak_22667	571.63	289	0	0	0	intergen
X	115147254	115147539	MACS_peak_22668	451.52	285	0	1	0	gen
X	115674070	115674381	MACS_peak_22669	128.16	311	0	0	0	intergen
X	115690716	115691011	MACS_peak_22670	567.38	295	0	0	0	intergen
X	115844170	115844424	MACS_peak_22671	452.91	254	0	0	0	intergen
X	115847151	115847405	MACS_peak_22672	386.44	254	0	0	0	intergen
X	115850132	115850386	MACS_peak_22673	344.54	254	0	0	0	intergen
X	115853115	115853330	MACS_peak_22674	459.6	215	0	0	0	intergen
X	115856094	115856348	MACS_peak_22675	347.65	254	0	0	0	intergen
X	115857973	115858217	MACS_peak_22676	59.85	244	0	0	0	intergen
X	115859085	115859339	MACS_peak_22677	278.67	254	0	0	0	intergen
X	115862076	115862291	MACS_peak_22678	363.01	215	0	0	0	intergen
X	115863951	115864191	MACS_peak_22679	70.11	240	0	0	0	intergen
X	115865059	115865274	MACS_peak_22680	362.38	215	0	0	0	intergen
X	115868044	115868259	MACS_peak_22681	359.87	215	0	0	0	intergen
X	115871023	115871277	MACS_peak_22682	339.63	254	0	0	0	intergen
X	115874010	115874264	MACS_peak_22683	341.46	254	0	0	0	intergen
X	115876979	115877233	MACS_peak_22684	337.22	254	0	0	0	intergen
X	115879972	115880226	MACS_peak_22685	395.73	254	0	0	0	intergen
X	115881266	115881526	MACS_peak_22686	69.97	260	0	0	0	intergen
X	115882981	115883235	MACS_peak_22687	256.45	254	0	0	0	intergen
X	115885970	115886185	MACS_peak_22688	226.43	215	0	0	0	intergen
X	115888052	115888307	MACS_peak_22689	374.97	255	0	0	0	intergen
X	116067060	116067429	MACS_peak_22690	93.4	369	0	0	0	intergen
X	116068117	116068450	MACS_peak_22691	182.83	333	0	0	0	intergen
X	116082537	116082775	MACS_peak_22692	502.51	238	0	0	0	intergen
X	116310769	116311056	MACS_peak_22693	69	287	0	0	0	intergen
X	116519908	116520191	MACS_peak_22696	113.62	283	0	0	0	intergen
X	116657083	116657458	MACS_peak_22697	404.42	375	0	0	0	intergen
X	116942700	116943002	MACS_peak_22698	75.45	302	0	0	0	intergen
X	116963631	116963796	MACS_peak_22699	605.98	165	0	0	0	intergen
X	116968237	116968554	MACS_peak_22700	86.13	317	0	0	0	intergen
X	117265403	117265802	MACS_peak_22702	50.57	399	0	0	0	intergen
X	117732282	117732672	MACS_peak_22703	82.85	390	0	0	0	intergen
X	117963771	117964057	MACS_peak_22704	66.93	286	0	1	0	gen
X	117984680	117984953	MACS_peak_22705	2028.32	273	0	1	0	gen
X	118037296	118037533	MACS_peak_22706	88.2	237	0	1	0	gen
X	118090785	118091154	MACS_peak_22707	113.2	369	0	1	0	gen
X	118244753	118245145	MACS_peak_22709	89.02	392	0	0	0	intergen
X	118254617	118254885	MACS_peak_22710	587.27	268	0	0	0	intergen
X	118401339	118401742	MACS_peak_22711	61.54	403	0	1	0	gen
X	118604010	118604332	MACS_peak_22712	424.26	322	0	1	0	gen
X	118629706	118629846	MACS_peak_22713	1395.4	140	0	1	0	gen
X	119008174	119008498	MACS_peak_22715	429.45	324	0	1	0	gen
X	119067129	119067370	MACS_peak_22716	1569.18	241	0	0	0	intergen
X	119118968	119119191	MACS_peak_22717	866.35	223	0	1	0	gen
X	119516318	119516570	MACS_peak_22718	463.76	252	0	0	0	intergen
X	119966038	119966373	MACS_peak_22719	50.43	335	0	0	1	other
X	119976378	119976685	MACS_peak_22720	350.28	307	0	0	1	other
X	119981728	119981962	MACS_peak_22721	568.05	234	0	0	2	other
X	120039091	120039386	MACS_peak_22722	827.09	295	0	0	1	other
X	120047253	120047535	MACS_peak_22723	62.38	282	0	0	1	other
X	120048469	120048689	MACS_peak_22724	62.91	220	0	0	1	other
X	120085566	120085879	MACS_peak_22725	945.2	313	0	0	1	other
X	120150423	120150736	MACS_peak_22726	810.73	313	0	0	1	other
X	120158067	120158263	MACS_peak_22727	490.85	196	1	0	1	promoter
X	120187662	120187901	MACS_peak_22728	105.55	239	0	0	1	other
X	120196979	120197274	MACS_peak_22729	686.01	295	0	0	1	other
X	120380882	120381205	MACS_peak_22731	447.18	323	0	1	0	gen
X	120475460	120475736	MACS_peak_22732	1928.25	276	0	0	0	intergen
X	120790033	120790336	MACS_peak_22733	1094.68	303	0	0	0	intergen
X	121322091	121322459	MACS_peak_22734	505.91	368	0	0	0	intergen
X	121773880	121774185	MACS_peak_22735	439.84	305	0	0	0	intergen
X	121880440	121880772	MACS_peak_22736	75.01	332	0	0	0	intergen
X	122072475	122072794	MACS_peak_22737	177.99	319	0	0	0	intergen
X	122375762	122376022	MACS_peak_22738	439.97	260	0	0	0	intergen
X	122434020	122434426	MACS_peak_22739	327.36	406	0	0	0	intergen
X	122706531	122706867	MACS_peak_22740	201.59	336	0	0	0	intergen
X	122728668	122728811	MACS_peak_22741	1167.67	143	0	0	0	intergen
X	122943072	122943451	MACS_peak_22743	56.38	379	0	0	0	intergen
X	123051946	123052093	MACS_peak_22744	504.17	147	0	0	0	intergen
X	123288034	123288370	MACS_peak_22746	177.18	336	0	1	0	gen
X	123566322	123566681	MACS_peak_22747	229.02	359	0	0	0	intergen
X	123777825	123778103	MACS_peak_22748	646.54	278	0	0	0	intergen
X	123889945	123890253	MACS_peak_22749	213.74	308	0	1	0	gen
X	123960346	123960752	MACS_peak_22750	730.17	406	1	0	1	promoter
X	124108052	124108462	MACS_peak_22751	83.74	410	0	1	0	gen
X	124349517	124349724	MACS_peak_22752	613.04	207	0	2	0	gen
X	124471327	124471670	MACS_peak_22754	419.68	343	0	1	0	gen
X	124495581	124495863	MACS_peak_22755	50.01	282	0	1	0	gen
X	125043632	125043945	MACS_peak_22756	70.89	313	0	0	0	intergen
X	125063712	125064044	MACS_peak_22757	123.61	332	0	0	0	intergen
X	125393136	125393511	MACS_peak_22758	201.59	375	0	0	0	intergen
X	125513239	125513525	MACS_peak_22759	59.95	286	0	0	0	intergen
X	125514662	125515065	MACS_peak_22760	54.05	403	0	0	0	intergen
X	125541879	125542103	MACS_peak_22761	564.54	224	0	0	0	intergen
X	125559702	125559937	MACS_peak_22762	569.68	235	0	0	0	intergen
X	125646189	125646527	MACS_peak_22764	422.19	338	0	0	0	intergen
X	125841936	125842163	MACS_peak_22765	139.09	227	0	0	0	intergen
X	125936417	125936740	MACS_peak_22766	58.2	323	0	0	0	intergen
X	125960362	125960602	MACS_peak_22767	111.22	240	0	0	0	intergen
X	126035489	126035918	MACS_peak_22768	2264.72	429	0	0	0	intergen
X	126155350	126155704	MACS_peak_22769	100.02	354	0	0	0	intergen
X	126231001	126231170	MACS_peak_22770	171.89	169	0	0	0	intergen
X	126287468	126287801	MACS_peak_22771	52.99	333	0	0	0	intergen
X	126386294	126386654	MACS_peak_22772	75.01	360	0	0	0	intergen
X	126517138	126517361	MACS_peak_22773	684.35	223	0	0	0	intergen
X	126770174	126770434	MACS_peak_22774	593.56	260	0	0	0	intergen
X	126777250	126777644	MACS_peak_22775	625.13	394	0	0	0	intergen
X	126813486	126813724	MACS_peak_22776	662.31	238	0	0	0	intergen
X	127330976	127331237	MACS_peak_22777	100.65	261	0	0	0	intergen
X	127364660	127364935	MACS_peak_22778	57.36	275	0	0	0	intergen
X	127607966	127608229	MACS_peak_22779	363.32	263	0	0	0	intergen
X	128351555	128351785	MACS_peak_22780	192.59	230	0	0	1	other
X	128526950	128527401	MACS_peak_22781	1353.73	451	0	0	1	other
X	129601239	129601458	MACS_peak_22786	1226.97	219	0	0	0	intergen
X	129605478	129605723	MACS_peak_22787	780.06	245	0	0	0	intergen
X	129637572	129637800	MACS_peak_22788	848.95	228	0	0	0	intergen
X	130028119	130028483	MACS_peak_22789	644.14	364	0	1	0	gen
X	130079837	130080084	MACS_peak_22790	485.56	247	0	1	0	gen
X	130160435	130160691	MACS_peak_22791	449.95	256	0	1	0	gen
X	130568315	130568664	MACS_peak_22792	62.01	349	0	0	0	intergen
X	130570949	130571399	MACS_peak_22793	71.46	450	0	0	0	intergen
X	130821508	130821861	MACS_peak_22794	136.43	353	0	1	0	gen
X	130975978	130976206	MACS_peak_22795	1007.8	228	0	0	0	intergen
X	130988972	130989215	MACS_peak_22796	891.43	243	0	0	1	other
X	130994794	130995005	MACS_peak_22797	763.02	211	0	0	1	other
X	131012468	131012691	MACS_peak_22798	712.32	223	0	0	1	other
X	131251327	131251646	MACS_peak_22799	95.09	319	0	0	0	intergen
X	131450974	131451278	MACS_peak_22800	105.65	304	0	1	0	gen
X	131527167	131527532	MACS_peak_22801	119.23	365	0	1	0	gen
X	131553954	131554319	MACS_peak_22802	51.02	365	0	1	0	gen
X	131664728	131664988	MACS_peak_22803	79.76	260	0	0	0	intergen
X	131675647	131676022	MACS_peak_22804	636.99	375	0	0	0	intergen
X	131726192	131726397	MACS_peak_22805	629.38	205	0	0	1	other
X	131768701	131769010	MACS_peak_22806	229.83	309	0	0	1	other
X	131802892	131803295	MACS_peak_22807	606.07	403	0	0	1	other
X	131875845	131876218	MACS_peak_22808	93.4	373	0	0	0	intergen
X	132098286	132098531	MACS_peak_22809	780.06	245	0	1	0	gen
X	132248075	132248506	MACS_peak_22811	77.91	431	0	0	1	other
X	132260750	132260925	MACS_peak_22812	780.06	175	0	0	1	other
X	132535983	132536400	MACS_peak_22813	495.15	417	0	0	0	intergen
X	132592978	132593212	MACS_peak_22814	532.66	234	0	0	0	intergen
X	132613088	132613349	MACS_peak_22815	466.72	261	0	0	0	intergen
X	132740619	132740864	MACS_peak_22816	918.92	245	0	1	0	gen
X	132772754	132772994	MACS_peak_22817	516.86	240	0	1	0	gen
X	132944651	132944963	MACS_peak_22818	89.02	312	0	1	0	gen
X	133005131	133005334	MACS_peak_22819	793.98	203	0	0	0	intergen
X	133335119	133335312	MACS_peak_22820	678.9	193	0	1	0	gen
X	133714178	133714434	MACS_peak_22821	470.06	256	0	1	0	gen
X	134122061	134122365	MACS_peak_22822	89.9	304	0	0	0	intergen
X	134144272	134144580	MACS_peak_22823	684.39	308	0	0	0	intergen
X	134157256	134157591	MACS_peak_22824	1341.74	335	0	0	0	intergen
X	134294687	134294896	MACS_peak_22825	944.36	209	0	0	0	intergen
X	134313556	134313834	MACS_peak_22826	369.8	278	0	0	0	intergen
X	134355933	134356065	MACS_peak_22827	857.98	132	0	0	0	intergen
X	134396299	134396564	MACS_peak_22828	1141.07	265	0	1	0	gen
X	134556381	134556531	MACS_peak_22829	403.07	150	0	0	1	other
X	134780918	134781216	MACS_peak_22830	443.84	298	0	1	0	gen
X	135206364	135206695	MACS_peak_22832	265.34	331	0	0	1	other
X	135387123	135387556	MACS_peak_22833	125.39	433	0	0	0	intergen
X	136009787	136010091	MACS_peak_22834	440.4	304	0	1	0	gen
X	136028459	136028755	MACS_peak_22835	445	296	0	1	0	gen
X	136519037	136519397	MACS_peak_22837	411.4	360	0	0	0	intergen
X	136577699	136577918	MACS_peak_22838	729.14	219	0	0	0	intergen
X	136711164	136711480	MACS_peak_22839	553.16	316	0	1	0	gen
X	136726876	136727189	MACS_peak_22840	239.75	313	0	1	0	gen
X	136758027	136758177	MACS_peak_22841	1411.68	150	0	1	0	gen
X	136925247	136925503	MACS_peak_22842	425.33	256	0	0	1	other
X	137052469	137052844	MACS_peak_22843	517.89	375	0	0	0	intergen
X	137194213	137194492	MACS_peak_22845	562.94	279	0	0	0	intergen
X	137272363	137272510	MACS_peak_22846	1491.86	147	0	0	0	intergen
X	137315795	137316217	MACS_peak_22848	1815.39	422	0	0	0	intergen
X	137345288	137345579	MACS_peak_22849	603.02	291	0	0	0	intergen
X	137487979	137488358	MACS_peak_22850	114.74	379	0	0	0	intergen
X	137573035	137573172	MACS_peak_22851	2230.55	137	0	1	0	gen
X	138034278	138034504	MACS_peak_22852	533.53	226	0	0	0	intergen
X	138191893	138192333	MACS_peak_22853	1364.78	440	0	0	0	intergen
X	138235505	138235882	MACS_peak_22854	106.66	377	0	0	0	intergen
X	138280875	138281118	MACS_peak_22855	1029.26	243	0	0	0	intergen
X	138590614	138590756	MACS_peak_22856	868.02	142	0	0	0	intergen
X	138810794	138811113	MACS_peak_22857	51.86	319	0	1	0	gen
X	138982753	138982947	MACS_peak_22858	654.22	194	0	1	0	gen
X	139067774	139068241	MACS_peak_22859	66.96	467	0	1	0	gen
X	139146002	139146208	MACS_peak_22860	166.09	206	0	1	0	gen
X	139343408	139343816	MACS_peak_22861	500.59	408	0	0	0	intergen
X	139436670	139437047	MACS_peak_22862	87.13	377	0	0	0	intergen
X	139441211	139441554	MACS_peak_22863	100.52	343	0	0	0	intergen
X	139965977	139966329	MACS_peak_22864	335.81	352	0	0	0	intergen
X	139992747	139993107	MACS_peak_22865	57.86	360	0	0	0	intergen
X	140131603	140131939	MACS_peak_22866	93.4	336	0	0	0	intergen
X	140572726	140573001	MACS_peak_22867	309.47	275	0	0	0	intergen
X	140918447	140918717	MACS_peak_22868	460.86	270	0	0	0	intergen
X	141077185	141077531	MACS_peak_22869	259.34	346	0	0	0	intergen
X	141287705	141288179	MACS_peak_22870	186.49	474	0	0	0	intergen
X	141467573	141467753	MACS_peak_22871	746.04	180	0	0	0	intergen
X	141567503	141567800	MACS_peak_22872	103.45	297	0	0	1	other
X	141789568	141789995	MACS_peak_22873	605.87	427	0	0	0	intergen
X	141793351	141793628	MACS_peak_22874	580.42	277	0	0	0	intergen
X	141825360	141825760	MACS_peak_22875	103.21	400	0	0	0	intergen
X	141844294	141844477	MACS_peak_22876	729.14	183	0	1	0	gen
X	141936104	141936482	MACS_peak_22877	403.06	378	0	0	0	intergen
X	142269948	142270186	MACS_peak_22878	797.18	238	0	0	0	intergen
X	142308736	142308989	MACS_peak_22879	470.06	253	0	0	0	intergen
X	142388040	142388385	MACS_peak_22880	50.72	345	0	0	0	intergen
X	142794916	142795160	MACS_peak_22881	280.81	244	0	0	0	intergen
X	143097903	143098165	MACS_peak_22882	591.97	262	0	0	0	intergen
X	143213861	143214303	MACS_peak_22883	673.34	442	0	0	0	intergen
X	143352901	143353264	MACS_peak_22884	56.7	363	0	0	1	other
X	143354984	143355352	MACS_peak_22885	64.72	368	0	0	1	other
X	143522463	143522706	MACS_peak_22886	168.43	243	0	0	0	intergen
X	144306141	144306571	MACS_peak_22887	55.51	430	0	0	0	intergen
X	144340075	144340429	MACS_peak_22888	738.6	354	0	0	0	intergen
X	144404604	144404850	MACS_peak_22889	191.05	246	0	0	0	intergen
X	144503994	144504279	MACS_peak_22890	89.72	285	0	0	0	intergen
X	144680067	144680218	MACS_peak_22891	1571.36	151	0	0	0	intergen
X	144682743	144683021	MACS_peak_22892	502.42	278	0	0	0	intergen
X	144762309	144762583	MACS_peak_22893	311.56	274	0	0	0	intergen
X	144966817	144967077	MACS_peak_22894	125.63	260	0	0	0	intergen
X	145213556	145213822	MACS_peak_22895	855.73	266	0	0	0	intergen
X	145388076	145388356	MACS_peak_22896	707.43	280	0	0	0	intergen
X	145404963	145405421	MACS_peak_22897	952.43	458	0	0	0	intergen
X	145494227	145494628	MACS_peak_22898	998.05	401	0	0	0	intergen
X	145825993	145826227	MACS_peak_22900	532.66	234	0	1	0	gen
X	147143343	147143690	MACS_peak_22901	77.56	347	0	0	0	intergen
X	147411672	147412051	MACS_peak_22903	51.95	379	0	0	0	intergen
X	148049470	148049795	MACS_peak_22905	671.43	325	0	0	0	intergen
X	148348707	148349031	MACS_peak_22907	72.18	324	0	0	0	intergen
X	148530469	148530807	MACS_peak_22908	422.19	338	0	1	0	gen
X	149153226	149153450	MACS_peak_22909	564.54	224	0	0	0	intergen
X	149493608	149493919	MACS_peak_22910	436.49	311	0	2	0	gen
X	150138079	150138461	MACS_peak_22912	50.92	382	0	0	1	other
X	151027528	151027747	MACS_peak_22915	580.62	219	0	0	0	intergen
X	151082306	151082596	MACS_peak_22916	448.52	290	0	0	0	intergen
X	151202708	151203024	MACS_peak_22917	50.92	316	0	0	0	intergen
X	151360247	151360532	MACS_peak_22918	451.52	285	0	0	0	intergen
X	151373511	151373914	MACS_peak_22919	896.63	403	0	0	0	intergen
X	151449574	151450028	MACS_peak_22920	478.76	454	0	0	0	intergen
X	151450056	151450346	MACS_peak_22921	488.85	290	0	0	0	intergen
X	151487719	151488009	MACS_peak_22922	57.86	290	0	0	0	intergen
X	151668241	151668630	MACS_peak_22923	63.13	389	0	1	1	gen
X	151703773	151704038	MACS_peak_22924	978.69	265	0	1	0	gen
X	152212280	152212435	MACS_peak_22925	717.97	155	0	1	0	gen
X	152233301	152233626	MACS_peak_22926	60.84	325	0	1	0	gen
X	152236242	152236527	MACS_peak_22927	60	285	0	1	0	gen
X	152275073	152275444	MACS_peak_22928	248.1	371	0	1	0	gen
X	152350249	152350524	MACS_peak_22929	115.17	275	0	1	0	gen
X	152360573	152360830	MACS_peak_22930	75.06	257	0	1	0	gen
X	152586477	152586796	MACS_peak_22931	157.55	319	0	0	0	intergen
X	152632588	152632817	MACS_peak_22932	533.53	229	0	0	0	intergen
X	152636006	152636254	MACS_peak_22933	624.49	248	1	0	0	promoter
X	152817187	152817540	MACS_peak_22934	530.32	353	0	0	0	intergen
X	152935281	152935485	MACS_peak_22935	612.68	204	0	1	0	gen
X	152998455	152998798	MACS_peak_22936	419.68	343	0	0	0	intergen
X	153212252	153212513	MACS_peak_22937	466.72	261	0	0	0	intergen
X	153554858	153555071	MACS_peak_22938	596.79	213	0	1	0	gen
X	153947348	153947697	MACS_peak_22939	416.71	349	1	0	0	promoter
X	153978562	153978801	MACS_peak_22940	191.05	239	0	1	0	gen
X	154051264	154051469	MACS_peak_22941	972.07	205	0	1	0	gen
X	154129115	154129250	MACS_peak_22942	1554.14	135	0	1	0	gen
X	154164934	154165274	MACS_peak_22943	454.28	340	0	0	1	other
X	154202100	154202388	MACS_peak_22944	439.97	288	0	0	1	other
X	154239310	154239554	MACS_peak_22945	281.86	244	0	0	1	other
X	154308432	154308619	MACS_peak_22946	712.32	187	0	1	0	gen
X	154328540	154328682	MACS_peak_22947	387.38	142	0	1	0	gen
X	154361029	154361186	MACS_peak_22948	196.82	157	0	1	0	gen
X	154534807	154535060	MACS_peak_22949	470.06	253	1	0	0	promoter
X	154575164	154575346	MACS_peak_22950	936.57	182	0	0	0	intergen
X	154629083	154629265	MACS_peak_22951	936.57	182	0	0	0	intergen
X	154845932	154846338	MACS_peak_22952	78.38	406	0	1	0	gen
X	154888298	154888512	MACS_peak_22953	522.09	214	2	1	0	promoter
X	154942054	154942372	MACS_peak_22954	149.99	318	0	1	0	gen
X	155094508	155094806	MACS_peak_22955	565.28	298	0	2	0	gen
X	155160263	155160439	MACS_peak_22956	106.72	176	0	0	0	intergen
X	155232143	155232351	MACS_peak_22957	604.98	208	0	1	0	gen
X	155432762	155433212	MACS_peak_22960	60.46	450	0	0	0	intergen
X	155672735	155673055	MACS_peak_22961	63.13	320	0	0	0	intergen
X	155813650	155813985	MACS_peak_22962	81.06	335	0	0	0	intergen
X	155901487	155901709	MACS_peak_22963	194.4	222	0	1	0	gen
X	155933310	155933627	MACS_peak_22965	68.83	317	0	1	0	gen
X	156016752	156017065	MACS_peak_22966	422.13	313	0	0	1	other
X	156028458	156028889	MACS_peak_22967	263.36	431	0	0	0	intergen
