chr	start	end	id	score	size	phits	ghits	ohits	type
1	3621301	3621482	MACS_peak_47	1569.18	181	1	0	0	luma
1	3849254	3849393	MACS_peak_50	1043.77	139	0	1	0	luma
1	7808412	7808703	MACS_peak_66	312.33	291	0	1	0	luma
1	7967141	7967350	MACS_peak_67	780.06	209	0	1	0	luma
1	8561116	8561391	MACS_peak_70	1128.24	275	0	1	0	luma
1	11086620	11086991	MACS_peak_81	228.35	371	0	1	0	luma
1	11642461	11642648	MACS_peak_83	901.33	187	0	1	1	luma
1	11954303	11954502	MACS_peak_84	809.56	199	0	1	0	luma
1	21694568	21694710	MACS_peak_127	384.6	142	0	1	0	luma
1	21701360	21701500	MACS_peak_128	1136.75	140	0	1	0	luma
1	24390073	24390417	MACS_peak_134	784.68	344	0	1	0	luma
1	24635290	24635555	MACS_peak_136	464.09	265	1	0	0	luma
1	26878026	26878314	MACS_peak_154	700.62	288	1	0	0	luma
1	32109480	32109695	MACS_peak_180	799.34	215	1	0	0	luma
1	32215701	32216058	MACS_peak_181	399.64	357	1	1	0	luma
1	36149559	36149840	MACS_peak_199	453.96	281	0	1	0	luma
1	37970423	37970740	MACS_peak_204	76.3	317	0	1	0	luma
1	37971799	37972153	MACS_peak_205	175.85	354	0	1	0	luma
1	39853286	39853582	MACS_peak_210	445	296	0	1	0	luma
1	45512650	45512867	MACS_peak_241	901.33	217	1	1	0	luma
1	46693899	46694325	MACS_peak_251	202.06	426	0	1	0	luma
1	50684255	50684388	MACS_peak_291	1396.21	133	0	1	0	luma
1	50864358	50864796	MACS_peak_292	54.03	438	0	1	0	luma
1	50929492	50929774	MACS_peak_293	453.35	282	0	1	0	luma
1	51769102	51769394	MACS_peak_299	447.34	292	0	1	0	luma
1	52389841	52390056	MACS_peak_300	596.79	215	0	1	0	luma
1	52891920	52892301	MACS_peak_304	290.35	381	1	1	0	luma
1	53854906	53855078	MACS_peak_306	1358.7	172	1	0	0	luma
1	53959706	53959945	MACS_peak_307	620.13	239	0	1	0	luma
1	70239596	70239850	MACS_peak_395	596.79	254	0	1	0	luma
1	70311529	70311821	MACS_peak_396	1835.72	292	0	1	0	luma
1	74228846	74229154	MACS_peak_415	380.3	308	0	2	0	luma
1	74500408	74500743	MACS_peak_416	84.4	335	0	3	0	luma
1	75782828	75783195	MACS_peak_432	150.31	367	1	1	0	luma
1	77899165	77899478	MACS_peak_443	103.45	313	0	1	0	luma
1	77900841	77901162	MACS_peak_444	214.38	321	0	1	0	luma
1	84141168	84141498	MACS_peak_490	426.3	330	0	1	0	luma
1	84230950	84231171	MACS_peak_491	132.92	221	0	1	0	luma
1	84234349	84234710	MACS_peak_492	102.84	361	0	1	0	luma
1	88736708	88736954	MACS_peak_519	485.56	246	0	1	0	luma
1	91001012	91001361	MACS_peak_525	57.54	349	0	1	0	luma
1	91002416	91002765	MACS_peak_526	125.87	349	0	1	0	luma
1	108746332	108746612	MACS_peak_690	454.58	280	1	0	0	luma
1	109027860	109028091	MACS_peak_693	678.9	231	0	1	0	luma
1	109263610	109263986	MACS_peak_695	760.2	376	0	1	0	luma
1	109490456	109490929	MACS_peak_696	581.45	473	1	1	0	luma
1	109499995	109500233	MACS_peak_697	954.29	238	1	1	0	luma
1	109546307	109546618	MACS_peak_698	1085.67	311	1	1	0	luma
1	109980685	109980904	MACS_peak_702	580.62	219	1	0	0	luma
1	113070881	113071224	MACS_peak_729	89.02	343	1	0	1	luma
1	113905131	113905326	MACS_peak_746	447.48	195	1	0	0	luma
1	113949258	113949470	MACS_peak_747	856.48	212	0	1	0	luma
1	114428154	114428526	MACS_peak_756	1656.19	372	0	1	0	luma
1	114431606	114431846	MACS_peak_757	589.16	240	0	1	0	luma
1	114468513	114468879	MACS_peak_758	369.28	366	0	1	1	luma
1	114471441	114471645	MACS_peak_759	552.85	204	0	1	0	luma
1	114489037	114489430	MACS_peak_760	655.79	393	0	1	0	luma
1	114570367	114570602	MACS_peak_763	366.7	235	1	0	0	luma
1	114758093	114758320	MACS_peak_768	665.93	227	0	1	0	luma
1	114765218	114765351	MACS_peak_769	820.94	133	1	0	0	luma
1	116531261	116531590	MACS_peak_796	801.89	329	0	1	0	luma
1	116570337	116570571	MACS_peak_797	814.37	234	1	1	0	luma
1	116574451	116574841	MACS_peak_798	1418.79	390	1	0	0	luma
1	116581209	116581341	MACS_peak_799	1116.4	132	0	1	0	luma
1	116764050	116764398	MACS_peak_803	417.2	348	0	1	0	luma
1	117055323	117055660	MACS_peak_805	662.69	337	1	0	1	luma
1	117402383	117402597	MACS_peak_808	1098.16	214	0	1	0	luma
1	117512765	117513012	MACS_peak_809	629.38	247	0	1	0	luma
1	144969519	144969868	MACS_peak_905	55.54	349	0	1	0	luma
1	144966973	144967271	MACS_peak_906	53.71	298	0	1	0	luma
1	146138077	146138542	MACS_peak_942	1241.95	465	0	2	0	luma
1	145661079	145661321	MACS_peak_949	111.29	242	0	1	0	luma
1	145617453	145617688	MACS_peak_950	421.83	235	0	1	0	luma
1	148120454	148120925	MACS_peak_953	702.27	471	0	1	0	luma
1	146966420	146966794	MACS_peak_957	1254.58	374	0	1	0	luma
1	146960077	146960449	MACS_peak_961	439.14	372	0	1	0	luma
1	146966420	146966730	MACS_peak_962	1362.1	310	0	1	0	luma
1	146972611	146973030	MACS_peak_963	857.26	419	0	1	0	luma
1	146990071	146990264	MACS_peak_964	108.52	193	0	1	0	luma
1	147930027	147930459	MACS_peak_981	388.99	432	1	0	0	luma
1	147937862	147938082	MACS_peak_982	566.9	220	0	1	0	luma
1	147983453	147983811	MACS_peak_984	61.23	358	0	1	0	luma
1	148120454	148120743	MACS_peak_986	813.61	289	0	1	0	luma
1	148126714	148127069	MACS_peak_987	187.57	355	0	1	0	luma
1	150068289	150068520	MACS_peak_1030	744.89	231	1	0	0	luma
1	150072958	150073235	MACS_peak_1031	566.95	277	0	1	0	luma
1	150092629	150092854	MACS_peak_1032	615.31	225	0	1	0	luma
1	150114982	150115293	MACS_peak_1033	627.75	311	0	1	0	luma
1	150452559	150452915	MACS_peak_1038	343.22	356	0	1	0	luma
1	150501201	150501421	MACS_peak_1039	360.97	220	0	1	0	luma
1	150621444	150621908	MACS_peak_1042	554.79	464	0	1	0	luma
1	150922516	150922895	MACS_peak_1046	695.87	379	1	0	0	luma
1	151155925	151156288	MACS_peak_1050	1180.37	363	3	0	0	luma
1	151196176	151196572	MACS_peak_1051	1028.03	396	1	0	0	luma
1	151251743	151252043	MACS_peak_1052	989.86	300	1	0	0	luma
1	153355511	153355802	MACS_peak_1084	447.93	291	1	0	0	luma
1	153797347	153797624	MACS_peak_1089	456.44	277	0	1	1	luma
1	153847650	153847851	MACS_peak_1090	554.96	201	0	1	0	luma
1	153904050	153904318	MACS_peak_1091	547.83	268	0	1	0	luma
1	153946630	153946833	MACS_peak_1092	629.38	203	1	0	0	luma
1	154479894	154480078	MACS_peak_1095	918.92	184	0	1	0	luma
1	154534278	154534628	MACS_peak_1096	403.01	350	0	1	0	luma
1	155061573	155061910	MACS_peak_1099	790.35	337	2	1	0	luma
1	155086122	155086335	MACS_peak_1100	596.79	213	0	2	0	luma
1	155250744	155251024	MACS_peak_1103	454.58	280	1	0	0	luma
1	155277250	155277512	MACS_peak_1104	656.83	262	1	1	0	luma
1	155494335	155494575	MACS_peak_1105	770.24	240	0	1	0	luma
1	155837509	155837675	MACS_peak_1108	795.29	166	0	1	0	luma
1	156066270	156066588	MACS_peak_1110	498.48	318	0	1	0	luma
1	156192255	156192473	MACS_peak_1113	363.4	218	1	0	0	luma
1	156317526	156317853	MACS_peak_1114	637.34	327	0	1	0	luma
1	156319683	156319956	MACS_peak_1115	446.99	273	0	1	0	luma
1	156719742	156719877	MACS_peak_1119	1630.94	135	1	0	0	luma
1	158954683	158954987	MACS_peak_1140	56.74	304	0	1	0	luma
1	162065812	162065946	MACS_peak_1172	1359.65	134	1	0	0	luma
1	162230228	162230484	MACS_peak_1173	470.06	256	0	1	0	luma
1	163262418	163262818	MACS_peak_1181	134.77	400	1	1	1	luma
1	163315876	163316215	MACS_peak_1182	538.66	339	0	2	1	luma
1	173973967	173974317	MACS_peak_1266	478.89	350	0	1	0	luma
1	182784642	182784853	MACS_peak_1368	1116.4	211	1	0	0	luma
1	193183105	193183424	MACS_peak_1469	811.38	319	1	1	0	luma
1	197526815	197527134	MACS_peak_1508	880.59	319	0	1	0	luma
1	197615148	197615422	MACS_peak_1509	488.85	274	0	1	0	luma
1	197619104	197619365	MACS_peak_1510	860.98	261	0	1	0	luma
1	197709846	197710272	MACS_peak_1512	60.03	426	0	1	0	luma
1	197713679	197713993	MACS_peak_1513	369.05	314	0	1	0	luma
1	197739627	197739834	MACS_peak_1514	756.91	207	0	1	0	luma
1	203830819	203831066	MACS_peak_1593	160.74	247	0	2	0	luma
1	203861180	203861615	MACS_peak_1594	1877.72	435	1	0	0	luma
1	206233274	206233613	MACS_peak_1633	495.28	339	0	1	0	luma
1	206331636	206331945	MACS_peak_1637	56.98	309	0	1	0	luma
1	206384890	206385231	MACS_peak_1638	264.38	341	0	1	0	luma
1	206911150	206911469	MACS_peak_1649	1658.62	319	0	1	0	luma
1	207041299	207041607	MACS_peak_1650	178.37	308	1	1	0	luma
1	207049985	207050191	MACS_peak_1651	573.39	206	0	2	0	luma
1	207077865	207078127	MACS_peak_1652	1292.87	262	0	1	0	luma
1	212070652	212070996	MACS_peak_1677	419.18	344	0	1	0	luma
1	217557302	217557514	MACS_peak_1710	450.48	212	0	1	0	luma
1	217694633	217694973	MACS_peak_1711	65.49	340	0	1	0	luma
1	217747268	217747610	MACS_peak_1712	925.78	342	0	1	0	luma
1	217811587	217811827	MACS_peak_1713	440.38	240	0	1	0	luma
1	219990991	219991297	MACS_peak_1738	439.28	306	0	1	0	luma
1	220123913	220124249	MACS_peak_1739	644.82	336	0	1	0	luma
1	220154720	220155101	MACS_peak_1740	312.33	381	0	1	0	luma
1	220189788	220190085	MACS_peak_1741	444.41	297	0	1	0	luma
1	220218684	220218946	MACS_peak_1742	1040.74	262	0	1	0	luma
1	220775256	220775582	MACS_peak_1744	1209.66	326	0	1	0	luma
1	224427704	224427898	MACS_peak_1776	678.9	194	0	1	0	luma
1	228393492	228393763	MACS_peak_1794	584.96	271	1	0	0	luma
1	229453313	229453536	MACS_peak_1818	1208.41	223	0	1	0	luma
1	236598011	236598247	MACS_peak_1841	516.86	236	0	1	0	luma
1	247576535	247576814	MACS_peak_1889	578.93	279	0	1	1	luma
2	6897181	6897463	MACS_peak_9874	592.88	282	0	1	0	luma
2	10668515	10668783	MACS_peak_9892	853.65	268	0	1	0	luma
2	10835347	10835564	MACS_peak_9893	564.92	217	0	1	0	luma
2	11446781	11447029	MACS_peak_9899	485.56	248	1	0	0	luma
2	25397875	25398226	MACS_peak_10003	774.9	351	0	1	0	luma
2	25606819	25607129	MACS_peak_10004	437.04	310	0	1	0	luma
2	25616658	25616960	MACS_peak_10005	265.34	302	0	1	0	luma
2	25625541	25625678	MACS_peak_10006	1420.82	137	0	1	0	luma
2	27621518	27621823	MACS_peak_10017	439.84	305	1	1	1	luma
2	27683559	27683869	MACS_peak_10018	682.83	310	0	1	0	luma
2	27945659	27945958	MACS_peak_10019	506.92	299	0	2	0	luma
2	28026651	28026989	MACS_peak_10020	967.61	338	0	1	0	luma
2	28214323	28214633	MACS_peak_10021	813.39	310	0	1	0	luma
2	31933313	31933457	MACS_peak_10050	769.86	144	0	2	0	luma
2	31969498	31969692	MACS_peak_10051	632.58	194	0	2	0	luma
2	39055333	39055609	MACS_peak_10111	1422.18	276	0	1	0	luma
2	39059394	39059674	MACS_peak_10112	361.13	280	0	1	0	luma
2	58174860	58175302	MACS_peak_10237	125.99	442	0	1	0	luma
2	58176540	58176908	MACS_peak_10238	50	368	0	1	0	luma
2	58202136	58202371	MACS_peak_10239	972.07	235	0	1	0	luma
2	58217283	58217556	MACS_peak_10240	458.95	273	0	1	0	luma
2	63861682	63861980	MACS_peak_10283	565.28	298	0	1	0	luma
2	63888765	63889128	MACS_peak_10284	644.81	363	1	1	0	luma
2	63928666	63928906	MACS_peak_10285	223.38	240	0	1	0	luma
2	70977403	70977715	MACS_peak_10340	435.94	312	1	1	0	luma
2	73033300	73033492	MACS_peak_10357	866.35	192	0	1	0	luma
2	74392041	74392376	MACS_peak_10373	423.72	335	1	0	1	luma
2	97112228	97112655	MACS_peak_10618	1677.51	427	1	0	0	luma
2	97171060	97171424	MACS_peak_10619	61.7	364	0	1	0	luma
2	97229411	97229618	MACS_peak_10620	170.73	207	0	1	0	luma
2	98594839	98595286	MACS_peak_10631	75.42	447	1	0	0	luma
2	101012705	101012938	MACS_peak_10641	712.11	233	0	2	0	luma
2	101016277	101016530	MACS_peak_10642	83.72	253	0	2	0	luma
2	102311765	102312101	MACS_peak_10651	663.41	336	2	0	0	luma
2	102325829	102326293	MACS_peak_10652	222.1	464	0	2	0	luma
2	102327833	102328151	MACS_peak_10653	50.5	318	0	2	0	luma
2	102753618	102753953	MACS_peak_10657	664.12	335	0	1	0	luma
2	109546134	109546401	MACS_peak_10708	854.69	267	1	0	0	luma
2	111619517	111619737	MACS_peak_10743	564.54	220	0	1	2	luma
2	111813254	111813675	MACS_peak_10744	649.49	421	0	1	0	luma
2	111850726	111851128	MACS_peak_10745	1178.01	402	0	1	0	luma
2	117926086	117926403	MACS_peak_10812	57.81	317	0	1	1	luma
2	117967856	117968057	MACS_peak_10813	645.81	201	0	1	0	luma
2	118003400	118003582	MACS_peak_10814	687.62	182	0	1	1	luma
2	130155893	130156280	MACS_peak_10875	511.42	387	1	0	0	luma
2	130360505	130360858	MACS_peak_10877	651.52	353	1	0	0	luma
2	131492341	131492566	MACS_peak_10880	548.55	225	0	1	0	luma
2	135138900	135139074	MACS_peak_10918	1208.41	174	1	1	0	luma
2	135294236	135294486	MACS_peak_10919	82.05	250	0	1	0	luma
2	135407909	135408220	MACS_peak_10920	51.07	311	0	1	0	luma
2	135424889	135425207	MACS_peak_10921	940.27	318	0	1	0	luma
2	135515691	135515886	MACS_peak_10922	352.92	195	0	1	0	luma
2	135685652	135686003	MACS_peak_10923	415.73	351	0	1	0	luma
2	147937744	147938114	MACS_peak_10993	640.22	370	0	1	0	luma
2	148780375	148780613	MACS_peak_11001	502.51	238	0	1	0	luma
2	149035305	149035602	MACS_peak_11006	373.73	297	1	0	0	luma
2	151798797	151798963	MACS_peak_11024	762.11	166	1	1	0	luma
2	158188745	158188922	MACS_peak_11078	972.07	177	0	1	1	luma
2	158264816	158265040	MACS_peak_11079	712.32	224	0	1	0	luma
2	158283509	158283895	MACS_peak_11080	131.14	386	0	1	0	luma
2	158424239	158424419	MACS_peak_11081	446.02	180	0	1	1	luma
2	162297975	162298273	MACS_peak_11109	692.37	298	0	1	0	luma
2	169611586	169611855	MACS_peak_11169	603.02	269	0	1	0	luma
2	171705548	171705876	MACS_peak_11181	669.21	328	0	1	0	luma
2	171706221	171706517	MACS_peak_11182	693.99	296	0	1	0	luma
2	171940922	171941262	MACS_peak_11183	407.96	340	0	2	0	luma
2	171970495	171970649	MACS_peak_11184	740.33	154	0	2	0	luma
2	174354315	174354754	MACS_peak_11209	1229.91	439	0	1	0	luma
2	174380433	174380671	MACS_peak_11210	516.86	238	0	1	0	luma
2	176127102	176127314	MACS_peak_11223	758.25	212	2	0	1	luma
2	181573061	181573371	MACS_peak_11264	437.04	310	0	1	0	luma
2	181664613	181664973	MACS_peak_11265	84.06	360	0	1	0	luma
2	188976610	188976981	MACS_peak_11325	639.57	371	1	0	0	luma
2	188983368	188983712	MACS_peak_11326	482.41	344	0	1	0	luma
2	189027043	189027327	MACS_peak_11327	52.27	284	1	0	0	luma
2	189466700	189467008	MACS_peak_11331	558.46	308	0	1	0	luma
2	189660919	189661395	MACS_peak_11332	815.52	476	1	0	0	luma
2	196298136	196298475	MACS_peak_11391	351.43	339	0	1	0	luma
2	196337465	196337767	MACS_peak_11392	441.54	302	0	1	0	luma
2	196521691	196521983	MACS_peak_11393	147.15	292	0	1	0	luma
2	196526783	196527100	MACS_peak_11394	102.96	317	0	1	0	luma
2	200856812	200857007	MACS_peak_11431	485.3	195	1	0	0	luma
2	202262175	202262548	MACS_peak_11437	103.45	373	1	0	0	luma
2	202279031	202279363	MACS_peak_11438	425.26	332	0	1	0	luma
2	203294840	203294980	MACS_peak_11444	275.54	140	0	1	0	luma
2	219171214	219171490	MACS_peak_11564	984.35	276	1	0	0	luma
2	223970379	223970573	MACS_peak_11588	848.95	194	1	0	0	luma
2	233380541	233380786	MACS_peak_11634	629.38	245	0	1	0	luma
2	236084991	236085345	MACS_peak_11642	159.56	354	0	1	0	luma
2	239357782	239358107	MACS_peak_11656	603.02	325	0	1	0	luma
2	239909877	239910132	MACS_peak_11658	1853.13	255	0	1	0	luma
3	5165297	5165484	MACS_peak_13016	712.32	187	0	1	1	luma
3	9424869	9425077	MACS_peak_13047	931.22	208	0	1	0	luma
3	15202651	15202999	MACS_peak_13098	647.33	348	1	0	1	luma
3	15220335	15220603	MACS_peak_13099	450.74	268	0	1	0	luma
3	15401428	15401560	MACS_peak_13102	977.06	132	0	1	0	luma
3	15405465	15405788	MACS_peak_13103	548.63	323	0	1	0	luma
3	15731841	15731980	MACS_peak_13104	701.67	139	0	1	0	luma
3	15812318	15812631	MACS_peak_13105	1667.82	313	0	1	0	luma
3	15815727	15816014	MACS_peak_13106	1258.14	287	0	1	0	luma
3	16268136	16268342	MACS_peak_13112	1477.15	206	1	0	0	luma
3	25648043	25648451	MACS_peak_13213	518.48	408	0	1	0	luma
3	25760859	25760998	MACS_peak_13214	652.22	139	0	1	0	luma
3	27205040	27205477	MACS_peak_13227	123	437	0	1	0	luma
3	27279324	27279512	MACS_peak_13228	883.81	188	0	1	0	luma
3	27312149	27312378	MACS_peak_13229	548.55	229	0	1	0	luma
3	27373371	27373622	MACS_peak_13230	883.81	251	1	0	0	luma
3	27439566	27439790	MACS_peak_13231	549.18	224	0	1	0	luma
3	28317438	28317706	MACS_peak_13239	853.65	268	1	1	0	luma
3	28328496	28328887	MACS_peak_13240	406.81	391	0	1	0	luma
3	31724736	31724989	MACS_peak_13261	470.06	253	0	1	0	luma
3	32279515	32279878	MACS_peak_13265	64.31	363	0	1	0	luma
3	32537971	32538171	MACS_peak_13267	983.72	200	0	1	0	luma
3	32733534	32733947	MACS_peak_13269	613.85	413	0	1	1	luma
3	33285310	33285583	MACS_peak_13270	103.45	273	0	1	0	luma
3	33309051	33309336	MACS_peak_13271	451.52	285	0	1	0	luma
3	33511646	33512026	MACS_peak_13273	61.75	380	0	1	0	luma
3	33867012	33867309	MACS_peak_13276	693.18	297	0	1	0	luma
3	41203033	41203252	MACS_peak_13331	1061.85	219	0	1	0	luma
3	42788114	42788304	MACS_peak_13339	695.57	190	1	1	1	luma
3	42848109	42848330	MACS_peak_13340	227.89	221	0	3	2	luma
3	42921999	42922378	MACS_peak_13342	66.96	379	0	2	0	luma
3	43488876	43489181	MACS_peak_13344	104.57	305	0	1	0	luma
3	43503042	43503458	MACS_peak_13345	732.46	416	0	1	0	luma
3	43638589	43638822	MACS_peak_13346	532.66	233	0	1	0	luma
3	43681010	43681261	MACS_peak_13347	234.8	251	0	1	0	luma
3	43730387	43730519	MACS_peak_13348	1116.4	132	0	1	0	luma
3	45705391	45705645	MACS_peak_13352	883.81	254	0	1	0	luma
3	45929113	45929333	MACS_peak_13353	564.54	220	0	1	0	luma
3	46372595	46372837	MACS_peak_13355	645.81	242	1	0	1	luma
3	46783255	46783628	MACS_peak_13356	81.56	373	0	2	0	luma
3	46923566	46923740	MACS_peak_13358	780.06	174	1	0	0	luma
3	47421161	47421360	MACS_peak_13359	645.81	199	0	1	0	luma
3	47468405	47468736	MACS_peak_13360	67.49	331	0	1	0	luma
3	47990087	47990264	MACS_peak_13361	763.02	177	0	1	0	luma
3	48436000	48436297	MACS_peak_13363	1101.6	297	2	0	0	luma
3	48952636	48952896	MACS_peak_13364	593.56	260	0	1	0	luma
3	49010260	49010440	MACS_peak_13365	583.31	180	1	0	0	luma
3	49464593	49464938	MACS_peak_13366	312.33	345	1	0	0	luma
3	49839300	49839493	MACS_peak_13368	866.35	193	0	1	0	luma
3	50226146	50226362	MACS_peak_13370	528	216	1	0	0	luma
3	50246253	50246462	MACS_peak_13371	606	209	0	1	0	luma
3	50616010	50616214	MACS_peak_13372	1358.26	204	1	0	0	luma
3	57824406	57824676	MACS_peak_13412	546.29	270	0	1	0	luma
3	57885662	57885999	MACS_peak_13413	293.19	337	0	1	0	luma
3	58510529	58510669	MACS_peak_13414	1025.76	140	0	1	0	luma
3	58565328	58565538	MACS_peak_13415	624.46	210	1	0	0	luma
3	63842271	63842536	MACS_peak_13483	465.8	265	0	2	0	luma
3	63851526	63851752	MACS_peak_13484	826.97	226	0	1	0	luma
3	63961798	63962131	MACS_peak_13486	424.75	333	0	2	0	luma
3	63992983	63993307	MACS_peak_13487	174.17	324	0	2	0	luma
3	64014510	64014781	MACS_peak_13489	1307.61	271	1	0	1	luma
3	64016046	64016307	MACS_peak_13490	161.92	261	0	1	0	luma
3	64021992	64022277	MACS_peak_13491	331.88	285	0	1	0	luma
3	66138615	66138994	MACS_peak_13553	515.71	379	0	1	0	luma
3	66236233	66236538	MACS_peak_13554	686.76	305	0	1	0	luma
3	69061914	69062099	MACS_peak_13568	901.33	185	0	1	0	luma
3	72748233	72748367	MACS_peak_13590	1098.16	134	1	0	0	luma
3	100283226	100283387	MACS_peak_13830	866.35	161	0	1	0	luma
3	108205618	108206067	MACS_peak_13896	959.23	449	0	1	0	luma
3	108674538	108674770	MACS_peak_13902	537.4	232	0	1	0	luma
3	108686062	108686276	MACS_peak_13903	596.79	214	0	1	0	luma
3	111338008	111338372	MACS_peak_13927	1031.37	364	0	1	0	luma
3	112189397	112189772	MACS_peak_13931	56.38	375	0	1	0	luma
3	112205275	112205495	MACS_peak_13932	175.39	220	0	1	0	luma
3	112225255	112225630	MACS_peak_13933	404.42	375	0	1	0	luma
3	113736501	113736833	MACS_peak_13945	425.26	332	0	1	0	luma
3	119821012	119821467	MACS_peak_13988	1288.68	455	1	0	0	luma
3	119891862	119892243	MACS_peak_13989	514.63	381	0	1	0	luma
3	119954066	119954363	MACS_peak_13990	534.92	297	0	1	0	luma
3	120723544	120723940	MACS_peak_13999	54.13	396	0	1	0	luma
3	120736203	120736511	MACS_peak_14000	143.12	308	0	1	0	luma
3	123258711	123259179	MACS_peak_14022	469.45	468	0	1	0	luma
3	123262527	123262819	MACS_peak_14023	829.92	292	0	1	0	luma
3	123652374	123652762	MACS_peak_14028	510.89	388	0	1	0	luma
3	123852444	123852706	MACS_peak_14029	114.74	262	0	1	0	luma
3	125268868	125269083	MACS_peak_14039	896.52	215	0	1	0	luma
3	128753278	128753479	MACS_peak_14071	478.76	201	0	1	0	luma
3	130699740	130700085	MACS_peak_14084	418.68	345	0	1	0	luma
3	130723059	130723196	MACS_peak_14085	896.34	137	0	1	0	luma
3	131057393	131057861	MACS_peak_14087	51.51	468	0	1	1	luma
3	131333541	131333855	MACS_peak_14089	70.49	314	0	1	1	luma
3	131473534	131473944	MACS_peak_14092	615.59	410	0	1	0	luma
3	131486002	131486248	MACS_peak_14093	93.49	246	0	1	0	luma
3	132469892	132470355	MACS_peak_14104	148.8	463	0	1	0	luma
3	132485994	132486210	MACS_peak_14105	746.04	216	0	1	0	luma
3	132657758	132657892	MACS_peak_14106	916.48	134	1	2	0	luma
3	138524131	138524416	MACS_peak_14172	58.29	285	0	1	0	luma
3	138545067	138545413	MACS_peak_14173	434.11	346	0	1	0	luma
3	139145086	139145447	MACS_peak_14178	52.12	361	0	1	0	luma
3	139333714	139334101	MACS_peak_14179	79.31	387	0	1	0	luma
3	139381667	139381928	MACS_peak_14180	592.77	261	0	1	0	luma
3	148861296	148861626	MACS_peak_14261	928.77	330	1	0	1	luma
3	150616285	150616645	MACS_peak_14285	96.97	360	0	1	0	luma
3	151116988	151117346	MACS_peak_14289	402.61	358	0	1	0	luma
3	151168367	151168649	MACS_peak_14290	450.7	282	0	1	0	luma
3	151218856	151219002	MACS_peak_14291	914.4	146	0	2	0	luma
3	151247113	151247549	MACS_peak_14292	69.92	436	0	2	0	luma
3	151290685	151291008	MACS_peak_14293	548.63	323	1	1	0	luma
3	151426018	151426484	MACS_peak_14295	1317.25	466	1	1	0	luma
3	155438520	155438892	MACS_peak_14339	72.11	372	0	1	0	luma
3	155537099	155537237	MACS_peak_14340	1025.3	138	0	1	0	luma
3	155544855	155545290	MACS_peak_14341	68.1	435	0	1	0	luma
3	155701918	155702177	MACS_peak_14342	603.02	259	0	1	0	luma
3	161099590	161099937	MACS_peak_14407	913.18	347	0	1	0	luma
3	161120940	161121127	MACS_peak_14408	437.67	187	0	1	0	luma
3	161220482	161220724	MACS_peak_14409	611.55	242	0	1	0	luma
3	170860031	170860408	MACS_peak_14519	889.09	377	1	0	1	luma
3	179382175	179382598	MACS_peak_14583	105.65	423	0	1	0	luma
3	179558799	179559221	MACS_peak_14584	2214.43	422	1	0	0	luma
3	179619807	179620013	MACS_peak_14585	185.79	206	0	1	0	luma
3	179750797	179751063	MACS_peak_14586	463.44	266	0	1	0	luma
3	179797488	179797850	MACS_peak_14588	410.45	362	1	0	0	luma
3	179811591	179811878	MACS_peak_14589	417.57	287	0	1	0	luma
3	179929150	179929556	MACS_peak_14590	864.57	406	0	1	0	luma
3	180707403	180707625	MACS_peak_14602	831.64	222	0	1	0	luma
3	180802825	180803170	MACS_peak_14603	418.68	345	0	1	1	luma
3	180964294	180964667	MACS_peak_14604	405.33	373	0	1	0	luma
3	184162333	184162577	MACS_peak_14623	501.16	244	0	1	0	luma
3	184174585	184174872	MACS_peak_14624	682.8	287	1	0	0	luma
3	185629095	185629336	MACS_peak_14637	588.69	241	0	1	0	luma
3	189967339	189967509	MACS_peak_14678	719.86	170	0	1	0	luma
3	193606729	193607000	MACS_peak_14705	77.03	271	0	1	0	luma
3	195424277	195424416	MACS_peak_14715	685.04	139	0	1	0	luma
3	196068125	196068313	MACS_peak_14724	883.81	188	0	1	0	luma
3	196684932	196685149	MACS_peak_14727	1276.33	217	0	1	0	luma
3	196759397	196759540	MACS_peak_14728	689.56	143	0	1	0	luma
3	196898558	196898990	MACS_peak_14730	934.75	432	0	1	0	luma
3	197807107	197807239	MACS_peak_14737	950.58	132	0	1	0	luma
4	926644	926844	MACS_peak_14754	645.81	200	0	1	0	luma
4	2230389	2230709	MACS_peak_14759	438.69	320	1	1	0	luma
4	5727256	5727486	MACS_peak_14780	96.34	230	0	1	0	luma
4	15649903	15650287	MACS_peak_14880	513.02	384	0	1	0	luma
4	17631946	17632189	MACS_peak_14889	210.25	243	1	1	0	luma
4	37940103	37940395	MACS_peak_14988	89.02	292	0	1	0	luma
4	37975577	37975826	MACS_peak_14989	744.66	249	0	1	0	luma
4	38077623	38077756	MACS_peak_14991	1098.16	133	0	1	0	luma
4	39619322	39619546	MACS_peak_14996	1025.76	224	0	1	0	luma
4	39930211	39930351	MACS_peak_14997	603.93	140	0	1	0	luma
4	39976507	39976698	MACS_peak_14998	695.57	191	0	1	0	luma
4	41958589	41958972	MACS_peak_15007	613.41	383	0	1	0	luma
4	47564449	47564714	MACS_peak_15034	1141.07	265	0	1	0	luma
4	48003518	48003869	MACS_peak_15036	779.13	351	0	2	0	luma
4	53407833	53408209	MACS_peak_15091	131.65	376	0	2	0	luma
4	53432806	53433181	MACS_peak_15092	391.26	375	0	2	0	luma
4	54234336	54234595	MACS_peak_15099	726.32	259	0	2	0	luma
4	55343010	55343155	MACS_peak_15103	1142.17	145	1	0	0	luma
4	55400116	55400555	MACS_peak_15104	406.81	439	1	0	0	luma
4	55510635	55510768	MACS_peak_15105	1396.21	133	0	1	0	luma
4	56424917	56425149	MACS_peak_15110	532.66	232	0	1	1	luma
4	70688051	70688429	MACS_peak_15199	403.06	378	1	0	0	luma
4	70918826	70919203	MACS_peak_15200	75.69	377	0	1	0	luma
4	71016656	71016919	MACS_peak_15201	138.55	263	0	2	0	luma
4	82739345	82739647	MACS_peak_15285	820.61	302	0	1	0	luma
4	82785365	82785558	MACS_peak_15286	678.9	193	0	1	0	luma
4	82898243	82898579	MACS_peak_15287	423.21	336	1	1	1	luma
4	83055036	83055238	MACS_peak_15289	500.39	202	0	1	0	luma
4	84760691	84760936	MACS_peak_15300	124.01	245	0	1	0	luma
4	84761795	84762248	MACS_peak_15301	71.7	453	0	1	0	luma
4	100421450	100421785	MACS_peak_15407	541.11	335	0	1	0	luma
4	100473454	100473646	MACS_peak_15408	1023.52	192	0	1	0	luma
4	100528867	100529246	MACS_peak_15409	159.55	379	0	1	0	luma
4	100645645	100645906	MACS_peak_15410	1001.77	261	0	1	0	luma
4	100717981	100718273	MACS_peak_15411	54.15	292	0	1	0	luma
4	100806576	100806909	MACS_peak_15412	424.75	333	0	1	0	luma
4	103187810	103188125	MACS_peak_15426	72.01	315	0	1	0	luma
4	105730412	105730800	MACS_peak_15441	89.02	388	0	2	0	luma
4	105863554	105863858	MACS_peak_15442	108.34	304	0	1	0	luma
4	105865118	105865547	MACS_peak_15443	68.83	429	0	1	0	luma
4	109826823	109827041	MACS_peak_15460	580.62	218	1	0	0	luma
4	122999907	123000237	MACS_peak_15541	55.53	330	0	1	0	luma
4	123017245	123017456	MACS_peak_15542	365.38	211	0	1	0	luma
4	123096096	123096330	MACS_peak_15543	532.66	234	0	1	0	luma
4	123117395	123117600	MACS_peak_15544	896.36	205	0	1	0	luma
4	123196446	123196654	MACS_peak_15545	1320.51	208	0	1	0	luma
4	140360108	140360378	MACS_peak_15617	460.86	270	0	1	1	luma
4	140523798	140524032	MACS_peak_15619	385.26	234	1	0	0	luma
4	145009917	145010205	MACS_peak_15645	96.57	288	0	2	0	luma
4	145609813	145610209	MACS_peak_15647	506.71	396	0	1	0	luma
4	146814704	146814857	MACS_peak_15655	506.18	153	0	1	0	luma
4	146893184	146893652	MACS_peak_15656	147.58	468	0	1	0	luma
4	146916572	146917001	MACS_peak_15657	974.86	429	0	1	0	luma
4	156968469	156968873	MACS_peak_15708	619.12	404	0	1	0	luma
4	168445800	168446087	MACS_peak_15774	82.13	287	0	1	0	luma
4	168870267	168870532	MACS_peak_15775	464.09	265	0	2	0	luma
4	174305804	174306148	MACS_peak_15806	657.74	344	0	1	0	luma
4	174319067	174319490	MACS_peak_15807	1382.4	423	0	1	0	luma
5	5467435	5467694	MACS_peak_15882	578.34	259	0	1	0	luma
5	7868113	7868381	MACS_peak_15893	853.65	268	0	2	0	luma
5	16456292	16456517	MACS_peak_15936	866.35	225	1	0	0	luma
5	36917542	36917851	MACS_peak_16078	64.39	309	0	1	0	luma
5	36944566	36944935	MACS_peak_16079	640.87	369	0	1	0	luma
5	36973212	36973494	MACS_peak_16080	265.34	282	0	1	0	luma
5	37005998	37006346	MACS_peak_16081	417.2	348	0	1	0	luma
5	37332060	37332196	MACS_peak_16083	1435.06	136	0	1	0	luma
5	37412968	37413279	MACS_peak_16084	1350.42	311	0	1	0	luma
5	43105712	43106037	MACS_peak_16128	800.34	325	0	1	0	luma
5	53004807	53005027	MACS_peak_16224	625.11	220	0	1	0	luma
5	55105956	55106380	MACS_peak_16239	579.03	424	1	0	0	luma
5	55292431	55292607	MACS_peak_16240	972.07	176	0	1	1	luma
5	55344346	55344774	MACS_peak_16241	975.66	428	0	1	0	luma
5	57195973	57196114	MACS_peak_16251	345.1	141	0	1	0	luma
5	60649377	60649638	MACS_peak_16274	576.74	261	0	1	0	luma
5	60667882	60668355	MACS_peak_16275	697.34	473	0	1	0	luma
5	62443855	62444149	MACS_peak_16284	446.16	294	0	2	0	luma
5	62460540	62460845	MACS_peak_16285	439.84	305	0	2	0	luma
5	64958815	64959069	MACS_peak_16301	470.06	254	0	1	0	luma
5	66018364	66018774	MACS_peak_16306	953.02	410	0	1	0	luma
5	66040728	66040860	MACS_peak_16307	1116.4	132	0	1	0	luma
5	66050761	66050913	MACS_peak_16308	548.25	152	0	1	0	luma
5	66060780	66061159	MACS_peak_16309	87.49	379	0	1	0	luma
5	69373593	69373806	MACS_peak_16335	602.31	213	1	0	0	luma
5	77752163	77752389	MACS_peak_16423	400.49	226	0	1	0	luma
5	77809519	77809822	MACS_peak_16424	89.02	303	0	1	0	luma
5	94226518	94226928	MACS_peak_16550	189.51	410	0	1	0	luma
5	94737961	94738170	MACS_peak_16551	771.58	209	0	2	0	luma
5	112873088	112873220	MACS_peak_16689	977.06	132	1	1	0	luma
5	112996106	112996309	MACS_peak_16690	989.9	203	0	1	0	luma
5	115831231	115831526	MACS_peak_16708	694.81	295	1	0	0	luma
5	115839080	115839347	MACS_peak_16709	718.95	267	1	1	0	luma
5	115888122	115888358	MACS_peak_16710	516.86	236	0	1	0	luma
5	119062947	119063310	MACS_peak_16732	407.35	363	0	1	1	luma
5	123545654	123545876	MACS_peak_16759	712.32	222	0	1	0	luma
5	123611130	123611593	MACS_peak_16760	1777.03	463	0	1	0	luma
5	131381314	131381637	MACS_peak_16811	312.33	323	0	1	0	luma
5	131515955	131516170	MACS_peak_16812	630.08	215	0	2	0	luma
5	131589578	131589874	MACS_peak_16813	445	296	0	2	0	luma
5	131732334	131732574	MACS_peak_16814	198.25	240	0	2	0	luma
5	131734761	131735222	MACS_peak_16815	55.51	461	0	2	0	luma
5	131778363	131778710	MACS_peak_16816	94.4	347	0	2	0	luma
5	133025364	133025721	MACS_peak_16825	265.34	357	0	1	0	luma
5	133105993	133106245	MACS_peak_16826	460.18	252	0	1	0	luma
5	136174210	136174408	MACS_peak_16843	662.31	198	0	1	0	luma
5	138195435	138195739	MACS_peak_16859	561.16	304	0	1	0	luma
5	138352355	138352710	MACS_peak_16860	650.16	355	1	0	0	luma
5	138411122	138411447	MACS_peak_16861	1065.38	325	0	1	0	luma
5	138464014	138464374	MACS_peak_16863	526.28	360	1	0	0	luma
5	139548085	139548290	MACS_peak_16871	481.25	205	0	1	0	luma
5	139582556	139582755	MACS_peak_16872	740.33	199	0	1	0	luma
5	139610437	139610759	MACS_peak_16873	424.26	322	0	1	0	luma
5	140997231	140997444	MACS_peak_16881	596.79	213	0	15	0	luma
5	141198901	141199112	MACS_peak_16884	596.79	211	1	0	2	luma
5	141326006	141326367	MACS_peak_16885	397.74	361	1	0	0	luma
5	141330328	141330501	MACS_peak_16886	723.41	173	1	0	0	luma
5	141349805	141350117	MACS_peak_16887	555.79	312	1	3	0	luma
5	141512414	141512631	MACS_peak_16888	746.04	217	1	22	0	luma
5	146130554	146130787	MACS_peak_16922	538.37	233	0	1	0	luma
5	149269044	149269348	MACS_peak_16946	440.4	304	1	0	2	luma
5	149317250	149317480	MACS_peak_16947	532.66	230	0	1	0	luma
5	150484246	150484381	MACS_peak_16953	944.23	135	1	0	1	luma
5	150737303	150737493	MACS_peak_16955	568.54	190	0	1	0	luma
5	150747507	150747988	MACS_peak_16956	72.76	481	0	1	0	luma
5	154180221	154180418	MACS_peak_16989	831.63	197	0	1	0	luma
5	154935769	154936063	MACS_peak_16995	265.34	294	0	1	0	luma
5	154945776	154945951	MACS_peak_16996	972.07	175	1	0	0	luma
5	154953354	154953492	MACS_peak_16997	1148.16	138	0	1	0	luma
5	154967497	154967760	MACS_peak_16998	722.6	263	0	1	0	luma
5	157085373	157085711	MACS_peak_17017	141.66	338	1	0	0	luma
5	157096045	157096366	MACS_peak_17018	312.33	321	0	1	0	luma
5	157816728	157817032	MACS_peak_17021	561.16	304	0	1	0	luma
5	157829086	157829422	MACS_peak_17022	384.23	336	0	1	0	luma
5	160021899	160022247	MACS_peak_17031	888.36	348	0	1	0	luma
5	163456483	163456703	MACS_peak_17058	564.54	220	1	1	0	luma
5	169821286	169821564	MACS_peak_17083	113.31	278	0	1	0	luma
5	169824056	169824386	MACS_peak_17084	63.46	330	0	1	0	luma
5	171912167	171912555	MACS_peak_17097	628.81	388	0	1	0	luma
5	171956095	171956364	MACS_peak_17098	461.5	269	0	1	0	luma
5	172002372	172002715	MACS_peak_17099	380.3	343	0	1	0	luma
5	172207814	172208067	MACS_peak_17102	596.79	253	1	0	0	luma
5	176448109	176448342	MACS_peak_17130	416.25	233	1	0	0	luma
5	177185660	177186105	MACS_peak_17136	1091.75	445	0	1	0	luma
5	177455418	177455800	MACS_peak_17138	401.26	382	1	1	0	luma
5	178130278	178130561	MACS_peak_17146	474.02	283	1	0	0	luma
5	179106627	179107044	MACS_peak_17148	144.59	417	1	0	0	luma
5	179763153	179763517	MACS_peak_17151	1594.76	364	0	1	0	luma
6	482770	483106	MACS_peak_17182	113.69	336	1	0	0	luma
6	494938	495141	MACS_peak_17183	540.33	203	0	1	0	luma
6	605782	606012	MACS_peak_17185	189.46	230	0	1	0	luma
6	617510	617727	MACS_peak_17186	580.62	217	0	1	0	luma
6	624902	625195	MACS_peak_17187	696.46	293	0	1	0	luma
6	2952621	2952979	MACS_peak_17207	648.14	358	1	0	0	luma
6	5143725	5144003	MACS_peak_17217	455.81	278	0	1	0	luma
6	5269054	5269347	MACS_peak_17218	140.77	293	0	1	0	luma
6	5379707	5379965	MACS_peak_17219	468.72	258	0	1	0	luma
6	5398526	5398759	MACS_peak_17220	532.66	233	0	1	0	luma
6	5402239	5402704	MACS_peak_17221	701.99	465	0	1	0	luma
6	5422408	5422606	MACS_peak_17222	831.63	198	0	1	0	luma
6	5471057	5471235	MACS_peak_17223	659.6	178	0	1	0	luma
6	5527988	5528214	MACS_peak_17224	1025.76	226	0	1	0	luma
6	7275976	7276189	MACS_peak_17236	451.43	213	0	1	0	luma
6	7947095	7947450	MACS_peak_17238	189.55	355	0	1	0	luma
6	10813040	10813328	MACS_peak_17255	229.83	288	0	3	0	luma
6	11575546	11575876	MACS_peak_17262	796.13	330	0	1	0	luma
6	31772914	31773134	MACS_peak_17382	413.13	220	1	1	0	luma
6	31795913	31796140	MACS_peak_17383	548.55	227	1	0	0	luma
6	31989450	31989679	MACS_peak_17384	635.07	229	0	1	0	luma
6	32022188	32022417	MACS_peak_17385	635.07	229	0	1	0	luma
6	33391173	33391547	MACS_peak_17392	1022.03	374	1	0	0	luma
6	34843438	34843817	MACS_peak_17396	682.47	379	0	1	0	luma
6	35279407	35279577	MACS_peak_17398	729.92	170	0	1	1	luma
6	35342308	35342498	MACS_peak_17400	474.18	190	1	0	0	luma
6	35415304	35415674	MACS_peak_17401	380.3	370	0	1	0	luma
6	36123904	36124120	MACS_peak_17407	944.23	216	1	0	0	luma
6	41921337	41921581	MACS_peak_17436	525.6	244	1	0	0	luma
6	42580892	42581024	MACS_peak_17437	797.63	132	0	1	0	luma
6	42845075	42845245	MACS_peak_17439	1268.27	170	0	1	0	luma
6	44151964	44152271	MACS_peak_17443	438.71	307	0	1	0	luma
6	44418907	44419235	MACS_peak_17445	75.01	328	0	1	0	luma
6	46142257	46142476	MACS_peak_17454	580.62	219	0	1	0	luma
6	52263839	52264023	MACS_peak_17504	729.14	184	1	0	0	luma
6	53093928	53094234	MACS_peak_17506	816.97	306	0	1	0	luma
6	75262751	75262939	MACS_peak_17671	695.57	188	0	1	0	luma
6	75266596	75267033	MACS_peak_17672	486.55	437	0	1	0	luma
6	75658881	75659103	MACS_peak_17673	555.12	222	0	1	0	luma
6	75660217	75660401	MACS_peak_17674	729.14	184	0	1	0	luma
6	75687619	75687893	MACS_peak_17675	233.74	274	0	1	0	luma
6	75747205	75747342	MACS_peak_17676	914.41	137	1	0	0	luma
6	75855124	75855303	MACS_peak_17677	954.29	179	0	1	0	luma
6	75902888	75903199	MACS_peak_17678	75.63	311	0	1	0	luma
6	75924396	75924859	MACS_peak_17679	1207.96	463	1	0	0	luma
6	75934994	75935226	MACS_peak_17680	514.21	232	0	1	0	luma
6	82178176	82178430	MACS_peak_17732	1171.45	254	0	1	0	luma
6	84179348	84179682	MACS_peak_17744	60.1	334	0	1	0	luma
6	85536014	85536238	MACS_peak_17761	413.13	224	0	1	0	luma
6	85537128	85537381	MACS_peak_17762	1025.76	253	0	1	0	luma
6	87443077	87443335	MACS_peak_17781	595.17	258	0	2	0	luma
6	87673043	87673183	MACS_peak_17782	431.68	140	1	0	0	luma
6	88899531	88899887	MACS_peak_17792	413.31	356	0	1	0	luma
6	88948921	88949193	MACS_peak_17793	166.08	272	0	1	0	luma
6	89729540	89729700	MACS_peak_17798	1098.16	160	0	1	0	luma
6	89796315	89796677	MACS_peak_17799	216.96	362	0	1	0	luma
6	98866667	98866986	MACS_peak_17841	73.94	319	1	0	0	luma
6	99434987	99435265	MACS_peak_17848	579.67	278	1	0	0	luma
6	99451566	99451932	MACS_peak_17849	61.12	366	0	1	0	luma
6	100524005	100524231	MACS_peak_17861	695.57	226	0	1	0	luma
6	100585966	100586271	MACS_peak_17862	222.27	305	0	1	0	luma
6	100608556	100608796	MACS_peak_17863	516.86	240	0	1	0	luma
6	100657820	100658003	MACS_peak_17864	843.77	183	0	1	0	luma
6	100664267	100664593	MACS_peak_17865	546.72	326	0	1	0	luma
6	100678126	100678386	MACS_peak_17866	862.05	260	0	1	0	luma
6	104771309	104771618	MACS_peak_17890	1230.02	309	0	1	0	luma
6	107887092	107887484	MACS_peak_17900	67.84	392	0	1	0	luma
6	108388274	108388607	MACS_peak_17902	86.65	333	0	1	0	luma
6	108515764	108516085	MACS_peak_17903	116.18	321	0	1	0	luma
6	109538435	109538711	MACS_peak_17906	50.69	276	0	1	0	luma
6	109595878	109596147	MACS_peak_17907	183.15	269	0	1	0	luma
6	109598884	109599300	MACS_peak_17908	72.76	416	0	1	0	luma
6	109649949	109650342	MACS_peak_17909	94.57	393	0	1	0	luma
6	109705196	109705464	MACS_peak_17910	587.27	268	0	1	0	luma
6	110145199	110145487	MACS_peak_17915	58.9	288	0	1	0	luma
6	110806226	110806392	MACS_peak_17918	869.22	166	0	1	0	luma
6	110991281	110991440	MACS_peak_17920	781.6	159	0	1	0	luma
6	111300460	111300721	MACS_peak_17922	724.45	261	1	0	0	luma
6	112095457	112095756	MACS_peak_17925	312.33	299	0	1	0	luma
6	112163376	112163658	MACS_peak_17926	453.35	282	0	1	1	luma
6	113936185	113936404	MACS_peak_17937	1785.17	219	1	0	0	luma
6	113994913	113995190	MACS_peak_17938	983.22	277	0	1	1	luma
6	125114213	125114590	MACS_peak_18009	1433.99	377	1	0	0	luma
6	125153560	125153789	MACS_peak_18010	695.57	229	0	1	0	luma
6	125974362	125974719	MACS_peak_18015	1458.45	357	0	1	0	luma
6	130282339	130282541	MACS_peak_18042	814.37	202	0	1	0	luma
6	130308145	130308508	MACS_peak_18043	644.81	363	0	1	0	luma
6	130322762	130322993	MACS_peak_18044	678.9	231	0	1	0	luma
6	130348727	130348924	MACS_peak_18045	122.27	197	0	1	0	luma
6	142146938	142147234	MACS_peak_18128	445	296	1	0	0	luma
6	142188450	142188622	MACS_peak_18129	690.17	172	0	1	0	luma
6	145503236	145503549	MACS_peak_18141	67.1	313	0	1	0	luma
6	145666286	145666685	MACS_peak_18142	68.17	399	0	1	0	luma
6	145679846	145680116	MACS_peak_18143	758.81	270	0	1	0	luma
6	145704255	145704490	MACS_peak_18144	1201.14	235	0	1	0	luma
6	149680632	149680764	MACS_peak_18159	1116.4	132	0	1	0	luma
6	149723852	149724121	MACS_peak_18160	842.54	269	1	0	0	luma
6	151363978	151364257	MACS_peak_18167	312.33	279	1	0	0	luma
6	151406047	151406400	MACS_peak_18168	651.52	353	1	0	0	luma
6	151568650	151568910	MACS_peak_18169	406.81	260	0	1	0	luma
6	154805389	154805659	MACS_peak_18192	697.55	270	0	1	0	luma
6	157045983	157046201	MACS_peak_18200	580.62	218	0	1	0	luma
6	157993706	157993935	MACS_peak_18202	712.57	229	0	1	0	luma
6	158444142	158444357	MACS_peak_18204	681.39	215	0	1	0	luma
6	158972563	158972814	MACS_peak_18207	613.04	251	1	0	0	luma
6	160100627	160100895	MACS_peak_18210	2187.09	268	0	1	0	luma
6	167045907	167046178	MACS_peak_18232	584.96	271	0	1	1	luma
6	169644935	169645133	MACS_peak_18241	451.06	198	0	2	0	luma
6	170575144	170575523	MACS_peak_18245	634.44	379	1	0	0	luma
7	873315	873606	MACS_peak_18262	447.93	291	1	1	0	luma
7	944080	944486	MACS_peak_18263	485.8	406	0	2	0	luma
7	1135857	1136239	MACS_peak_18264	401.26	382	0	1	0	luma
7	1996063	1996381	MACS_peak_18274	432.66	318	0	1	0	luma
7	2247250	2247478	MACS_peak_18275	848.95	228	1	1	0	luma
7	2364908	2365161	MACS_peak_18277	409.01	253	0	1	0	luma
7	2367720	2367866	MACS_peak_18278	1170.45	146	0	1	0	luma
7	2578880	2579059	MACS_peak_18279	898.14	179	0	1	0	luma
7	2748427	2748757	MACS_peak_18281	78.78	330	0	2	0	luma
7	5486976	5487240	MACS_peak_18305	464.74	264	0	1	0	luma
7	5494654	5494906	MACS_peak_18306	746.04	252	0	1	0	luma
7	5665459	5665694	MACS_peak_18308	440.38	235	0	1	1	luma
7	5704499	5704730	MACS_peak_18309	678.9	231	0	1	0	luma
7	5747681	5747881	MACS_peak_18310	1075.85	200	0	1	0	luma
7	5997256	5997542	MACS_peak_18312	357.56	286	0	1	0	luma
7	6007521	6007768	MACS_peak_18313	482.84	247	1	1	0	luma
7	6149472	6149619	MACS_peak_18314	972.07	147	0	1	0	luma
7	6435640	6435918	MACS_peak_18318	627.32	278	0	1	0	luma
7	6455211	6455352	MACS_peak_18319	816.83	141	0	2	0	luma
7	7424409	7424640	MACS_peak_18333	989.9	231	0	1	0	luma
7	7595386	7595854	MACS_peak_18334	784.97	468	0	1	0	luma
7	7678394	7678854	MACS_peak_18335	978.69	460	0	2	1	luma
7	7680595	7680985	MACS_peak_18337	567.67	390	0	2	1	luma
7	17803878	17804097	MACS_peak_18409	580.62	219	0	1	0	luma
7	23185023	23185363	MACS_peak_18444	660.56	340	1	0	0	luma
7	26198187	26198551	MACS_peak_18468	409.51	364	1	1	0	luma
7	27143716	27144005	MACS_peak_18473	449.12	289	2	1	2	luma
7	27150844	27151115	MACS_peak_18474	850.57	271	1	1	3	luma
7	27743674	27743819	MACS_peak_18477	1265.84	145	1	0	0	luma
7	30625403	30625685	MACS_peak_18488	576.71	282	0	1	0	luma
7	32490812	32491268	MACS_peak_18512	477.87	456	1	1	0	luma
7	32579261	32579648	MACS_peak_18513	1198.74	387	0	1	0	luma
7	33170357	33170574	MACS_peak_18522	154.43	217	0	1	0	luma
7	33228110	33228386	MACS_peak_18523	429.01	276	0	1	0	luma
7	33243369	33243643	MACS_peak_18524	1275.79	274	0	1	0	luma
7	33379381	33379583	MACS_peak_18525	611.83	202	0	1	0	luma
7	33411006	33411142	MACS_peak_18526	1586.65	136	0	1	0	luma
7	33459590	33459941	MACS_peak_18527	415.73	351	0	1	0	luma
7	33519730	33520008	MACS_peak_18528	335.61	278	0	1	0	luma
7	44469008	44469256	MACS_peak_18593	763.02	248	0	1	0	luma
7	64334046	64334403	MACS_peak_18785	219.12	357	0	1	0	luma
7	64697061	64697414	MACS_peak_18786	63.13	353	0	1	0	luma
7	66950211	66950343	MACS_peak_18802	1028.85	132	0	1	0	luma
7	67000765	67000996	MACS_peak_18803	532.66	231	0	1	0	luma
7	67040836	67041254	MACS_peak_18804	495.64	418	0	1	0	luma
7	67176765	67176941	MACS_peak_18805	763.02	176	0	1	0	luma
7	72168341	72168586	MACS_peak_18818	487.14	245	0	1	0	luma
7	72915100	72915338	MACS_peak_18823	481.5	238	0	1	0	luma
7	73463148	73463482	MACS_peak_18825	488.44	334	0	1	0	luma
7	74067748	74068114	MACS_peak_18829	296.93	366	0	1	0	luma
7	75452459	75452741	MACS_peak_18839	639.14	282	0	1	0	luma
7	75467505	75467669	MACS_peak_18840	785.52	164	0	1	0	luma
7	75866439	75866770	MACS_peak_18845	543.58	331	0	1	0	luma
7	75931231	75931457	MACS_peak_18846	548.55	226	0	1	0	luma
7	77759316	77759664	MACS_peak_18861	533.26	348	0	1	0	luma
7	77815263	77815535	MACS_peak_18862	695.76	272	0	1	0	luma
7	80453798	80454064	MACS_peak_18878	719.85	266	1	1	0	luma
7	80576083	80576329	MACS_peak_18879	448.91	246	0	1	0	luma
7	80659559	80659776	MACS_peak_18880	746.04	217	0	1	0	luma
7	80667325	80667668	MACS_peak_18881	751.13	343	0	1	0	luma
7	87178386	87178627	MACS_peak_18942	501.16	241	0	1	0	luma
7	90412988	90413261	MACS_peak_18968	583.44	273	0	1	1	luma
7	90427857	90428194	MACS_peak_18969	486.61	337	0	1	1	luma
7	91756801	91757119	MACS_peak_18982	372.13	318	0	1	0	luma
7	91761925	91762250	MACS_peak_18983	62.38	325	0	1	0	luma
7	91792474	91792669	MACS_peak_18984	124.81	195	0	1	0	luma
7	91830141	91830398	MACS_peak_18985	709.49	257	0	1	0	luma
7	91876744	91877054	MACS_peak_18986	557.12	310	0	1	0	luma
7	92217651	92217931	MACS_peak_18990	707.43	280	0	2	0	luma
7	92447186	92447500	MACS_peak_18992	603.02	314	1	0	1	luma
7	92449875	92450080	MACS_peak_18993	972.07	205	1	0	0	luma
7	94395497	94395767	MACS_peak_19014	716.24	270	1	0	0	luma
7	96631932	96632273	MACS_peak_19034	194.53	341	0	1	0	luma
7	96678366	96678642	MACS_peak_19035	557.06	276	0	1	0	luma
7	96704015	96704256	MACS_peak_19036	646.51	241	0	1	0	luma
7	98106497	98106820	MACS_peak_19053	1356.87	323	1	0	0	luma
7	98145696	98146014	MACS_peak_19054	551.85	318	0	1	0	luma
7	99365579	99365850	MACS_peak_19065	460.22	271	0	2	0	luma
7	99415594	99416012	MACS_peak_19066	731.14	418	2	1	0	luma
7	99913154	99913422	MACS_peak_19070	718.04	268	0	1	0	luma
7	100081830	100082142	MACS_peak_19074	790.3	312	0	1	0	luma
7	100217123	100217417	MACS_peak_19076	645.79	294	1	2	0	luma
7	100217896	100218289	MACS_peak_19077	747.46	393	1	2	0	luma
7	100469270	100469638	MACS_peak_19080	363.56	368	0	1	0	luma
7	101309870	101310071	MACS_peak_19086	777.44	201	1	0	1	luma
7	102390833	102391126	MACS_peak_19096	673.02	293	0	1	0	luma
7	102537191	102537452	MACS_peak_19099	507.36	261	3	1	0	luma
7	102539368	102539591	MACS_peak_19100	1589.86	223	3	1	0	luma
7	102544052	102544256	MACS_peak_19101	334.37	204	1	1	0	luma
7	102551642	102551965	MACS_peak_19102	773.07	323	1	2	0	luma
7	102758203	102758517	MACS_peak_19114	473.97	314	0	1	0	luma
7	102782048	102782461	MACS_peak_19115	139.27	413	0	1	0	luma
7	104156771	104157114	MACS_peak_19122	411.54	343	0	1	0	luma
7	105066961	105067101	MACS_peak_19135	876.68	140	0	1	0	luma
7	105260227	105260591	MACS_peak_19136	82.74	364	0	1	0	luma
7	105362053	105362323	MACS_peak_19137	127.5	270	0	1	0	luma
7	107320074	107320316	MACS_peak_19153	780.06	242	0	1	0	luma
7	107351080	107351426	MACS_peak_19154	114.74	346	0	1	0	luma
7	107479527	107479832	MACS_peak_19155	1236.43	305	0	1	0	luma
7	107501706	107501919	MACS_peak_19156	763.02	213	0	1	0	luma
7	107509872	107510197	MACS_peak_19157	149.64	325	0	1	0	luma
7	107510863	107511207	MACS_peak_19158	84.4	344	0	1	0	luma
7	107545778	107545910	MACS_peak_19159	1090.31	132	0	1	0	luma
7	107598909	107599358	MACS_peak_19160	506.92	449	0	1	0	luma
7	107751362	107751562	MACS_peak_19165	1212.73	200	0	1	0	luma
7	116376478	116376803	MACS_peak_19230	76.15	325	0	1	1	luma
7	116409358	116409554	MACS_peak_19231	217.56	196	0	1	1	luma
7	116526150	116526331	MACS_peak_19232	746.04	181	1	0	0	luma
7	116900576	116900842	MACS_peak_19235	719.85	266	0	1	0	luma
7	120799525	120799898	MACS_peak_19261	619.75	373	0	1	0	luma
7	123537099	123537380	MACS_peak_19285	577.45	281	1	0	0	luma
7	123540999	123541234	MACS_peak_19286	516.86	235	1	0	0	luma
7	124856338	124856659	MACS_peak_19300	431.05	321	0	1	0	luma
7	128293696	128293971	MACS_peak_19317	73.29	275	1	0	0	luma
7	128474295	128474608	MACS_peak_19321	1102.85	313	1	0	1	luma
7	130037814	130038042	MACS_peak_19336	577.34	228	0	1	0	luma
7	131192227	131192508	MACS_peak_19344	1414.71	281	0	1	0	luma
7	132986067	132986323	MACS_peak_19351	242.71	256	0	1	0	luma
7	133854715	133855146	MACS_peak_19353	1103.83	431	0	1	0	luma
7	133990976	133991212	MACS_peak_19354	814.37	236	0	1	0	luma
7	139151259	139151547	MACS_peak_19391	416.97	288	0	1	0	luma
7	139184845	139185068	MACS_peak_19392	513.05	223	0	1	0	luma
7	139399337	139399485	MACS_peak_19395	686.78	148	0	2	0	luma
7	140712111	140712390	MACS_peak_19400	52.99	279	0	1	0	luma
7	141650031	141650272	MACS_peak_19405	797.18	241	0	1	0	luma
7	149149166	149149421	MACS_peak_19466	580.75	255	0	1	0	luma
7	151754173	151754375	MACS_peak_19482	814.37	202	0	1	0	luma
7	151844530	151844712	MACS_peak_19483	729.14	182	0	1	0	luma
7	152208255	152208452	MACS_peak_19486	1065.23	197	0	1	0	luma
7	152336821	152337059	MACS_peak_19487	516.86	238	0	1	0	luma
7	156719910	156720217	MACS_peak_19506	96.97	307	0	1	0	luma
7	156778251	156778573	MACS_peak_19507	673.67	322	0	1	0	luma
7	156827581	156827962	MACS_peak_19508	514.63	381	0	1	0	luma
7	156949573	156949762	MACS_peak_19510	695.57	189	1	0	0	luma
7	157250664	157251046	MACS_peak_19511	755.85	382	0	1	0	luma
7	158885737	158886009	MACS_peak_19518	423.73	272	0	1	0	luma
8	9736458	9736716	MACS_peak_19575	76.3	258	0	1	0	luma
8	9760566	9760897	MACS_peak_19576	381.49	331	0	1	0	luma
8	11314593	11314800	MACS_peak_19579	596.67	207	0	1	0	luma
8	11765529	11765736	MACS_peak_19580	603.96	207	1	0	0	luma
8	18002371	18002681	MACS_peak_19614	100.2	310	0	1	0	luma
8	18002731	18003017	MACS_peak_19615	124.29	286	0	1	0	luma
8	19346439	19346761	MACS_peak_19623	673.67	322	0	1	0	luma
8	19372120	19372354	MACS_peak_19624	662.31	234	0	1	0	luma
8	22422594	22422929	MACS_peak_19638	565.1	335	0	1	0	luma
8	22489475	22489820	MACS_peak_19639	783.88	345	0	1	0	luma
8	22561894	22562090	MACS_peak_19640	662.31	196	0	1	0	luma
8	22574497	22574756	MACS_peak_19641	726.32	259	1	1	0	luma
8	25281631	25281911	MACS_peak_19655	578.19	280	0	1	0	luma
8	26499288	26499562	MACS_peak_19663	458.32	274	0	1	0	luma
8	26571298	26571497	MACS_peak_19664	831.63	199	0	1	0	luma
8	27426232	27426506	MACS_peak_19670	458.32	274	0	1	0	luma
8	27597216	27597497	MACS_peak_19672	577.45	281	1	0	0	luma
8	28619017	28619398	MACS_peak_19674	199.17	381	0	1	0	luma
8	28839699	28840042	MACS_peak_19675	51.97	343	0	1	0	luma
8	29004383	29004649	MACS_peak_19676	463.44	266	0	1	0	luma
8	33495597	33495737	MACS_peak_19688	1111.4	140	0	2	0	luma
8	41581568	41581918	MACS_peak_19716	171.16	350	1	0	0	luma
8	47917376	47917620	MACS_peak_19776	635.03	244	0	1	0	luma
8	52622275	52622584	MACS_peak_19801	437.6	309	1	0	0	luma
8	52698585	52698725	MACS_peak_19802	791.44	140	0	1	0	luma
8	52737149	52737411	MACS_peak_19803	466.05	262	0	1	0	luma
8	53808837	53809086	MACS_peak_19812	901.33	249	0	1	0	luma
8	54010450	54010732	MACS_peak_19813	576.71	282	0	1	0	luma
8	56970738	56971065	MACS_peak_19836	427.87	327	0	1	0	luma
8	60546788	60547146	MACS_peak_19854	172.39	358	0	1	0	luma
8	60617215	60617394	MACS_peak_19855	954.29	179	0	1	0	luma
8	66577124	66577414	MACS_peak_19894	64.51	290	0	1	0	luma
8	66579017	66579362	MACS_peak_19895	118.46	345	0	1	0	luma
8	70113676	70113890	MACS_peak_19915	596.79	214	1	0	0	luma
8	70114778	70115020	MACS_peak_19916	402.63	242	0	1	0	luma
8	73037588	73037868	MACS_peak_19935	1267.54	280	0	1	0	luma
8	73467901	73468265	MACS_peak_19941	82.74	364	0	1	0	luma
8	73687130	73687452	MACS_peak_19942	386.17	322	1	1	1	luma
8	79986663	79986924	MACS_peak_19992	66.48	261	0	2	0	luma
8	80006593	80006839	MACS_peak_19993	84.34	246	0	2	0	luma
8	80008070	80008484	MACS_peak_19994	94.8	414	0	2	0	luma
8	80023542	80023957	MACS_peak_19995	959.75	415	0	2	0	luma
8	80067229	80067446	MACS_peak_19996	1805.04	217	0	2	0	luma
8	80085092	80085334	MACS_peak_19997	501.16	242	0	1	0	luma
8	80118458	80118650	MACS_peak_19998	884.92	192	0	1	0	luma
8	86514197	86514392	MACS_peak_20065	640.49	195	1	0	0	luma
8	86558158	86558534	MACS_peak_20066	349.84	376	1	1	0	luma
8	89954528	89954666	MACS_peak_20125	989.14	138	0	1	0	luma
8	89984027	89984395	MACS_peak_20126	766.12	368	0	1	0	luma
8	89984641	89984993	MACS_peak_20127	415.24	352	0	1	0	luma
8	89994275	89994632	MACS_peak_20128	774.47	357	0	1	0	luma
8	89994702	89994936	MACS_peak_20129	532.66	234	0	1	0	luma
8	90000587	90001027	MACS_peak_20130	646.41	440	1	1	0	luma
8	95137190	95137403	MACS_peak_20191	596.79	213	1	0	0	luma
8	96695153	96695493	MACS_peak_20203	78.43	340	0	1	0	luma
8	96695891	96696208	MACS_peak_20204	54.21	317	0	1	0	luma
8	96777892	96778246	MACS_peak_20205	492.82	354	0	1	0	luma
8	96856647	96856867	MACS_peak_20206	564.54	220	0	1	0	luma
8	96964088	96964464	MACS_peak_20207	505.64	376	0	1	0	luma
8	96988100	96988368	MACS_peak_20208	506.92	268	0	1	0	luma
8	97142239	97142506	MACS_peak_20210	534.37	267	0	1	0	luma
8	97145333	97145587	MACS_peak_20211	453.3	254	0	1	0	luma
8	102407757	102407999	MACS_peak_20287	518.84	242	0	1	0	luma
8	103046814	103047047	MACS_peak_20295	1094.86	233	0	1	0	luma
8	109261577	109261818	MACS_peak_20392	729.92	241	0	1	0	luma
8	109282190	109282567	MACS_peak_20393	759.47	377	0	1	0	luma
8	109325957	109326173	MACS_peak_20395	712.64	216	0	1	0	luma
8	109552035	109552310	MACS_peak_20399	717.3	275	0	1	0	luma
8	109561684	109561974	MACS_peak_20400	1704.82	290	0	1	0	luma
8	116766127	116766460	MACS_peak_20464	424.75	333	1	1	0	luma
8	120063747	120063996	MACS_peak_20493	763.02	249	1	0	0	luma
8	120084660	120084870	MACS_peak_20494	780.06	210	0	1	0	luma
8	120118688	120119150	MACS_peak_20495	640.09	462	0	1	0	luma
8	120123512	120123771	MACS_peak_20496	1297.26	259	0	1	0	luma
8	120218054	120218322	MACS_peak_20497	587.27	268	0	1	0	luma
8	120350320	120350664	MACS_peak_20498	96.73	344	0	1	0	luma
8	120388666	120388905	MACS_peak_20499	516.86	239	0	1	0	luma
8	120421502	120421981	MACS_peak_20500	1193.97	479	0	1	0	luma
8	120452820	120453180	MACS_peak_20501	1671.3	360	0	1	0	luma
8	123804393	123804600	MACS_peak_20559	585.19	207	0	1	0	luma
8	125129862	125130137	MACS_peak_20575	2344.71	275	0	1	0	luma
8	125148393	125148591	MACS_peak_20576	509.17	198	0	1	0	luma
8	125215206	125215475	MACS_peak_20577	50.92	269	0	1	0	luma
8	125230676	125230961	MACS_peak_20578	784.02	285	0	1	0	luma
8	125432094	125432346	MACS_peak_20580	1025.76	252	1	0	0	luma
8	132600573	132600850	MACS_peak_20650	75.37	277	0	1	0	luma
8	132789617	132790009	MACS_peak_20651	626.35	392	0	1	0	luma
8	132819880	132820094	MACS_peak_20652	596.79	214	0	1	0	luma
8	140099283	140099487	MACS_peak_20687	629.38	204	0	1	1	luma
8	140338737	140339183	MACS_peak_20688	406.81	446	0	1	0	luma
8	140393807	140394185	MACS_peak_20689	516.25	378	0	1	0	luma
8	140432060	140432298	MACS_peak_20690	662.31	238	0	1	0	luma
8	140595696	140596024	MACS_peak_20691	427.34	328	0	1	0	luma
8	140668327	140668546	MACS_peak_20692	580.62	219	0	1	0	luma
8	140977873	140978301	MACS_peak_20693	81.72	428	0	1	0	luma
8	142255518	142255802	MACS_peak_20703	358.74	284	0	1	0	luma
8	142726874	142727240	MACS_peak_20706	408.57	366	1	0	0	luma
8	143314757	143315090	MACS_peak_20715	634.13	333	0	1	0	luma
8	143748611	143748918	MACS_peak_20717	685.18	307	0	1	0	luma
8	143749173	143749478	MACS_peak_20718	439.84	305	0	1	0	luma
8	143836495	143836696	MACS_peak_20719	814.37	201	1	0	0	luma
8	144234269	144234635	MACS_peak_20721	306.6	366	0	1	0	luma
8	144443956	144444246	MACS_peak_20722	448.52	290	0	1	0	luma
8	144509755	144510062	MACS_peak_20723	438.71	307	2	0	0	luma
8	144567128	144567476	MACS_peak_20724	603.06	348	0	1	0	luma
8	144730226	144730594	MACS_peak_20725	505.54	368	0	1	0	luma
8	144805143	144805330	MACS_peak_20726	453.36	187	0	1	0	luma
9	2060118	2060260	MACS_peak_20748	1067.21	142	0	1	0	luma
9	2728151	2728356	MACS_peak_20749	629.38	205	0	2	0	luma
9	5080622	5080886	MACS_peak_20765	395.93	264	0	1	0	luma
9	5679914	5680257	MACS_peak_20769	68.83	343	0	1	0	luma
9	5799216	5799480	MACS_peak_20770	590.39	264	0	1	0	luma
9	5963272	5963633	MACS_peak_20771	102.67	361	0	1	0	luma
9	6488248	6488398	MACS_peak_20774	853.84	150	0	1	0	luma
9	6907725	6908068	MACS_peak_20776	536.24	343	0	1	1	luma
9	21813969	21814214	MACS_peak_20844	780.06	245	0	2	0	luma
9	27224830	27225145	MACS_peak_20870	158.81	315	0	1	0	luma
9	32968442	32968690	MACS_peak_20903	485.56	248	1	0	0	luma
9	33111144	33111285	MACS_peak_20905	1025.76	141	0	1	0	luma
9	33886046	33886267	MACS_peak_20909	482.68	221	0	1	0	luma
9	33886640	33886779	MACS_peak_20910	902.92	139	0	1	0	luma
9	33995349	33995721	MACS_peak_20911	638.92	372	0	1	0	luma
9	34176278	34176506	MACS_peak_20912	541.5	228	1	0	0	luma
9	36257463	36257928	MACS_peak_20922	109.53	465	0	2	0	luma
9	36270403	36270535	MACS_peak_20923	857.98	132	0	2	0	luma
9	37808432	37808830	MACS_peak_20930	619.03	398	0	2	0	luma
9	65710542	65710814	MACS_peak_21107	59.86	272	0	1	0	luma
9	75077261	75077458	MACS_peak_21154	662.31	197	0	1	0	luma
9	77215970	77216392	MACS_peak_21167	493.69	422	0	1	0	luma
9	77759944	77760108	MACS_peak_21172	946.88	164	0	1	0	luma
9	77827895	77828198	MACS_peak_21173	534.92	303	0	1	0	luma
9	86287084	86287404	MACS_peak_21230	431.58	320	1	0	0	luma
9	88548046	88548464	MACS_peak_21247	482.54	418	0	1	0	luma
9	88578512	88578808	MACS_peak_21248	693.99	296	0	1	0	luma
9	93109190	93109477	MACS_peak_21277	437.02	287	0	1	0	luma
9	97598798	97599062	MACS_peak_21317	464.74	264	1	1	0	luma
9	99224449	99224662	MACS_peak_21330	914.46	213	1	0	0	luma
9	99947423	99947651	MACS_peak_21334	522.21	228	0	1	0	luma
9	100222761	100223032	MACS_peak_21336	715.34	271	0	1	0	luma
9	100323036	100323257	MACS_peak_21337	729.14	221	0	1	0	luma
9	101530113	101530495	MACS_peak_21349	401.26	382	1	1	0	luma
9	101549614	101549967	MACS_peak_21350	673.34	353	0	1	0	luma
9	107287829	107287962	MACS_peak_21401	1176.51	133	1	0	0	luma
9	107307954	107308240	MACS_peak_21402	518.15	286	0	1	0	luma
9	112711160	112711417	MACS_peak_21459	424.66	257	0	1	0	luma
9	113182066	113182288	MACS_peak_21464	712.32	222	0	1	0	luma
9	113274381	113274806	MACS_peak_21465	492.24	425	1	1	0	luma
9	113285239	113285397	MACS_peak_21466	540.72	158	0	1	0	luma
9	121213292	121213719	MACS_peak_21526	976.47	427	0	2	0	luma
9	121222469	121222730	MACS_peak_21527	705.75	261	0	2	0	luma
9	122809434	122809661	MACS_peak_21548	709.61	227	0	1	0	luma
9	124410353	124410626	MACS_peak_21561	529.8	273	0	1	0	luma
9	125011482	125011895	MACS_peak_21566	90.87	413	0	1	0	luma
9	125089378	125089565	MACS_peak_21567	646.78	187	0	1	0	luma
9	125143716	125144080	MACS_peak_21568	524.01	364	1	0	0	luma
9	126860250	126860526	MACS_peak_21584	581.17	276	1	0	0	luma
9	127786876	127787199	MACS_peak_21591	429.98	323	1	0	0	luma
9	128117661	128117997	MACS_peak_21596	1058.97	336	1	0	1	luma
9	128255286	128255544	MACS_peak_21599	1005.37	258	1	0	0	luma
9	128733175	128733545	MACS_peak_21603	496.77	370	1	0	0	luma
9	128818222	128818499	MACS_peak_21605	610.43	277	2	0	0	luma
9	129139130	129139476	MACS_peak_21609	783.08	346	0	1	0	luma
9	129142896	129143253	MACS_peak_21610	412.83	357	0	1	0	luma
9	129611089	129611307	MACS_peak_21613	580.62	218	2	0	0	luma
9	129617253	129617606	MACS_peak_21614	530.32	353	0	2	0	luma
9	129804836	129804968	MACS_peak_21616	771.26	132	1	0	0	luma
9	130099734	130100016	MACS_peak_21620	142.05	282	0	1	0	luma
9	130107209	130107427	MACS_peak_21621	580.62	218	0	1	0	luma
9	130770970	130771235	MACS_peak_21625	488.85	265	0	1	0	luma
9	130866451	130866798	MACS_peak_21626	655.65	347	0	1	0	luma
9	130870033	130870370	MACS_peak_21627	845.32	337	0	1	0	luma
9	131178373	131178681	MACS_peak_21629	1339.28	308	0	1	0	luma
9	131404105	131404238	MACS_peak_21633	1201.31	133	0	1	0	luma
9	131954379	131954621	MACS_peak_21636	1725.79	242	0	1	0	luma
9	132259233	132259425	MACS_peak_21638	619.53	192	1	0	0	luma
9	132312972	132313221	MACS_peak_21639	763.02	249	0	1	0	luma
9	132651275	132651528	MACS_peak_21640	596.79	253	0	1	0	luma
9	132653236	132653622	MACS_peak_21641	219.32	386	0	1	0	luma
9	132673456	132673661	MACS_peak_21642	608.4	205	1	0	0	luma
9	132768949	132769090	MACS_peak_21643	1025.76	141	0	1	0	luma
9	132800249	132800499	MACS_peak_21644	613.04	250	0	1	0	luma
9	133044042	133044316	MACS_peak_21646	582.68	274	0	1	0	luma
9	133329505	133329725	MACS_peak_21650	1365.09	220	1	0	0	luma
9	133403909	133404181	MACS_peak_21651	849.55	272	1	1	0	luma
9	134698528	134698858	MACS_peak_21660	1065.19	330	0	1	0	luma
9	135500500	135500723	MACS_peak_21663	564.54	223	1	1	0	luma
9	135504637	135504888	MACS_peak_21664	485.56	251	1	0	1	luma
9	135864412	135864747	MACS_peak_21667	423.72	335	0	1	0	luma
9	136791813	136792079	MACS_peak_21671	603.02	266	3	0	0	luma
9	137064156	137064386	MACS_peak_21673	675.38	230	1	0	1	luma
9	137227578	137227801	MACS_peak_21676	712.32	223	3	0	0	luma
9	137262181	137262533	MACS_peak_21678	1207.14	352	0	1	0	luma
9	137559138	137559490	MACS_peak_21684	1402.87	352	1	0	0	luma
10	178212	178666	MACS_peak_1906	591.23	454	0	1	0	luma
10	230883	231132	MACS_peak_1907	471.88	249	0	1	0	luma
10	810565	810800	MACS_peak_1911	662.31	235	1	0	0	luma
10	1050853	1051121	MACS_peak_1912	488.85	268	1	0	0	luma
10	6088653	6089055	MACS_peak_1949	1855.58	402	1	0	0	luma
10	12111036	12111382	MACS_peak_1996	418.18	346	0	1	0	luma
10	12214568	12214946	MACS_peak_1997	516.25	378	0	1	0	luma
10	13171761	13171893	MACS_peak_2011	1116.4	132	0	1	0	luma
10	13206591	13206959	MACS_peak_2012	950.42	368	0	1	0	luma
10	13586686	13586992	MACS_peak_2018	559.8	306	1	0	0	luma
10	13613430	13613850	MACS_peak_2019	506.92	420	1	1	0	luma
10	14904175	14904350	MACS_peak_2025	341.55	175	0	1	0	luma
10	15106483	15106715	MACS_peak_2028	678.9	232	1	1	0	luma
10	18630374	18630754	MACS_peak_2054	74.78	380	0	1	0	luma
10	18630768	18631100	MACS_peak_2055	156.26	332	0	1	0	luma
10	18632877	18633190	MACS_peak_2056	189.21	313	0	1	0	luma
10	19089887	19090200	MACS_peak_2060	78.93	313	0	1	0	luma
10	19090515	19090773	MACS_peak_2061	84.98	258	0	1	0	luma
10	19204331	19204649	MACS_peak_2062	339.76	318	0	1	0	luma
10	19320035	19320169	MACS_peak_2065	1098.16	134	0	1	0	luma
10	19348585	19348810	MACS_peak_2066	346.64	225	0	1	0	luma
10	19609095	19609451	MACS_peak_2067	1316.54	356	0	1	0	luma
10	19684124	19684317	MACS_peak_2068	661.2	193	0	1	0	luma
10	19788217	19788473	MACS_peak_2069	729.14	256	0	1	0	luma
10	19811570	19811883	MACS_peak_2070	422.13	313	1	0	0	luma
10	21781569	21781828	MACS_peak_2089	158.29	259	0	1	0	luma
10	21782523	21782890	MACS_peak_2090	169.77	367	0	1	0	luma
10	21839338	21839628	MACS_peak_2091	104.63	290	0	1	0	luma
10	21907939	21908315	MACS_peak_2092	721.05	376	0	1	0	luma
10	21953498	21953980	MACS_peak_2093	950.42	482	0	1	0	luma
10	21993414	21993653	MACS_peak_2094	797.18	239	0	1	0	luma
10	27046903	27047164	MACS_peak_2135	661.73	261	0	1	0	luma
10	35269387	35269854	MACS_peak_2196	349.84	467	0	1	0	luma
10	35563255	35563562	MACS_peak_2198	816.07	307	0	1	0	luma
10	45539985	45540228	MACS_peak_2378	100.65	243	0	1	0	luma
10	45667234	45667579	MACS_peak_2379	272.37	345	0	1	0	luma
10	46586810	46587014	MACS_peak_2386	797.18	204	0	1	1	luma
10	47460470	47460695	MACS_peak_2395	844.95	225	1	0	0	luma
10	49519119	49519375	MACS_peak_2414	470.06	256	0	1	0	luma
10	49890077	49890301	MACS_peak_2417	564.54	224	0	1	0	luma
10	58216477	58216721	MACS_peak_2482	629.38	244	0	1	0	luma
10	62603564	62603882	MACS_peak_2504	96.1	318	0	2	1	luma
10	63387525	63387730	MACS_peak_2509	321.35	205	0	1	0	luma
10	63446599	63446807	MACS_peak_2510	1108.27	208	0	1	0	luma
10	69289356	69289500	MACS_peak_2556	649.84	144	0	1	0	luma
10	69310419	69310552	MACS_peak_2557	1396.21	133	0	1	0	luma
10	73149979	73150342	MACS_peak_2569	146.63	363	0	1	0	luma
10	74458016	74458322	MACS_peak_2573	623.5	306	0	1	0	luma
10	74570949	74571203	MACS_peak_2574	58.33	254	0	1	0	luma
10	75120279	75120645	MACS_peak_2576	158.81	366	0	1	0	luma
10	75230610	75230857	MACS_peak_2579	471.88	247	1	1	0	luma
10	75235930	75236242	MACS_peak_2580	555.79	312	1	0	0	luma
10	77995270	77995711	MACS_peak_2596	91.01	441	0	1	0	luma
10	78047225	78047658	MACS_peak_2597	602.54	433	0	1	0	luma
10	87081641	87081904	MACS_peak_2667	243.49	263	0	1	0	luma
10	87149180	87149376	MACS_peak_2668	1193.18	196	0	1	0	luma
10	87967122	87967375	MACS_peak_2675	470.06	253	0	1	0	luma
10	88987046	88987336	MACS_peak_2681	448.52	290	1	1	0	luma
10	89764581	89764855	MACS_peak_2686	210.33	274	0	1	0	luma
10	90880140	90880379	MACS_peak_2693	645.81	239	0	1	0	luma
10	92303370	92303635	MACS_peak_2709	406.81	265	0	1	0	luma
10	92524230	92524608	MACS_peak_2710	2991.26	378	0	1	0	luma
10	93916606	93916917	MACS_peak_2722	682.05	311	0	1	0	luma
10	94162339	94162665	MACS_peak_2723	84.24	326	0	1	0	luma
10	94163496	94163748	MACS_peak_2724	124.29	252	0	1	0	luma
10	94320348	94320542	MACS_peak_2725	631.23	194	0	1	0	luma
10	97407184	97407438	MACS_peak_2747	470.06	254	0	1	1	luma
10	98228944	98229277	MACS_peak_2751	76.3	333	0	1	0	luma
10	98230175	98230491	MACS_peak_2752	63.99	316	0	1	0	luma
10	100240862	100241024	MACS_peak_2773	1079.97	162	0	1	0	luma
10	100518824	100519027	MACS_peak_2775	989.9	203	1	2	0	luma
10	100994358	100994537	MACS_peak_2778	746.04	179	1	0	0	luma
10	101012867	101013271	MACS_peak_2779	1232.32	404	0	1	0	luma
10	101034344	101034638	MACS_peak_2780	380.3	294	1	0	0	luma
10	102009938	102010164	MACS_peak_2786	1189.9	226	0	1	0	luma
10	102399527	102399809	MACS_peak_2788	839.55	282	1	1	0	luma
10	102479041	102479299	MACS_peak_2789	468.72	258	0	1	0	luma
10	102596500	102596858	MACS_peak_2790	648.14	358	0	1	0	luma
10	104017126	104017388	MACS_peak_2797	466.05	262	0	1	0	luma
10	109884321	109884572	MACS_peak_2840	746.04	251	0	1	0	luma
10	111007879	111008163	MACS_peak_2843	575.25	284	0	1	0	luma
10	118721107	118721385	MACS_peak_2884	455.81	278	0	1	0	luma
10	119846468	119846707	MACS_peak_2891	588.69	239	0	1	0	luma
10	122142855	122143067	MACS_peak_2898	763.02	212	0	1	0	luma
10	122870523	122870891	MACS_peak_2903	60.54	368	0	1	0	luma
10	125947153	125947526	MACS_peak_2915	59.12	373	0	1	0	luma
10	126344013	126344284	MACS_peak_2916	202.56	271	0	1	0	luma
10	133304725	133304994	MACS_peak_2955	852.62	269	2	1	0	luma
10	133497456	133497669	MACS_peak_2957	451.43	213	0	1	0	luma
11	189731	190106	MACS_peak_2966	352.17	375	1	1	0	luma
11	191875	192263	MACS_peak_2967	628.81	388	2	1	0	luma
11	585244	585533	MACS_peak_2970	76.3	289	0	1	0	luma
11	1953661	1953866	MACS_peak_2972	797.18	205	0	1	0	luma
11	9165970	9166177	MACS_peak_3025	613.04	207	0	1	0	luma
11	13396057	13396492	MACS_peak_3043	66.99	435	0	1	0	luma
11	14455112	14455345	MACS_peak_3058	678.9	233	0	1	0	luma
11	14572408	14572730	MACS_peak_3059	136.91	322	0	1	0	luma
11	14597573	14598025	MACS_peak_3060	178.43	452	0	1	0	luma
11	14628974	14629438	MACS_peak_3061	53.31	464	0	1	0	luma
11	16820370	16820709	MACS_peak_3085	538.66	339	0	1	0	luma
11	16946018	16946351	MACS_peak_3086	424.75	333	0	1	0	luma
11	17864469	17864819	MACS_peak_3090	532.08	350	0	1	0	luma
11	17963361	17963496	MACS_peak_3091	498.22	135	0	1	0	luma
11	17978762	17979026	MACS_peak_3092	464.74	264	0	1	0	luma
11	17979845	17980078	MACS_peak_3093	678.9	233	0	1	0	luma
11	17991772	17992102	MACS_peak_3094	488.85	330	0	1	0	luma
11	18486433	18486811	MACS_peak_3098	153.24	378	0	1	0	luma
11	28360990	28361373	MACS_peak_3179	218.92	383	0	1	0	luma
11	31546099	31546393	MACS_peak_3208	170.9	294	0	1	0	luma
11	31546621	31546980	MACS_peak_3209	52.67	359	0	1	0	luma
11	31696407	31696678	MACS_peak_3210	142.94	271	0	1	1	luma
11	32943341	32943702	MACS_peak_3218	57.34	361	0	1	0	luma
11	34926165	34926357	MACS_peak_3227	833.66	192	0	1	0	luma
11	34951776	34952087	MACS_peak_3228	87.14	311	0	1	0	luma
11	34952537	34952822	MACS_peak_3229	84.69	285	0	1	0	luma
11	35698259	35698638	MACS_peak_3231	125.37	379	0	1	0	luma
11	35705472	35705823	MACS_peak_3232	130.39	351	0	1	0	luma
11	35742396	35742821	MACS_peak_3233	1519.94	425	0	1	0	luma
11	36266095	36266404	MACS_peak_3234	437.6	309	1	0	0	luma
11	46006466	46006872	MACS_peak_3289	1126.43	406	0	1	0	luma
11	46507476	46507608	MACS_peak_3296	857.98	132	0	1	0	luma
11	46537755	46538137	MACS_peak_3297	401.26	382	0	1	0	luma
11	46573888	46574245	MACS_peak_3298	105.65	357	0	1	1	luma
11	46838689	46838825	MACS_peak_3299	1056.36	136	0	1	0	luma
11	47259588	47259932	MACS_peak_3302	657.74	344	0	1	0	luma
11	47355278	47355448	MACS_peak_3303	797.18	170	1	0	0	luma
11	47558519	47558880	MACS_peak_3305	525.71	361	0	1	0	luma
11	47721993	47722149	MACS_peak_3306	784.03	156	0	1	0	luma
11	59802662	59802951	MACS_peak_3431	571.63	289	1	1	0	luma
11	60886577	60886841	MACS_peak_3445	229.33	264	1	0	0	luma
11	61129780	61130117	MACS_peak_3448	834.03	337	1	0	0	luma
11	61446235	61446429	MACS_peak_3450	678.9	194	0	2	0	luma
11	62705565	62705960	MACS_peak_3462	507.23	395	1	2	0	luma
11	63670744	63670963	MACS_peak_3478	580.62	219	0	1	0	luma
11	63738839	63739110	MACS_peak_3479	1737.7	271	0	1	0	luma
11	64887925	64888229	MACS_peak_3482	561.16	304	0	1	0	luma
11	65112544	65112792	MACS_peak_3483	485.56	248	2	0	0	luma
11	65329950	65330315	MACS_peak_3484	495.65	365	1	0	0	luma
11	65593873	65594079	MACS_peak_3486	797.18	206	2	0	0	luma
11	65711836	65712013	MACS_peak_3488	1844.9	177	2	0	0	luma
11	65845028	65845334	MACS_peak_3490	336.45	306	0	2	0	luma
11	65884742	65884927	MACS_peak_3491	901.33	185	1	0	0	luma
11	66094186	66094665	MACS_peak_3494	127.93	479	0	1	0	luma
11	66095005	66095384	MACS_peak_3495	55.29	379	0	1	0	luma
11	66222710	66222921	MACS_peak_3496	596.79	211	0	1	0	luma
11	66282562	66282858	MACS_peak_3497	566.68	296	2	0	0	luma
11	66694646	66694993	MACS_peak_3499	380.3	347	0	1	0	luma
11	67168339	67168537	MACS_peak_3500	831.63	198	0	1	0	luma
11	67345909	67346222	MACS_peak_3501	810.73	313	1	1	0	luma
11	67356922	67357133	MACS_peak_3502	1301.7	211	0	2	0	luma
11	67371377	67371628	MACS_peak_3503	485.56	251	0	3	0	luma
11	68206195	68206412	MACS_peak_3511	580.62	217	0	1	0	luma
11	68409059	68409346	MACS_peak_3512	573.07	287	0	1	0	luma
11	68727905	68728087	MACS_peak_3514	729.14	182	0	1	0	luma
11	69101411	69101761	MACS_peak_3517	416.22	350	0	1	0	luma
11	69670302	69670556	MACS_peak_3518	470.06	254	0	1	0	luma
11	71512621	71513011	MACS_peak_3526	113.09	390	0	1	0	luma
11	71800311	71800787	MACS_peak_3533	815.52	476	0	1	1	luma
11	72025060	72025456	MACS_peak_3536	972.38	396	0	1	0	luma
11	72434154	72434408	MACS_peak_3540	1171.45	254	0	1	0	luma
11	72683729	72684081	MACS_peak_3543	415.24	352	1	0	0	luma
11	73072660	73073011	MACS_peak_3544	371.55	351	0	1	0	luma
11	73351115	73351503	MACS_peak_3550	1102.85	388	0	1	0	luma
11	73393656	73393920	MACS_peak_3551	972.38	264	0	1	0	luma
11	73478776	73479053	MACS_peak_3552	456.44	277	0	1	0	luma
11	73544661	73545026	MACS_peak_3553	643.49	365	0	1	0	luma
11	73729893	73730197	MACS_peak_3555	529.34	304	0	1	0	luma
11	73812197	73812432	MACS_peak_3556	448.43	235	0	1	0	luma
11	74621987	74622394	MACS_peak_3564	473.28	407	0	1	0	luma
11	74757112	74757497	MACS_peak_3566	96.97	385	0	1	0	luma
11	74758221	74758585	MACS_peak_3567	76.89	364	0	1	0	luma
11	74799820	74800033	MACS_peak_3568	370.25	213	0	1	0	luma
11	74830785	74831115	MACS_peak_3569	1069.92	330	0	2	1	luma
11	75121950	75122341	MACS_peak_3575	83.36	391	0	1	1	luma
11	75124685	75124978	MACS_peak_3576	165.91	293	0	1	1	luma
11	75407933	75408266	MACS_peak_3581	1345.06	333	0	1	0	luma
11	76881535	76881748	MACS_peak_3593	511.33	213	0	1	0	luma
11	76908808	76909181	MACS_peak_3594	92.88	373	0	1	0	luma
11	76939804	76940076	MACS_peak_3595	584.2	272	0	1	0	luma
11	77326944	77327354	MACS_peak_3600	82.65	410	0	1	0	luma
11	77329110	77329421	MACS_peak_3601	95.79	311	0	1	0	luma
11	77330156	77330498	MACS_peak_3602	111.37	342	0	1	0	luma
11	77619641	77619864	MACS_peak_3604	564.54	223	0	1	0	luma
11	77758725	77758982	MACS_peak_3605	338.06	257	0	1	0	luma
11	77888606	77888994	MACS_peak_3606	172.39	388	0	2	0	luma
11	77949458	77949750	MACS_peak_3607	142.05	292	0	1	0	luma
11	78104837	78105134	MACS_peak_3608	512.48	297	1	0	0	luma
11	78414155	78414545	MACS_peak_3609	679.18	390	0	1	1	luma
11	82864293	82864528	MACS_peak_3650	972.07	235	0	1	0	luma
11	86041928	86042155	MACS_peak_3676	548.55	227	0	1	0	luma
11	86307891	86308288	MACS_peak_3678	391.67	397	0	1	0	luma
11	86456017	86456498	MACS_peak_3681	671.72	481	0	1	1	luma
11	86571642	86571899	MACS_peak_3682	449.27	257	0	1	1	luma
11	86653304	86653590	MACS_peak_3683	112.91	286	0	1	0	luma
11	86655455	86655908	MACS_peak_3684	57.34	453	0	1	0	luma
11	86826330	86826694	MACS_peak_3685	61.7	364	0	1	0	luma
11	86828322	86828776	MACS_peak_3686	57.09	454	0	1	0	luma
11	95874619	95875059	MACS_peak_3750	119.54	440	0	1	0	luma
11	101456795	101457086	MACS_peak_3776	570.2	291	0	1	0	luma
11	101679425	101679653	MACS_peak_3777	192	228	0	1	0	luma
11	101702969	101703355	MACS_peak_3778	667.43	386	0	1	0	luma
11	101841979	101842355	MACS_peak_3780	114.74	376	0	1	0	luma
11	103138769	103139188	MACS_peak_3786	77.02	419	0	1	0	luma
11	103325943	103326243	MACS_peak_3787	690.75	300	0	1	0	luma
11	107364182	107364564	MACS_peak_3802	78.42	382	0	1	0	luma
11	107364700	107365154	MACS_peak_3803	50.57	454	0	1	0	luma
11	107367080	107367423	MACS_peak_3804	124.94	343	0	1	0	luma
11	107838376	107838752	MACS_peak_3805	265.34	376	0	1	0	luma
11	108359256	108359728	MACS_peak_3807	272.09	472	0	2	0	luma
11	108359933	108360195	MACS_peak_3808	85.37	262	0	2	0	luma
11	108361919	108362382	MACS_peak_3809	100.2	463	0	2	0	luma
11	108684420	108684765	MACS_peak_3811	95.66	345	0	1	0	luma
11	108697922	108698178	MACS_peak_3812	729.14	256	0	1	0	luma
11	113766664	113766986	MACS_peak_3835	229.83	322	0	1	0	luma
11	118198336	118198578	MACS_peak_3867	645.81	242	1	0	0	luma
11	118488535	118488951	MACS_peak_3870	455.81	416	0	1	0	luma
11	118565803	118566217	MACS_peak_3871	497.6	414	0	1	0	luma
11	118772253	118772469	MACS_peak_3875	577.49	216	0	1	0	luma
11	119004064	119004268	MACS_peak_3876	573.39	204	0	1	1	luma
11	126237657	126237887	MACS_peak_3905	762.11	230	0	1	0	luma
11	126310565	126310774	MACS_peak_3906	613.04	209	0	1	0	luma
11	129175073	129175519	MACS_peak_3910	54.32	446	0	1	0	luma
11	129193435	129193835	MACS_peak_3911	889.09	400	0	1	0	luma
11	129245099	129245472	MACS_peak_3912	148.81	373	0	1	0	luma
11	134262103	134262310	MACS_peak_3933	613.04	207	0	1	0	luma
12	2885365	2885586	MACS_peak_3950	1043.77	221	0	2	0	luma
12	4511092	4511528	MACS_peak_3962	81.42	436	0	1	0	luma
12	4512658	4513004	MACS_peak_3963	50.76	346	0	1	0	luma
12	4571515	4571688	MACS_peak_3964	723.41	173	0	1	0	luma
12	6938000	6938332	MACS_peak_3981	542.96	332	1	1	0	luma
12	7319557	7319717	MACS_peak_3983	1472.89	160	0	1	0	luma
12	9748520	9748983	MACS_peak_3996	1076.78	463	1	0	0	luma
12	12409153	12409392	MACS_peak_4021	253.88	239	0	1	0	luma
12	12409864	12410249	MACS_peak_4022	187.51	385	0	1	0	luma
12	13077898	13078249	MACS_peak_4024	114.74	351	0	1	0	luma
12	13098448	13098595	MACS_peak_4025	1087.19	147	0	2	0	luma
12	14630162	14630343	MACS_peak_4032	936.57	181	0	1	0	luma
12	14863592	14863940	MACS_peak_4034	127.5	348	0	1	0	luma
12	26216511	26216811	MACS_peak_4089	69.69	300	0	1	1	luma
12	27039504	27039721	MACS_peak_4095	423.76	217	0	1	0	luma
12	28267592	28267965	MACS_peak_4107	762.41	373	0	1	0	luma
12	28523362	28523680	MACS_peak_4108	133.95	318	0	1	0	luma
12	32717144	32717468	MACS_peak_4127	801.19	324	0	1	0	luma
12	42332334	42332680	MACS_peak_4221	418.18	346	0	1	0	luma
12	45725767	45726011	MACS_peak_4243	918.92	244	1	0	1	luma
12	45762525	45762877	MACS_peak_4244	530.91	352	0	1	0	luma
12	49513987	49514438	MACS_peak_4278	598.13	451	0	1	0	luma
12	49636988	49637187	MACS_peak_4280	831.63	199	1	1	0	luma
12	52894544	52894680	MACS_peak_4319	664.91	136	1	0	0	luma
12	53655229	53655450	MACS_peak_4326	564.54	221	0	1	0	luma
12	53676110	53676481	MACS_peak_4327	520.09	371	0	1	0	luma
12	54032585	54032854	MACS_peak_4330	852.62	269	1	2	1	luma
12	55928417	55928713	MACS_peak_4360	603.02	296	1	1	0	luma
12	55996154	55996384	MACS_peak_4361	532.66	230	1	1	0	luma
12	56271096	56271453	MACS_peak_4366	528	357	2	0	0	luma
12	56594184	56594437	MACS_peak_4373	470.06	253	1	1	0	luma
12	56636801	56637183	MACS_peak_4374	312.33	382	1	0	0	luma
12	64499027	64499167	MACS_peak_4463	1752.27	140	0	1	0	luma
12	65306603	65306809	MACS_peak_4469	629.38	206	0	1	0	luma
12	65351305	65351656	MACS_peak_4470	87.12	351	0	1	0	luma
12	65352473	65352755	MACS_peak_4471	103.45	282	0	1	0	luma
12	68766482	68766614	MACS_peak_4505	977.06	132	0	1	0	luma
12	68830324	68830614	MACS_peak_4506	418.87	290	0	1	0	luma
12	68833044	68833394	MACS_peak_4507	304.28	350	0	1	0	luma
12	70590028	70590322	MACS_peak_4529	625.23	294	0	1	0	luma
12	70630868	70631244	MACS_peak_4530	115.9	376	0	1	0	luma
12	89459403	89459687	MACS_peak_4750	600.96	284	0	1	0	luma
12	89521999	89522280	MACS_peak_4751	1120.76	281	2	1	0	luma
12	93410040	93410315	MACS_peak_4777	581.92	275	1	0	0	luma
12	93735237	93735599	MACS_peak_4779	488.85	362	0	1	1	luma
12	95073652	95073958	MACS_peak_4789	685.97	306	1	0	0	luma
12	100322039	100322334	MACS_peak_4839	243.49	295	0	1	0	luma
12	102091392	102091527	MACS_peak_4857	702.09	135	0	1	0	luma
12	102095706	102095940	MACS_peak_4858	644.94	234	0	1	0	luma
12	106261573	106261828	MACS_peak_4903	866.35	255	0	1	0	luma
12	106357387	106357752	MACS_peak_4904	409.04	365	1	0	0	luma
12	106472038	106472302	MACS_peak_4905	125.63	264	0	1	0	luma
12	106473360	106473777	MACS_peak_4906	82.72	417	0	1	0	luma
12	106778355	106778590	MACS_peak_4908	847.1	235	1	0	0	luma
12	108511978	108512270	MACS_peak_4921	829.92	292	1	0	0	luma
12	108803578	108803828	MACS_peak_4924	485.56	250	0	1	0	luma
12	110430831	110431064	MACS_peak_4935	302.6	233	1	0	1	luma
12	110431204	110431671	MACS_peak_4936	1204.42	467	1	0	1	luma
12	111529320	111529705	MACS_peak_4943	630.67	385	0	1	0	luma
12	111553484	111553709	MACS_peak_4944	181.09	225	0	1	0	luma
12	112058889	112059208	MACS_peak_4948	114.74	319	0	1	0	luma
12	112138736	112138996	MACS_peak_4949	440.77	260	0	1	0	luma
12	112198219	112198476	MACS_peak_4950	469.39	257	0	1	0	luma
12	112411614	112411839	MACS_peak_4951	839.47	225	0	1	0	luma
12	113005822	113006253	MACS_peak_4956	285.42	431	0	1	1	luma
12	113174467	113174636	MACS_peak_4960	1025.76	169	0	1	0	luma
12	113952899	113953114	MACS_peak_4961	453.32	215	0	1	0	luma
12	118377927	118378199	MACS_peak_4984	2566.34	272	1	0	0	luma
12	120552950	120553102	MACS_peak_5004	2041.47	152	0	1	0	luma
12	120583450	120583752	MACS_peak_5005	441.54	302	1	0	0	luma
12	120714050	120714392	MACS_peak_5007	536.84	342	1	0	0	luma
12	120898213	120898421	MACS_peak_5008	760.34	208	0	1	0	luma
12	121255162	121255391	MACS_peak_5013	848.95	229	0	1	0	luma
12	121479018	121479396	MACS_peak_5014	831.33	378	0	1	0	luma
12	121499943	121500214	MACS_peak_5015	1279.99	271	0	1	0	luma
12	121539225	121539366	MACS_peak_5016	1588.16	141	0	1	0	luma
12	122289695	122289828	MACS_peak_5022	1341.63	133	0	1	0	luma
12	122336105	122336442	MACS_peak_5023	922.25	337	0	1	0	luma
12	122471666	122471992	MACS_peak_5024	997.64	326	1	0	0	luma
12	123264081	123264492	MACS_peak_5029	834.03	411	1	0	0	luma
12	123322892	123323130	MACS_peak_5030	690.17	238	0	1	0	luma
12	123582202	123582392	MACS_peak_5033	1167.67	190	1	0	1	luma
12	123801660	123801833	MACS_peak_5034	1208.41	173	0	1	0	luma
12	123810267	123810639	MACS_peak_5035	312.33	372	0	1	0	luma
12	132809461	132809828	MACS_peak_5093	1310.99	367	0	1	0	luma
13	19642444	19642712	MACS_peak_5105	718.04	268	0	1	0	luma
13	19718145	19718437	MACS_peak_5106	447.34	292	0	1	0	luma
13	20828636	20828916	MACS_peak_5112	578.19	280	0	1	0	luma
13	20829194	20829483	MACS_peak_5113	449.12	289	0	1	0	luma
13	21551741	21552117	MACS_peak_5118	91.89	376	0	1	0	luma
13	23781176	23781474	MACS_peak_5136	69	298	0	1	0	luma
13	27580119	27580389	MACS_peak_5157	3100	270	0	1	0	luma
13	27696428	27696713	MACS_peak_5158	703.15	285	0	1	1	luma
13	28293380	28293512	MACS_peak_5164	981.89	132	0	1	0	luma
13	28324299	28324487	MACS_peak_5165	695.57	188	0	1	0	luma
13	29508247	29508448	MACS_peak_5169	645.81	201	1	0	0	luma
13	32604510	32604969	MACS_peak_5186	134.63	459	0	1	0	luma
13	32650778	32651076	MACS_peak_5187	960.47	298	0	1	0	luma
13	32668941	32669331	MACS_peak_5188	722.05	390	0	1	0	luma
13	32713416	32713610	MACS_peak_5189	873.21	194	0	1	0	luma
13	33855777	33856126	MACS_peak_5195	416.71	349	0	1	0	luma
13	39742198	39742448	MACS_peak_5233	157.99	250	0	1	0	luma
13	40737301	40737561	MACS_peak_5240	79.76	260	0	1	0	luma
13	40738050	40738307	MACS_peak_5241	52.18	257	0	1	0	luma
13	40740404	40740783	MACS_peak_5242	108.26	379	0	1	0	luma
13	41075154	41075352	MACS_peak_5246	808.21	198	0	1	0	luma
13	41222273	41222497	MACS_peak_5248	564.54	224	0	1	1	luma
13	41353123	41353305	MACS_peak_5249	710.43	182	0	1	0	luma
13	42141892	42142163	MACS_peak_5253	124.62	271	0	1	0	luma
13	42216072	42216420	MACS_peak_5254	417.2	348	0	1	0	luma
13	42967011	42967371	MACS_peak_5257	164.26	360	0	1	0	luma
13	44483678	44483969	MACS_peak_5271	674.68	291	0	1	0	luma
13	45511633	45511851	MACS_peak_5276	577.49	218	0	1	0	luma
13	45515955	45516307	MACS_peak_5277	415.24	352	0	1	0	luma
13	47784177	47784602	MACS_peak_5306	119.11	425	0	1	0	luma
13	47784823	47785284	MACS_peak_5307	62.5	461	0	1	0	luma
13	47785935	47786316	MACS_peak_5308	54.79	381	0	1	0	luma
13	48015860	48016301	MACS_peak_5310	91.01	441	0	1	0	luma
13	48016404	48016755	MACS_peak_5311	68.83	351	0	1	0	luma
13	48037967	48038229	MACS_peak_5312	838.54	262	1	0	0	luma
13	48336418	48336690	MACS_peak_5314	62.38	272	0	1	0	luma
13	48337396	48337760	MACS_peak_5315	140.37	364	0	1	0	luma
13	49281151	49281363	MACS_peak_5317	596.79	212	0	1	0	luma
13	50985036	50985321	MACS_peak_5324	96.14	285	0	1	0	luma
13	50987641	50987962	MACS_peak_5325	141.24	321	0	1	0	luma
13	51435011	51435366	MACS_peak_5327	776.01	355	0	1	0	luma
13	51733803	51733999	MACS_peak_5329	662.31	196	0	1	0	luma
13	51787690	51788006	MACS_peak_5330	433.75	316	0	2	0	luma
13	52665410	52665632	MACS_peak_5338	712.32	222	0	1	0	luma
13	59678139	59678503	MACS_peak_5371	409.51	364	0	1	0	luma
13	59680498	59680823	MACS_peak_5372	1236.43	325	0	1	0	luma
13	59771336	59771594	MACS_peak_5373	595.17	258	0	1	0	luma
13	59906471	59906776	MACS_peak_5375	560.48	305	0	1	0	luma
13	60473620	60473855	MACS_peak_5378	662.31	235	0	1	0	luma
13	72882560	72882816	MACS_peak_5450	729.14	256	0	1	0	luma
13	79491534	79491857	MACS_peak_5488	722.05	323	0	1	0	luma
13	79541425	79541765	MACS_peak_5489	421.18	340	0	1	0	luma
13	98840198	98840402	MACS_peak_5589	629.38	204	0	1	0	luma
13	99266027	99266192	MACS_peak_5590	1061.85	165	0	1	0	luma
13	99269662	99269933	MACS_peak_5591	460.22	271	0	1	0	luma
13	99528642	99528891	MACS_peak_5592	485.56	249	0	1	0	luma
13	100633953	100634269	MACS_peak_5593	678.2	316	0	1	0	luma
13	101642117	101642350	MACS_peak_5596	263.69	233	0	1	0	luma
13	111221106	111221410	MACS_peak_5645	440.4	304	0	1	0	luma
13	112573095	112573359	MACS_peak_5648	857.82	264	0	1	0	luma
13	113241400	113241532	MACS_peak_5649	1116.4	132	0	1	0	luma
13	113450994	113451331	MACS_peak_5650	1485.25	337	1	1	0	luma
13	113621483	113621698	MACS_peak_5651	944.23	215	0	1	0	luma
14	20690992	20691364	MACS_peak_5709	763.14	372	0	3	0	luma
14	21092518	21092833	MACS_peak_5714	434.29	315	1	0	0	luma
14	21456563	21456927	MACS_peak_5718	582.02	364	1	0	0	luma
14	23056189	23056497	MACS_peak_5746	438.15	308	1	1	0	luma
14	23068929	23069191	MACS_peak_5747	723.53	262	0	1	0	luma
14	23120793	23121098	MACS_peak_5748	872.75	305	2	0	0	luma
14	24002940	24003316	MACS_peak_5753	176.43	376	0	1	1	luma
14	24112447	24112819	MACS_peak_5757	64.04	372	1	1	0	luma
14	24308093	24308376	MACS_peak_5759	704.85	283	3	1	0	luma
14	24327933	24328123	MACS_peak_5760	730.64	190	1	1	0	luma
14	24332236	24332444	MACS_peak_5761	780.06	208	2	1	0	luma
14	30656168	30656457	MACS_peak_5830	449.12	289	0	1	0	luma
14	30666197	30666435	MACS_peak_5831	100.83	238	0	1	0	luma
14	30666512	30666816	MACS_peak_5832	132.69	304	0	1	0	luma
14	30681705	30682092	MACS_peak_5833	575.04	387	0	1	0	luma
14	30980230	30980535	MACS_peak_5835	825.19	305	0	1	0	luma
14	31127996	31128246	MACS_peak_5837	485.56	250	0	1	0	luma
14	31355962	31356298	MACS_peak_5839	423.21	336	0	2	0	luma
14	35620301	35620649	MACS_peak_5872	227.21	348	0	1	0	luma
14	36781251	36781491	MACS_peak_5881	936.57	240	0	1	0	luma
14	36892542	36892901	MACS_peak_5883	179.12	359	0	1	0	luma
14	36942332	36942570	MACS_peak_5884	932.35	238	0	1	0	luma
14	37015511	37015838	MACS_peak_5885	121.38	327	0	1	0	luma
14	37015979	37016305	MACS_peak_5886	99.41	326	0	1	0	luma
14	37117632	37117893	MACS_peak_5887	466.72	261	0	1	0	luma
14	37149733	37150160	MACS_peak_5888	611.86	427	0	1	0	luma
14	37230702	37230918	MACS_peak_5889	1079.97	216	0	1	0	luma
14	37295498	37295747	MACS_peak_5890	133.99	249	0	1	0	luma
14	37446218	37446553	MACS_peak_5891	83.8	335	0	1	0	luma
14	37446564	37446938	MACS_peak_5892	119.37	374	0	1	0	luma
14	49586929	49587176	MACS_peak_6045	485.56	247	0	1	0	luma
14	49830176	49830411	MACS_peak_6046	502.51	235	0	1	0	luma
14	50105090	50105285	MACS_peak_6052	869.22	195	1	0	0	luma
14	50236739	50237095	MACS_peak_6053	268.76	356	1	0	0	luma
14	50243545	50243846	MACS_peak_6054	141.59	301	0	1	0	luma
14	50755546	50755781	MACS_peak_6057	516.86	235	0	1	0	luma
14	50773766	50773967	MACS_peak_6058	645.81	201	0	1	0	luma
14	50777850	50778216	MACS_peak_6059	1165.72	366	0	1	0	luma
14	51250173	51250429	MACS_peak_6063	666.39	256	0	1	0	luma
14	54403026	54403301	MACS_peak_6100	69	275	0	1	0	luma
14	54950974	54951332	MACS_peak_6106	63.49	358	0	1	0	luma
14	54981782	54982015	MACS_peak_6107	429.38	233	0	1	0	luma
14	55051430	55051675	MACS_peak_6108	501.16	245	1	0	0	luma
14	55161131	55161326	MACS_peak_6109	490.85	195	0	1	0	luma
14	55280350	55280707	MACS_peak_6113	443.57	357	0	1	0	luma
14	55297934	55298313	MACS_peak_6114	515.71	379	0	1	0	luma
14	55322992	55323345	MACS_peak_6115	272.05	353	0	1	0	luma
14	57202741	57202974	MACS_peak_6140	525.73	233	1	0	0	luma
14	57294225	57294571	MACS_peak_6141	656.34	346	0	1	0	luma
14	58208534	58208739	MACS_peak_6154	612.68	205	0	2	0	luma
14	60268318	60268567	MACS_peak_6172	525.79	249	0	1	0	luma
14	60887653	60888050	MACS_peak_6179	94.4	397	0	1	1	luma
14	60910917	60911259	MACS_peak_6180	90.24	342	0	1	1	luma
14	61011507	61011798	MACS_peak_6181	122.82	291	0	1	0	luma
14	61025316	61025556	MACS_peak_6182	502.51	240	0	1	0	luma
14	63388937	63389202	MACS_peak_6213	464.09	265	0	1	0	luma
14	63398322	63398543	MACS_peak_6214	729.14	221	0	1	0	luma
14	63641464	63641642	MACS_peak_6216	1422.04	178	0	1	0	luma
14	64430063	64430278	MACS_peak_6219	543.04	215	0	1	1	luma
14	64511174	64511379	MACS_peak_6220	573.39	205	0	1	0	luma
14	64983816	64984180	MACS_peak_6224	693.48	364	1	1	0	luma
14	69129320	69129601	MACS_peak_6252	577.45	281	0	1	0	luma
14	69460095	69460496	MACS_peak_6254	393.43	401	0	1	0	luma
14	70330566	70330828	MACS_peak_6265	1336.03	262	1	1	0	luma
14	70938194	70938544	MACS_peak_6269	50.92	350	0	1	0	luma
14	70959886	70960146	MACS_peak_6270	81.88	260	0	1	0	luma
14	70975841	70976029	MACS_peak_6271	687.06	188	0	1	0	luma
14	71037281	71037531	MACS_peak_6272	75.91	250	0	1	0	luma
14	71050280	71050539	MACS_peak_6274	540.64	259	0	1	0	luma
14	71104010	71104220	MACS_peak_6275	613.04	210	0	1	0	luma
14	73023157	73023459	MACS_peak_6296	178.37	302	0	1	0	luma
14	73197843	73198135	MACS_peak_6297	488.85	292	0	1	0	luma
14	73314617	73314812	MACS_peak_6299	649.48	195	0	1	0	luma
14	73387717	73387947	MACS_peak_6300	510.52	230	0	1	1	luma
14	73390188	73390444	MACS_peak_6301	729.14	256	0	1	1	luma
14	73508741	73508879	MACS_peak_6302	1406.54	138	0	1	0	luma
14	73570973	73571285	MACS_peak_6303	1127.86	312	1	0	0	luma
14	74087339	74087542	MACS_peak_6306	654.07	203	1	0	0	luma
14	74096931	74097159	MACS_peak_6307	498.19	228	0	1	0	luma
14	74111672	74111880	MACS_peak_6308	770.35	208	0	1	0	luma
14	74125460	74125919	MACS_peak_6309	157.77	459	0	1	0	luma
14	74180148	74180498	MACS_peak_6310	265.34	350	0	1	0	luma
14	74508391	74508619	MACS_peak_6313	695.57	228	0	1	0	luma
14	74564005	74564419	MACS_peak_6314	1329.38	414	0	1	0	luma
14	74727146	74727504	MACS_peak_6315	56.95	358	0	1	0	luma
14	74878444	74878706	MACS_peak_6316	1136.13	262	1	0	0	luma
14	75088649	75088869	MACS_peak_6318	549.18	220	0	1	0	luma
14	75654235	75654486	MACS_peak_6322	485.56	251	1	2	0	luma
14	75906734	75907008	MACS_peak_6323	582.68	274	1	1	0	luma
14	76149381	76149735	MACS_peak_6324	611.86	354	1	0	1	luma
14	76199014	76199322	MACS_peak_6325	438.15	308	0	1	0	luma
14	77300959	77301315	MACS_peak_6334	775.24	356	0	1	0	luma
14	77315816	77316150	MACS_peak_6335	664.84	334	0	1	0	luma
14	88407507	88407838	MACS_peak_6418	105.65	331	0	1	0	luma
14	88445498	88445762	MACS_peak_6419	50.92	264	0	1	0	luma
14	88459240	88459610	MACS_peak_6420	124.97	370	0	1	0	luma
14	88460023	88460435	MACS_peak_6421	89.02	412	0	1	0	luma
14	88468463	88468780	MACS_peak_6422	3100	317	1	1	0	luma
14	91645552	91645893	MACS_peak_6446	85.73	341	0	1	0	luma
14	91649868	91650240	MACS_peak_6447	413.49	372	0	1	0	luma
14	93234003	93234319	MACS_peak_6457	1053.5	316	1	0	0	luma
14	100242020	100242205	MACS_peak_6487	536.31	185	1	0	0	luma
14	100271186	100271549	MACS_peak_6488	478.36	363	0	1	0	luma
14	101771058	101771470	MACS_peak_6497	552.59	412	0	1	0	luma
14	102096634	102096875	MACS_peak_6499	487.14	241	0	1	0	luma
14	102314299	102314547	MACS_peak_6500	485.56	248	1	0	0	luma
14	102972684	102972850	MACS_peak_6502	527.73	166	0	1	0	luma
14	103031951	103032192	MACS_peak_6503	646.51	241	0	1	0	luma
14	103048518	103048808	MACS_peak_6504	274.91	290	0	1	0	luma
14	103394033	103394297	MACS_peak_6509	986.85	264	0	1	0	luma
14	105317156	105317433	MACS_peak_6525	691.36	277	0	1	0	luma
15	22884430	22884673	MACS_peak_6605	780.06	243	0	1	0	luma
15	24927371	24927597	MACS_peak_6630	243.16	226	0	1	0	luma
15	28305243	28305633	MACS_peak_6639	137.06	390	0	1	0	luma
15	29925960	29926200	MACS_peak_6652	516.86	240	0	1	0	luma
15	30929601	30930024	MACS_peak_6673	722.05	423	0	1	0	luma
15	32610841	32611125	MACS_peak_6690	575.25	284	1	0	1	luma
15	32617486	32617737	MACS_peak_6691	131.01	251	1	0	0	luma
15	34089104	34089390	MACS_peak_6695	277.16	286	0	1	0	luma
15	38449872	38450072	MACS_peak_6717	645.81	200	1	0	0	luma
15	38474209	38474369	MACS_peak_6718	866.35	160	0	1	0	luma
15	40217222	40217551	MACS_peak_6736	544.83	329	1	1	0	luma
15	40320990	40321264	MACS_peak_6738	458.32	274	1	0	0	luma
15	40891841	40892187	MACS_peak_6739	656.34	346	1	0	0	luma
15	41051124	41051256	MACS_peak_6741	1090.31	132	0	1	0	luma
15	41383869	41384121	MACS_peak_6742	164.73	252	1	0	0	luma
15	42177061	42177283	MACS_peak_6747	433.36	222	0	1	0	luma
15	42557248	42557468	MACS_peak_6748	482.68	220	0	1	0	luma
15	43163499	43163783	MACS_peak_6750	398.72	284	0	1	1	luma
15	43177131	43177434	MACS_peak_6751	68.59	303	0	1	1	luma
15	43367856	43368080	MACS_peak_6754	378.09	224	1	1	0	luma
15	43652875	43653189	MACS_peak_6755	89.02	314	0	1	0	luma
15	43689971	43690242	MACS_peak_6756	460.22	271	1	0	0	luma
15	44288350	44288580	MACS_peak_6760	675.15	230	1	0	0	luma
15	44360164	44360483	MACS_peak_6761	86.85	319	0	1	0	luma
15	44363056	44363504	MACS_peak_6762	76.89	448	0	1	0	luma
15	45419896	45420039	MACS_peak_6770	1549.78	143	0	1	0	luma
15	49277047	49277410	MACS_peak_6789	69	363	0	1	0	luma
15	49322956	49323226	MACS_peak_6790	585.73	270	1	1	0	luma
15	49471341	49471737	MACS_peak_6792	1192.27	396	0	2	0	luma
15	49494058	49494290	MACS_peak_6793	571.87	232	0	1	0	luma
15	49638688	49638989	MACS_peak_6794	608.28	301	0	1	0	luma
15	50459886	50460022	MACS_peak_6805	753.52	136	0	1	0	luma
15	50505232	50505458	MACS_peak_6806	700.54	226	1	1	0	luma
15	50598970	50599232	MACS_peak_6807	950.42	262	0	1	0	luma
15	50622245	50622673	MACS_peak_6808	406.81	428	0	1	0	luma
15	50733422	50733716	MACS_peak_6810	815.26	294	0	1	0	luma
15	50908550	50908765	MACS_peak_6814	647.94	215	1	0	0	luma
15	50962707	50962982	MACS_peak_6815	406.81	275	0	1	0	luma
15	50986004	50986366	MACS_peak_6816	85.57	362	0	1	0	luma
15	51777104	51777389	MACS_peak_6838	611.86	285	0	1	0	luma
15	51785413	51785584	MACS_peak_6839	598.96	171	0	1	0	luma
15	51851884	51852099	MACS_peak_6840	644.42	215	0	1	0	luma
15	51888624	51889040	MACS_peak_6841	1065.38	416	0	1	1	luma
15	51897370	51897594	MACS_peak_6842	230.25	224	0	1	1	luma
15	51905946	51906139	MACS_peak_6843	997.5	193	0	1	0	luma
15	51982281	51982540	MACS_peak_6844	663.58	259	0	1	0	luma
15	55433816	55434078	MACS_peak_6872	859.93	262	0	1	1	luma
15	57146442	57146678	MACS_peak_6885	502.51	236	0	1	0	luma
15	57779282	57779551	MACS_peak_6886	406.81	269	0	1	0	luma
15	60444114	60444427	MACS_peak_6896	555.13	313	0	1	0	luma
15	63547772	63548008	MACS_peak_6908	793.98	236	0	1	1	luma
15	64209818	64210066	MACS_peak_6916	613.04	248	0	2	0	luma
15	64364689	64365049	MACS_peak_6917	158.81	360	1	1	0	luma
15	64395985	64396298	MACS_peak_6918	600.44	313	0	1	0	luma
15	64402007	64402271	MACS_peak_6919	540.16	264	0	1	0	luma
15	64681513	64681737	MACS_peak_6920	564.54	224	0	1	0	luma
15	65271083	65271279	MACS_peak_6922	662.31	196	0	1	0	luma
15	65638685	65638878	MACS_peak_6925	1043.77	193	0	1	0	luma
15	65859481	65859616	MACS_peak_6926	1358.26	135	0	1	0	luma
15	65885691	65885947	MACS_peak_6927	722.05	256	0	1	0	luma
15	66449967	66450259	MACS_peak_6929	99.97	292	0	1	0	luma
15	66451843	66452134	MACS_peak_6930	218.29	291	0	1	0	luma
15	66497774	66498032	MACS_peak_6931	727.26	258	1	0	0	luma
15	67433638	67433805	MACS_peak_6933	814.37	167	0	1	1	luma
15	67449234	67449536	MACS_peak_6934	123.52	302	0	1	1	luma
15	67456935	67457363	MACS_peak_6935	431.4	428	0	1	1	luma
15	68154954	68155274	MACS_peak_6936	550.56	320	0	1	0	luma
15	68161375	68161509	MACS_peak_6937	1377.21	134	0	1	0	luma
15	68829083	68829352	MACS_peak_6946	461.5	269	0	1	0	luma
15	69059207	69059587	MACS_peak_6947	402.16	380	0	1	0	luma
15	70984334	70984571	MACS_peak_6955	189.9	237	0	1	0	luma
15	70986490	70986831	MACS_peak_6956	55.24	341	0	1	0	luma
15	70988472	70988759	MACS_peak_6957	66.55	287	0	1	0	luma
15	70990017	70990272	MACS_peak_6958	169.18	255	0	1	0	luma
15	71011586	71011834	MACS_peak_6959	1140.18	248	0	1	0	luma
15	72473641	72473847	MACS_peak_6974	629.38	206	1	0	1	luma
15	72498859	72499077	MACS_peak_6975	442.94	218	0	1	0	luma
15	74631871	74632262	MACS_peak_6998	626.96	391	1	1	0	luma
15	74635251	74635516	MACS_peak_6999	1141.07	265	1	1	0	luma
15	74901647	74901880	MACS_peak_7004	831.63	233	1	1	0	luma
15	74925682	74926049	MACS_peak_7005	296.48	367	0	1	0	luma
15	75084439	75084883	MACS_peak_7007	87.04	444	0	1	0	luma
15	75410866	75411296	MACS_peak_7013	437.12	430	0	1	0	luma
15	75481987	75482359	MACS_peak_7014	103.45	372	0	1	0	luma
15	78432696	78432960	MACS_peak_7036	451.4	264	1	0	0	luma
15	78860176	78860540	MACS_peak_7040	374.08	364	0	1	0	luma
15	82139830	82140120	MACS_peak_7070	698.94	290	0	1	0	luma
15	88455044	88455301	MACS_peak_7129	1006.59	257	2	0	0	luma
15	90362076	90362320	MACS_peak_7152	469.89	244	0	1	0	luma
15	90990038	90990469	MACS_peak_7158	349.84	431	0	2	0	luma
15	99213296	99213589	MACS_peak_7233	490.12	293	0	1	0	luma
15	99273023	99273219	MACS_peak_7234	1226.97	196	0	1	0	luma
15	99286415	99286693	MACS_peak_7235	970.76	278	0	1	0	luma
15	100572473	100572674	MACS_peak_7244	651.96	201	0	1	0	luma
15	100627832	100628126	MACS_peak_7245	446.16	294	0	1	0	luma
15	101269891	101270171	MACS_peak_7253	562.2	280	1	0	0	luma
15	101629591	101629856	MACS_peak_7256	60.31	265	0	1	0	luma
15	101639194	101639503	MACS_peak_7257	488.85	309	0	1	0	luma
15	101641210	101641496	MACS_peak_7258	973.26	286	0	1	0	luma
16	52608	52894	MACS_peak_7275	265.34	286	1	1	0	luma
16	612094	612563	MACS_peak_7277	398.43	469	0	1	0	luma
16	612712	613081	MACS_peak_7278	236.35	369	0	1	0	luma
16	1236490	1236893	MACS_peak_7280	741.16	403	1	0	0	luma
16	2907226	2907557	MACS_peak_7292	527.67	331	1	0	0	luma
16	4330373	4330637	MACS_peak_7301	1142.38	264	1	1	0	luma
16	4823623	4823761	MACS_peak_7302	1043.77	138	0	1	0	luma
16	5084841	5085073	MACS_peak_7303	532.66	232	1	1	0	luma
16	5092403	5092593	MACS_peak_7304	677.53	190	0	1	0	luma
16	8905261	8905549	MACS_peak_7323	449.72	288	0	1	0	luma
16	14249570	14249808	MACS_peak_7361	468.75	238	0	1	0	luma
16	14833424	14833793	MACS_peak_7363	434.03	369	1	0	0	luma
16	14873094	14873452	MACS_peak_7364	399.16	358	0	1	0	luma
16	14941357	14941700	MACS_peak_7366	119.24	343	0	1	0	luma
16	18415826	18416216	MACS_peak_7391	1993.08	390	1	0	0	luma
16	18522720	18523078	MACS_peak_7392	368.21	358	0	1	0	luma
16	19179931	19180270	MACS_peak_7399	421.69	339	0	1	0	luma
16	19794216	19794486	MACS_peak_7406	716.24	270	0	1	0	luma
16	21640768	21640985	MACS_peak_7419	580.62	217	1	1	0	luma
16	22318789	22319026	MACS_peak_7430	814.37	237	0	1	0	luma
16	23182403	23182754	MACS_peak_7439	415.73	351	1	0	1	luma
16	23278941	23279105	MACS_peak_7441	810.9	164	1	0	0	luma
16	23296982	23297114	MACS_peak_7442	972.31	132	0	1	0	luma
16	23431600	23431834	MACS_peak_7443	342.45	234	0	1	0	luma
16	23434465	23434714	MACS_peak_7444	471.88	249	0	1	0	luma
16	23435430	23435769	MACS_peak_7445	661.26	339	0	1	0	luma
16	24645717	24645973	MACS_peak_7450	596.79	256	0	1	0	luma
16	24664393	24664689	MACS_peak_7451	445	296	0	1	1	luma
16	24689918	24690137	MACS_peak_7452	446.78	219	0	1	0	luma
16	24800757	24801004	MACS_peak_7453	485.56	247	0	1	0	luma
16	24961411	24961615	MACS_peak_7456	268.92	204	0	1	0	luma
16	27605586	27605908	MACS_peak_7467	936.39	322	0	1	0	luma
16	27642660	27642800	MACS_peak_7468	1301.7	140	0	1	0	luma
16	27690667	27690945	MACS_peak_7469	442.5	278	0	1	1	luma
16	28160189	28160371	MACS_peak_7471	687.62	182	0	1	0	luma
16	29815579	29815774	MACS_peak_7497	604.07	195	5	0	1	luma
16	29881615	29881956	MACS_peak_7499	201.59	341	0	1	0	luma
16	30430171	30430434	MACS_peak_7503	412.35	263	0	1	0	luma
16	30694067	30694249	MACS_peak_7507	1785.17	182	1	0	0	luma
16	31105630	31105914	MACS_peak_7510	596.03	284	1	0	0	luma
16	31465280	31465481	MACS_peak_7515	793.98	201	0	1	0	luma
16	31764671	31764997	MACS_peak_7518	114.74	326	0	1	0	luma
16	31775516	31775745	MACS_peak_7519	541.5	229	0	1	0	luma
16	46589971	46590320	MACS_peak_7641	149.86	349	0	1	0	luma
16	46810905	46811150	MACS_peak_7645	507.55	245	0	1	0	luma
16	46889114	46889271	MACS_peak_7646	1377.21	157	1	0	0	luma
16	47187772	47188161	MACS_peak_7648	139.91	389	0	1	0	luma
16	47222731	47223070	MACS_peak_7649	85.26	339	0	1	0	luma
16	47325480	47325857	MACS_peak_7650	126.19	377	0	1	0	luma
16	48400522	48400878	MACS_peak_7654	178.37	356	0	1	0	luma
16	53054868	53055209	MACS_peak_7665	641.27	341	1	0	0	luma
16	53278605	53278891	MACS_peak_7666	139.71	286	0	1	0	luma
16	56513957	56514137	MACS_peak_7681	746.04	180	0	1	0	luma
16	56808542	56808895	MACS_peak_7684	414.75	353	0	1	0	luma
16	56826953	56827174	MACS_peak_7685	354.64	221	0	1	0	luma
16	58005416	58005818	MACS_peak_7689	662.91	402	0	1	0	luma
16	66867943	66868124	MACS_peak_7741	746.04	181	0	1	0	luma
16	67942060	67942340	MACS_peak_7747	454.58	280	2	0	0	luma
16	68000973	68001245	MACS_peak_7748	459.58	272	0	1	0	luma
16	68855906	68856105	MACS_peak_7753	831.63	199	0	1	0	luma
16	68902417	68902754	MACS_peak_7754	790.35	337	0	1	0	luma
16	69122433	69122581	MACS_peak_7755	1012.48	148	1	0	0	luma
16	69309964	69310203	MACS_peak_7758	1022.22	239	1	1	0	luma
16	69428217	69428500	MACS_peak_7759	490.8	283	1	0	0	luma
16	69912907	69913047	MACS_peak_7761	352.36	140	0	1	0	luma
16	70331606	70331826	MACS_peak_7763	1061.85	220	0	2	1	luma
16	70370140	70370312	MACS_peak_7764	1686.4	172	0	2	1	luma
16	71736265	71736622	MACS_peak_7775	268.31	357	0	1	0	luma
16	71746417	71746774	MACS_peak_7776	481.76	357	0	1	0	luma
16	71882476	71882869	MACS_peak_7777	611.86	393	0	3	0	luma
16	74650985	74651228	MACS_peak_7803	1396.21	243	0	1	0	luma
16	75233719	75234143	MACS_peak_7806	492.72	424	0	1	0	luma
16	75385640	75385962	MACS_peak_7807	513.75	322	0	1	0	luma
16	75394649	75394789	MACS_peak_7808	960	140	0	1	0	luma
16	75402921	75403209	MACS_peak_7809	447.07	288	0	1	0	luma
16	75655202	75655484	MACS_peak_7812	464.3	282	0	1	0	luma
16	75723631	75723863	MACS_peak_7813	124.31	232	0	2	0	luma
16	75737614	75738023	MACS_peak_7814	71.7	409	0	1	0	luma
16	80974665	80974837	MACS_peak_7861	983.72	172	0	1	0	luma
16	81035585	81035860	MACS_peak_7862	711.8	275	1	1	0	luma
16	81086060	81086312	MACS_peak_7863	369.08	252	1	2	0	luma
16	84726071	84726315	MACS_peak_7905	596.07	244	0	1	0	luma
16	84738513	84738992	MACS_peak_7906	422.76	479	0	1	0	luma
16	84746858	84747117	MACS_peak_7907	1448.62	259	0	1	0	luma
16	84754456	84754655	MACS_peak_7908	645.81	199	0	1	0	luma
16	85253254	85253552	MACS_peak_7910	565.28	298	0	1	0	luma
16	85275725	85276047	MACS_peak_7911	549.27	322	0	1	0	luma
16	85409308	85409671	MACS_peak_7912	339.96	363	0	1	0	luma
16	85420776	85421084	MACS_peak_7913	815.17	308	0	1	0	luma
16	85610566	85610909	MACS_peak_7914	658.44	343	0	1	0	luma
16	85901922	85902055	MACS_peak_7917	1291.76	133	1	0	0	luma
16	86563655	86564107	MACS_peak_7926	1352.74	452	1	0	0	luma
16	87394543	87394845	MACS_peak_7933	562.53	302	0	1	0	luma
16	87420686	87420941	MACS_peak_7934	470.06	255	0	1	0	luma
16	89333858	89334184	MACS_peak_7952	312.33	326	0	1	0	luma
16	89557414	89557754	MACS_peak_7953	421.18	340	1	1	0	luma
16	89641318	89641544	MACS_peak_7955	548.55	226	1	0	0	luma
16	90019514	90019817	MACS_peak_7960	561.84	303	1	1	0	luma
17	412285	412579	MACS_peak_7972	446.16	294	1	0	1	luma
17	592343	592651	MACS_peak_7974	77.98	308	0	1	0	luma
17	599398	599752	MACS_peak_7975	84.4	354	0	1	0	luma
17	636867	637262	MACS_peak_7976	57.86	395	0	1	0	luma
17	649094	649550	MACS_peak_7977	590.18	456	0	1	0	luma
17	700580	700885	MACS_peak_7978	439.84	305	0	1	0	luma
17	1354960	1355274	MACS_peak_7983	710.55	314	0	1	0	luma
17	1365475	1365721	MACS_peak_7984	763.02	246	0	1	0	luma
17	1720840	1721061	MACS_peak_7985	729.14	221	1	0	0	luma
17	3647880	3648089	MACS_peak_7993	780.06	209	0	1	0	luma
17	3788623	3788858	MACS_peak_7994	213.21	235	0	1	0	luma
17	4304533	4304821	MACS_peak_7995	890.5	288	0	1	0	luma
17	4889092	4889312	MACS_peak_7999	394.77	220	0	1	0	luma
17	5439114	5439467	MACS_peak_8000	1179.44	353	1	1	0	luma
17	7913000	7913231	MACS_peak_8014	1491.86	231	1	0	0	luma
17	8138641	8138815	MACS_peak_8017	780.06	174	1	0	0	luma
17	8157352	8157727	MACS_peak_8018	404.42	375	1	1	0	luma
17	9554890	9555065	MACS_peak_8025	1760.85	175	0	1	1	luma
17	9559581	9559819	MACS_peak_8026	375.48	238	0	1	0	luma
17	10683906	10684162	MACS_peak_8036	470.06	256	0	1	0	luma
17	12103033	12103222	MACS_peak_8044	883.81	189	0	1	0	luma
17	14203493	14203676	MACS_peak_8056	729.14	183	0	1	0	luma
17	15248193	15248485	MACS_peak_8059	447.34	292	0	1	0	luma
17	15502893	15503114	MACS_peak_8061	729.14	221	1	2	0	luma
17	18094013	18094276	MACS_peak_8074	722.6	263	0	1	0	luma
17	19766509	19766796	MACS_peak_8089	450.32	287	1	0	0	luma
17	21020233	21020435	MACS_peak_8100	2606.56	202	0	1	0	luma
17	21129112	21129459	MACS_peak_8103	404.48	347	0	1	0	luma
17	28548200	28548401	MACS_peak_8138	645.81	201	1	1	0	luma
17	28719542	28719929	MACS_peak_8139	511.42	387	2	0	0	luma
17	28726876	28727098	MACS_peak_8140	564.54	222	2	0	0	luma
17	28750117	28750341	MACS_peak_8141	564.54	224	0	1	0	luma
17	28903062	28903351	MACS_peak_8142	449.12	289	1	0	0	luma
17	28916395	28916679	MACS_peak_8143	442.3	284	0	1	0	luma
17	29252195	29252630	MACS_peak_8146	601.44	435	1	1	0	luma
17	29274779	29275007	MACS_peak_8147	848.95	228	0	1	0	luma
17	31949569	31949783	MACS_peak_8153	1007.79	214	0	1	0	luma
17	39271012	39271270	MACS_peak_8184	458.45	258	0	1	0	luma
17	39485058	39485430	MACS_peak_8185	614.03	372	0	1	0	luma
17	41801659	41801867	MACS_peak_8199	1108.27	208	1	0	0	luma
17	41985418	41985550	MACS_peak_8200	1116.4	132	0	1	0	luma
17	42144922	42145150	MACS_peak_8201	519.64	228	0	2	0	luma
17	43222929	43223267	MACS_peak_8206	522.76	338	0	1	0	luma
17	43483568	43483891	MACS_peak_8209	488.85	323	1	0	0	luma
17	43576719	43576944	MACS_peak_8210	548.55	225	0	2	0	luma
17	46286708	46287045	MACS_peak_8222	359.79	337	0	1	0	luma
17	46641935	46642167	MACS_peak_8223	532.66	232	0	1	0	luma
17	46642378	46642591	MACS_peak_8224	596.79	213	0	1	0	luma
17	47946919	47947190	MACS_peak_8238	1102.85	271	0	1	2	luma
17	48074322	48074646	MACS_peak_8243	399.92	324	1	0	0	luma
17	48080300	48080516	MACS_peak_8244	683.05	216	0	1	0	luma
17	48097639	48097838	MACS_peak_8245	624.41	199	0	1	0	luma
17	48131351	48131560	MACS_peak_8246	876.89	209	1	0	0	luma
17	48153712	48154064	MACS_peak_8247	2153.35	352	0	1	0	luma
17	48259750	48260086	MACS_peak_8248	764.45	336	0	1	0	luma
17	48262904	48263369	MACS_peak_8249	1489.77	465	0	1	0	luma
17	48307873	48308194	MACS_peak_8250	611.86	321	0	1	1	luma
17	48351908	48352205	MACS_peak_8251	380.3	297	0	1	0	luma
17	48374668	48374962	MACS_peak_8252	446.16	294	0	1	0	luma
17	48585393	48585666	MACS_peak_8255	458.95	273	0	1	1	luma
17	48593822	48594303	MACS_peak_8256	577.46	481	2	1	1	luma
17	48940060	48940206	MACS_peak_8265	387.38	146	0	1	0	luma
17	49290783	49291083	MACS_peak_8271	1175.7	300	1	0	0	luma
17	49315432	49315840	MACS_peak_8272	643.45	408	0	1	0	luma
17	49407907	49408348	MACS_peak_8274	1095.16	441	1	0	1	luma
17	49708311	49708693	MACS_peak_8280	1149.5	382	1	1	0	luma
17	50079717	50079925	MACS_peak_8283	594.99	208	0	1	0	luma
17	50085977	50086359	MACS_peak_8284	547.82	382	0	1	0	luma
17	50139965	50140204	MACS_peak_8285	797.18	239	0	1	1	luma
17	50198298	50198692	MACS_peak_8286	1137.79	394	0	1	0	luma
17	50200448	50200776	MACS_peak_8287	427.34	328	0	1	0	luma
17	50482490	50482891	MACS_peak_8289	522.55	401	1	0	0	luma
17	51056849	51057070	MACS_peak_8294	767.82	221	0	1	1	luma
17	51113674	51114037	MACS_peak_8295	389.8	363	0	1	0	luma
17	51153234	51153546	MACS_peak_8296	486.01	312	2	0	0	luma
17	54993158	54993341	MACS_peak_8337	597.36	183	0	1	0	luma
17	55023815	55023957	MACS_peak_8338	2062.26	142	0	1	0	luma
17	55034239	55034495	MACS_peak_8339	576.65	256	0	1	0	luma
17	55053922	55054184	MACS_peak_8340	397.45	262	0	1	0	luma
17	55094167	55094372	MACS_peak_8341	573.39	205	0	1	0	luma
17	57833331	57833645	MACS_peak_8386	1600.31	314	1	0	1	luma
17	57857949	57858213	MACS_peak_8387	1408.55	264	1	0	0	luma
17	57875445	57875793	MACS_peak_8388	380.3	348	0	1	0	luma
17	57892404	57892777	MACS_peak_8389	572.27	373	0	1	0	luma
17	57938951	57939291	MACS_peak_8390	348.12	340	0	1	0	luma
17	58351155	58351387	MACS_peak_8398	504.09	232	1	2	1	luma
17	58562383	58562667	MACS_peak_8402	360.32	284	0	1	0	luma
17	58587669	58587974	MACS_peak_8404	2291.8	305	0	1	0	luma
17	58591291	58591753	MACS_peak_8405	727.52	462	0	1	0	luma
17	58629101	58629484	MACS_peak_8406	350.24	383	0	1	0	luma
17	58631591	58631924	MACS_peak_8407	217.28	333	0	1	0	luma
17	58659011	58659378	MACS_peak_8408	272.61	367	1	1	0	luma
17	58667866	58668024	MACS_peak_8409	664.76	158	0	2	0	luma
17	58995399	58995626	MACS_peak_8423	629.32	227	0	1	0	luma
17	59003404	59003742	MACS_peak_8424	396.63	338	0	1	0	luma
17	59003919	59004210	MACS_peak_8425	222.55	291	0	1	0	luma
17	59038715	59038900	MACS_peak_8427	308.59	185	0	1	0	luma
17	59061423	59061791	MACS_peak_8429	158.24	368	0	1	0	luma
17	59072966	59073262	MACS_peak_8430	162.76	296	0	1	0	luma
17	59076069	59076303	MACS_peak_8431	290.02	234	0	1	0	luma
17	59087603	59087840	MACS_peak_8433	186.7	237	0	1	0	luma
17	59091361	59091804	MACS_peak_8434	356.5	443	0	1	0	luma
17	59097268	59097568	MACS_peak_8435	86.12	300	0	1	0	luma
17	59101020	59101152	MACS_peak_8436	511.39	132	0	1	0	luma
17	59569937	59570343	MACS_peak_8446	832.63	406	1	0	0	luma
17	59574260	59574682	MACS_peak_8447	87.91	422	0	1	0	luma
17	59592253	59592552	MACS_peak_8448	147.3	299	0	1	0	luma
17	59855498	59855874	MACS_peak_8461	114.09	376	1	0	0	luma
17	59857379	59857611	MACS_peak_8462	170.22	232	1	0	0	luma
17	59874709	59875089	MACS_peak_8465	166.6	380	0	1	0	luma
17	59909145	59909299	MACS_peak_8466	508.47	154	0	1	0	luma
17	59918663	59918851	MACS_peak_8468	634.81	188	0	1	0	luma
17	59929362	59929710	MACS_peak_8469	120.35	348	0	1	0	luma
17	59938059	59938495	MACS_peak_8470	100.62	436	1	1	0	luma
17	59941205	59941430	MACS_peak_8471	309.39	225	1	1	0	luma
17	60059593	60059953	MACS_peak_8478	137.66	360	0	1	0	luma
17	60068608	60069062	MACS_peak_8479	181.44	454	0	1	0	luma
17	60174633	60175035	MACS_peak_8485	1578.28	402	1	0	0	luma
17	60188293	60188651	MACS_peak_8486	117.9	358	0	1	0	luma
17	60216260	60216640	MACS_peak_8487	74.78	380	0	1	0	luma
17	60229432	60229780	MACS_peak_8488	690.03	348	0	1	0	luma
17	60230183	60230567	MACS_peak_8489	146.15	384	0	1	0	luma
17	60242299	60242506	MACS_peak_8491	211.96	207	0	1	0	luma
17	60254691	60255065	MACS_peak_8493	206.31	374	0	1	0	luma
17	60256426	60256803	MACS_peak_8494	106.43	377	0	1	0	luma
17	60256897	60257131	MACS_peak_8495	174.8	234	0	1	1	luma
17	60281903	60282350	MACS_peak_8496	125.63	447	0	1	0	luma
17	60283139	60283505	MACS_peak_8497	103.45	366	0	1	0	luma
17	60283863	60284101	MACS_peak_8498	415.7	238	0	1	0	luma
17	60284921	60285262	MACS_peak_8499	93.4	341	0	1	0	luma
17	60288113	60288341	MACS_peak_8500	451.74	228	0	1	0	luma
17	60319219	60319553	MACS_peak_8502	84.4	334	0	1	0	luma
17	60329677	60330057	MACS_peak_8503	343.7	380	0	1	0	luma
17	60346663	60347143	MACS_peak_8504	329.83	480	0	1	0	luma
17	60358846	60359214	MACS_peak_8505	181.4	368	0	1	0	luma
17	60362801	60363036	MACS_peak_8506	167.64	235	0	1	0	luma
17	60373331	60373464	MACS_peak_8507	625.5	133	0	1	0	luma
17	60392222	60392545	MACS_peak_8508	221.26	323	1	1	0	luma
17	60420082	60420422	MACS_peak_8509	171.96	340	0	2	0	luma
17	60421294	60421596	MACS_peak_8510	186.16	302	0	2	0	luma
17	60447739	60447871	MACS_peak_8513	517.86	132	1	0	0	luma
17	60462946	60463283	MACS_peak_8514	126.47	337	0	1	0	luma
17	60463322	60463628	MACS_peak_8515	195.04	306	0	1	0	luma
17	60517657	60518050	MACS_peak_8516	137.55	393	0	1	0	luma
17	60519664	60519932	MACS_peak_8517	651.39	268	0	1	0	luma
17	60610205	60610461	MACS_peak_8524	151	256	0	1	0	luma
17	60638695	60639174	MACS_peak_8525	3100	479	0	1	0	luma
17	60640026	60640283	MACS_peak_8526	198.02	257	0	1	0	luma
17	60641806	60642219	MACS_peak_8528	960.88	413	0	1	0	luma
17	60647378	60647592	MACS_peak_8529	176.28	214	0	1	0	luma
17	60656576	60656789	MACS_peak_8530	185.02	213	0	1	0	luma
17	60656910	60657305	MACS_peak_8531	480.11	395	0	1	0	luma
17	60660222	60660591	MACS_peak_8532	112.17	369	0	1	0	luma
17	61676846	61677289	MACS_peak_8642	64.68	443	1	0	0	luma
17	61678138	61678510	MACS_peak_8643	92.17	372	1	0	0	luma
17	61680291	61680610	MACS_peak_8644	93.82	319	1	0	0	luma
17	61687279	61687725	MACS_peak_8645	371.68	446	0	1	0	luma
17	61688394	61688754	MACS_peak_8646	58.9	360	0	1	0	luma
17	61697223	61697702	MACS_peak_8648	66.39	479	0	1	0	luma
17	61713130	61713524	MACS_peak_8650	133.25	394	0	1	0	luma
17	61714970	61715358	MACS_peak_8651	62.5	388	0	1	0	luma
17	61723088	61723523	MACS_peak_8652	105.42	435	0	1	0	luma
17	61729731	61730135	MACS_peak_8653	417.23	404	0	1	0	luma
17	61730612	61730911	MACS_peak_8654	51.77	299	0	1	0	luma
17	61744118	61744480	MACS_peak_8655	50.92	362	0	1	0	luma
17	61745751	61745975	MACS_peak_8656	290.28	224	0	1	0	luma
17	61748872	61749148	MACS_peak_8657	61.68	276	0	1	0	luma
17	61757174	61757512	MACS_peak_8659	133.59	338	0	1	0	luma
17	61765936	61766296	MACS_peak_8661	54.82	360	0	1	0	luma
17	61768363	61768757	MACS_peak_8662	70.01	394	0	1	0	luma
17	61783074	61783369	MACS_peak_8664	80.61	295	0	1	0	luma
17	61783902	61784235	MACS_peak_8665	72.43	333	0	1	0	luma
17	61803488	61803731	MACS_peak_8667	153.99	243	0	1	0	luma
17	61810772	61811145	MACS_peak_8668	67.08	373	0	1	0	luma
17	61811284	61811605	MACS_peak_8669	54.52	321	0	1	0	luma
17	61813045	61813403	MACS_peak_8670	73.11	358	0	1	0	luma
17	61819330	61819706	MACS_peak_8671	50.79	376	0	1	0	luma
17	61824308	61824760	MACS_peak_8673	62.57	452	0	1	0	luma
17	61825506	61825826	MACS_peak_8674	74.54	320	0	1	0	luma
17	61826334	61826774	MACS_peak_8675	52.06	440	0	1	0	luma
17	61829574	61829949	MACS_peak_8676	60.82	375	0	1	0	luma
17	61837918	61838231	MACS_peak_8678	145.8	313	0	1	0	luma
17	61840595	61840909	MACS_peak_8680	68.03	314	0	1	0	luma
17	61843309	61843668	MACS_peak_8681	55.04	359	0	1	0	luma
17	61847914	61848290	MACS_peak_8682	56.1	376	0	1	0	luma
17	61849703	61850100	MACS_peak_8684	81.33	397	0	1	0	luma
17	61853135	61853420	MACS_peak_8685	67.31	285	0	1	0	luma
17	61863604	61863946	MACS_peak_8686	72.36	342	1	0	0	luma
17	61865299	61865736	MACS_peak_8687	187.59	437	1	0	0	luma
17	61875561	61875809	MACS_peak_8688	97.98	248	0	1	0	luma
17	61878674	61879056	MACS_peak_8689	62.39	382	0	1	0	luma
17	61879394	61879827	MACS_peak_8690	150.9	433	0	1	0	luma
17	61880708	61881009	MACS_peak_8691	83.91	301	0	1	0	luma
17	61891949	61892310	MACS_peak_8692	100.3	361	0	1	0	luma
17	61893087	61893396	MACS_peak_8693	76.3	309	0	1	0	luma
17	61906959	61907094	MACS_peak_8695	753.78	135	0	1	0	luma
17	61908343	61908736	MACS_peak_8696	67.53	393	0	1	0	luma
17	61992198	61992575	MACS_peak_8697	342.79	377	0	1	0	luma
17	62030622	62030866	MACS_peak_8699	491.61	244	0	1	0	luma
17	62421392	62421871	MACS_peak_8708	2036.87	479	1	0	0	luma
17	62421988	62422294	MACS_peak_8709	233.14	306	1	0	0	luma
17	62423683	62423963	MACS_peak_8710	334.08	280	1	0	0	luma
17	62484116	62484332	MACS_peak_8711	1396.66	216	0	1	0	luma
17	62484836	62485248	MACS_peak_8712	2259.35	412	0	1	0	luma
17	62553056	62553446	MACS_peak_8713	1258.57	390	0	1	0	luma
17	62592684	62592969	MACS_peak_8714	398.02	285	0	1	0	luma
17	63688767	63689011	MACS_peak_8738	483.55	244	0	2	0	luma
17	63697911	63698170	MACS_peak_8739	594.37	259	2	1	0	luma
17	63809780	63810025	MACS_peak_8740	986.28	245	0	1	0	luma
17	64473346	64473478	MACS_peak_8761	940.81	132	1	0	0	luma
17	64480337	64480638	MACS_peak_8762	790.81	301	1	0	0	luma
17	64492581	64492799	MACS_peak_8764	666.39	218	0	1	0	luma
17	64507448	64507801	MACS_peak_8765	611.86	353	1	1	0	luma
17	64514415	64514762	MACS_peak_8766	1129.64	347	0	1	0	luma
17	64540658	64540794	MACS_peak_8767	927.9	136	1	1	0	luma
17	65027243	65027599	MACS_peak_8779	1091.17	356	0	1	0	luma
17	67195832	67195974	MACS_peak_8818	921.89	142	0	1	0	luma
17	67200729	67201043	MACS_peak_8819	322.23	314	0	1	0	luma
17	67359898	67360112	MACS_peak_8821	460.03	214	0	1	0	luma
17	67717692	67717989	MACS_peak_8831	626.7	297	1	0	0	luma
17	67825308	67825565	MACS_peak_8834	714.38	257	1	0	0	luma
17	67891813	67892260	MACS_peak_8835	1617	447	0	1	0	luma
17	67942865	67943071	MACS_peak_8836	655.89	206	0	1	0	luma
17	67953862	67954086	MACS_peak_8837	86.67	224	0	1	0	luma
17	67963280	67963650	MACS_peak_8838	911.5	370	0	1	0	luma
17	68263146	68263347	MACS_peak_8845	478.76	201	2	0	0	luma
17	68410865	68411260	MACS_peak_8846	87.49	395	0	1	0	luma
17	68436481	68436685	MACS_peak_8847	617.05	204	0	1	1	luma
17	68972197	68972514	MACS_peak_8860	731.28	317	1	0	1	luma
17	69085062	69085457	MACS_peak_8862	825.48	395	0	1	0	luma
17	69138762	69138984	MACS_peak_8863	103.93	222	0	1	0	luma
17	73310853	73311235	MACS_peak_8909	401.26	382	0	1	0	luma
17	74791471	74791762	MACS_peak_8915	549.74	291	0	1	0	luma
17	75105889	75106114	MACS_peak_8916	529.68	225	1	1	0	luma
17	75201808	75202112	MACS_peak_8917	488.85	304	1	0	0	luma
17	75323091	75323362	MACS_peak_8918	599.17	271	0	1	0	luma
17	75404247	75404629	MACS_peak_8919	1320.51	382	0	1	0	luma
17	75504212	75504542	MACS_peak_8921	928.77	330	1	0	0	luma
17	75515679	75516087	MACS_peak_8922	616.76	408	1	0	0	luma
17	75625906	75626236	MACS_peak_8925	1642.21	330	1	1	0	luma
17	75632955	75633204	MACS_peak_8926	1162.47	249	1	1	0	luma
17	75633794	75634087	MACS_peak_8927	828.97	293	1	1	0	luma
17	75653031	75653250	MACS_peak_8928	528	219	0	1	0	luma
17	75674928	75675209	MACS_peak_8929	460.95	281	0	1	0	luma
17	75778977	75779166	MACS_peak_8932	616.5	189	1	0	0	luma
17	75783440	75783688	MACS_peak_8933	1399.91	248	1	1	0	luma
17	75792110	75792406	MACS_peak_8934	810.4	296	0	1	0	luma
17	76062424	76062732	MACS_peak_8935	1576.26	308	0	1	0	luma
17	76398044	76398364	MACS_peak_8936	550.56	320	0	1	0	luma
17	78422051	78422433	MACS_peak_8948	388.11	382	1	1	0	luma
17	78745455	78745693	MACS_peak_8950	662.31	238	0	1	0	luma
17	79960595	79960814	MACS_peak_8956	901.33	219	0	1	0	luma
17	79991744	79991938	MACS_peak_8957	678.9	194	0	1	0	luma
17	80005783	80006062	MACS_peak_8958	455.19	279	0	1	0	luma
17	80548071	80548414	MACS_peak_8961	419.68	343	1	0	0	luma
17	80575402	80575594	MACS_peak_8962	866.35	192	0	1	0	luma
17	80672259	80672489	MACS_peak_8963	429.38	230	0	1	0	luma
17	80740639	80740937	MACS_peak_8964	960.47	298	0	1	0	luma
17	81200911	81201149	MACS_peak_8966	516.86	238	0	1	0	luma
17	82021198	82021436	MACS_peak_8970	662.31	238	2	0	0	luma
17	82424497	82424939	MACS_peak_8971	964.62	442	0	1	0	luma
17	82551819	82552087	MACS_peak_8972	442.05	268	0	1	0	luma
17	82777869	82778128	MACS_peak_8973	953.02	259	0	1	0	luma
17	82781811	82782005	MACS_peak_8974	1434.33	194	0	1	0	luma
18	171006	171251	MACS_peak_8991	629.38	245	0	1	0	luma
18	730101	730397	MACS_peak_8995	438.73	296	0	1	0	luma
18	2541999	2542346	MACS_peak_9009	843.52	347	1	0	0	luma
18	2692486	2692707	MACS_peak_9010	564.54	221	0	1	1	luma
18	3246135	3246338	MACS_peak_9011	814.37	203	1	0	1	luma
18	9549383	9549770	MACS_peak_9036	511.42	387	1	0	0	luma
18	9951360	9951542	MACS_peak_9037	729.14	182	0	1	0	luma
18	12333048	12333422	MACS_peak_9050	518.44	374	1	1	0	luma
18	12827756	12828134	MACS_peak_9052	403.06	378	0	1	0	luma
18	13003452	13003657	MACS_peak_9053	797.18	205	0	1	0	luma
18	13031110	13031266	MACS_peak_9054	840.92	156	0	1	0	luma
18	20958793	20959235	MACS_peak_9077	1094.3	442	0	1	0	luma
18	20972026	20972277	MACS_peak_9078	485.56	251	0	1	0	luma
18	21591605	21591991	MACS_peak_9079	89.02	386	0	1	0	luma
18	21738805	21738957	MACS_peak_9080	446.36	152	0	1	0	luma
18	21805889	21806031	MACS_peak_9081	877.38	142	0	1	0	luma
18	23248503	23248644	MACS_peak_9097	676.31	141	0	2	0	luma
18	23565733	23566021	MACS_peak_9098	681.96	288	0	1	0	luma
18	24176841	24177137	MACS_peak_9099	826.15	296	0	1	0	luma
18	24186905	24187039	MACS_peak_9100	877.68	134	0	1	0	luma
18	24315612	24315863	MACS_peak_9101	746.04	251	0	1	0	luma
18	31506292	31506616	MACS_peak_9143	338.74	324	0	1	0	luma
18	36133793	36133929	MACS_peak_9165	753.52	136	1	0	0	luma
18	36136822	36137145	MACS_peak_9166	845.32	323	0	1	0	luma
18	37027744	37028126	MACS_peak_9172	76.3	382	0	1	0	luma
18	37053873	37054076	MACS_peak_9173	814.37	203	0	1	0	luma
18	37075318	37075727	MACS_peak_9174	69.67	409	0	1	0	luma
18	37076432	37076850	MACS_peak_9175	70.01	418	0	1	0	luma
18	37078545	37078821	MACS_peak_9176	125.63	276	0	1	0	luma
18	37215080	37215356	MACS_peak_9177	107.89	276	0	1	0	luma
18	45910457	45910796	MACS_peak_9218	421.69	339	0	1	0	luma
18	46044462	46044714	MACS_peak_9220	108.7	252	0	1	0	luma
18	46044785	46045195	MACS_peak_9221	85.66	410	0	1	0	luma
18	46081430	46081785	MACS_peak_9222	269.22	355	1	0	0	luma
18	46195469	46195694	MACS_peak_9223	346.64	225	0	1	0	luma
18	49219087	49219423	MACS_peak_9236	57.49	336	0	1	0	luma
18	49292572	49292955	MACS_peak_9238	678.93	383	0	1	0	luma
18	49447902	49448114	MACS_peak_9240	596.79	212	0	1	0	luma
18	50043267	50043674	MACS_peak_9243	584.98	407	0	1	0	luma
18	51173818	51173950	MACS_peak_9245	1116.4	132	1	0	0	luma
18	54728799	54729012	MACS_peak_9259	671.02	213	0	1	0	luma
18	54769673	54769884	MACS_peak_9260	596.79	211	0	1	0	luma
18	56716026	56716162	MACS_peak_9267	1061.85	136	0	1	0	luma
18	56869131	56869444	MACS_peak_9268	435.38	313	0	1	0	luma
18	57721664	57722031	MACS_peak_9271	84.48	367	0	1	1	luma
18	57723292	57723603	MACS_peak_9272	72.19	311	0	1	1	luma
18	58262435	58262651	MACS_peak_9273	746.04	216	0	1	0	luma
18	62052374	62052713	MACS_peak_9290	220.21	339	0	1	0	luma
18	62183627	62183927	MACS_peak_9291	1387.53	300	1	1	0	luma
18	62584353	62584612	MACS_peak_9292	468.05	259	0	1	0	luma
18	62911236	62911681	MACS_peak_9295	87.54	445	0	1	0	luma
18	62911864	62912091	MACS_peak_9296	164.16	227	0	1	0	luma
18	74751826	74752169	MACS_peak_9337	149.97	343	0	1	0	luma
18	79287494	79287786	MACS_peak_9346	62.38	292	0	1	0	luma
18	79287817	79288155	MACS_peak_9347	57.94	338	0	1	0	luma
19	1194579	1194950	MACS_peak_9361	262.11	371	0	1	0	luma
19	1813030	1813193	MACS_peak_9364	848.95	163	1	0	0	luma
19	3021062	3021224	MACS_peak_9367	270.22	162	0	1	0	luma
19	3545169	3545442	MACS_peak_9368	458.95	273	0	1	1	luma
19	4352504	4352913	MACS_peak_9373	616.18	409	0	1	1	luma
19	10000237	10000504	MACS_peak_9393	843.52	267	0	1	0	luma
19	10388884	10389170	MACS_peak_9397	450.92	286	1	0	0	luma
19	10404195	10404569	MACS_peak_9398	404.88	374	0	1	0	luma
19	10413596	10413847	MACS_peak_9399	272.3	251	1	1	0	luma
19	10551698	10551831	MACS_peak_9401	1396.21	133	1	1	0	luma
19	10581053	10581363	MACS_peak_9402	803.33	310	0	1	0	luma
19	11939141	11939451	MACS_peak_9408	102.5	310	0	2	0	luma
19	12394068	12394276	MACS_peak_9410	613.04	208	2	1	0	luma
19	12676353	12676635	MACS_peak_9413	453.35	282	1	1	0	luma
19	12796642	12797039	MACS_peak_9416	871.49	397	1	1	0	luma
19	15264161	15264409	MACS_peak_9432	901.33	248	0	1	0	luma
19	15278366	15278681	MACS_peak_9433	312.33	315	0	1	0	luma
19	15302654	15302801	MACS_peak_9434	1836.32	147	0	1	0	luma
19	18279491	18279773	MACS_peak_9451	705.71	282	1	0	0	luma
19	19342746	19343074	MACS_peak_9455	545.46	328	0	1	0	luma
19	19724567	19724922	MACS_peak_9458	71.69	355	0	1	0	luma
19	19869659	19869792	MACS_peak_9460	877.68	133	1	0	0	luma
19	19919832	19920135	MACS_peak_9461	60.7	303	0	1	0	luma
19	19920989	19921210	MACS_peak_9462	140.69	221	0	1	0	luma
19	19959365	19959586	MACS_peak_9463	492.22	221	0	1	0	luma
19	20628016	20628236	MACS_peak_9465	227.1	220	0	1	1	luma
19	21718560	21718692	MACS_peak_9471	963	132	1	0	0	luma
19	21722547	21722840	MACS_peak_9472	132.1	293	1	0	0	luma
19	22476433	22476775	MACS_peak_9475	380.3	342	0	1	0	luma
19	23362291	23362544	MACS_peak_9479	378.3	253	0	1	0	luma
19	37021808	37021971	MACS_peak_9566	772.28	163	0	1	0	luma
19	37120130	37120571	MACS_peak_9567	129.96	441	0	3	0	luma
19	38930301	38930545	MACS_peak_9578	629.38	244	1	2	0	luma
19	39443973	39444314	MACS_peak_9580	216.22	341	0	1	0	luma
19	39881548	39881855	MACS_peak_9583	685.18	307	0	1	0	luma
19	44095210	44095482	MACS_peak_9616	584.2	272	1	0	0	luma
19	44224816	44225123	MACS_peak_9617	129.01	307	1	1	0	luma
19	44415352	44415722	MACS_peak_9619	383.44	370	1	0	1	luma
19	44667525	44667833	MACS_peak_9621	424.89	308	0	1	1	luma
19	44951585	44951870	MACS_peak_9625	574.52	285	1	0	1	luma
19	46728830	46729085	MACS_peak_9644	470.06	255	0	1	1	luma
19	46840595	46840747	MACS_peak_9646	1965.34	152	1	0	0	luma
19	47367325	47367621	MACS_peak_9653	170.16	296	0	1	0	luma
19	48187390	48187712	MACS_peak_9696	413.88	322	0	2	0	luma
19	48320105	48320319	MACS_peak_9698	596.79	214	1	1	0	luma
19	48993218	48993580	MACS_peak_9702	410.45	362	1	0	0	luma
19	48999729	49000179	MACS_peak_9703	622.87	450	0	1	0	luma
19	49821817	49821949	MACS_peak_9706	771.26	132	1	0	0	luma
19	51016751	51017099	MACS_peak_9745	912.29	348	1	0	0	luma
19	52047721	52047938	MACS_peak_9754	553.1	217	0	1	0	luma
19	53189856	53190159	MACS_peak_9756	1232.34	303	0	1	0	luma
19	54172924	54173286	MACS_peak_9761	410.92	362	1	0	0	luma
19	54580430	54580744	MACS_peak_9763	183.74	314	0	1	0	luma
19	55632401	55632742	MACS_peak_9769	659.85	341	2	0	0	luma
19	56396244	56396572	MACS_peak_9773	429.01	328	1	0	1	luma
19	58513933	58514161	MACS_peak_9778	695.57	228	1	0	0	luma
19	58519003	58519241	MACS_peak_9779	516.86	238	0	1	0	luma
20	2506039	2506401	MACS_peak_11676	72.08	362	0	2	0	luma
20	2910206	2910637	MACS_peak_11678	306.6	431	0	1	0	luma
20	3494337	3494614	MACS_peak_11679	250.69	277	0	1	0	luma
20	3496247	3496668	MACS_peak_11680	108.17	421	0	1	0	luma
20	3513723	3513988	MACS_peak_11681	56.38	265	0	1	0	luma
20	3563662	3563991	MACS_peak_11682	426.82	329	0	1	0	luma
20	3630832	3631057	MACS_peak_11683	442.71	225	0	1	0	luma
20	3753100	3753289	MACS_peak_11684	695.57	189	1	0	0	luma
20	4008258	4008553	MACS_peak_11685	567.38	295	0	1	0	luma
20	6011560	6011709	MACS_peak_11691	843.6	149	0	1	0	luma
20	7980709	7981026	MACS_peak_11699	552.5	317	1	0	0	luma
20	8661893	8662287	MACS_peak_11701	873.84	394	0	1	0	luma
20	8759524	8759906	MACS_peak_11702	603.02	382	0	1	0	luma
20	8790537	8790783	MACS_peak_11703	927.9	246	0	1	0	luma
20	8853889	8854083	MACS_peak_11704	778.31	194	0	1	0	luma
20	13436978	13437388	MACS_peak_11733	60	410	0	1	0	luma
20	13458815	13459186	MACS_peak_11734	763.88	371	0	1	0	luma
20	13483671	13483882	MACS_peak_11735	386.13	211	0	1	0	luma
20	13788273	13788427	MACS_peak_11736	918.92	154	1	0	0	luma
20	18537247	18537546	MACS_peak_11768	265.34	299	0	1	0	luma
20	20054006	20054140	MACS_peak_11786	1666.76	134	1	1	0	luma
20	24552963	24553253	MACS_peak_11823	89.02	290	0	1	0	luma
20	24554914	24555335	MACS_peak_11824	84.14	421	0	1	0	luma
20	25262992	25263438	MACS_peak_11829	86.87	446	0	1	0	luma
20	25332673	25333045	MACS_peak_11830	67.63	372	0	1	0	luma
20	25383850	25384089	MACS_peak_11831	513.53	239	0	1	0	luma
20	31927110	31927312	MACS_peak_11874	705.57	202	0	1	0	luma
20	32790112	32790430	MACS_peak_11880	432.66	318	0	1	0	luma
20	34874145	34874342	MACS_peak_11888	831.63	197	1	0	0	luma
20	35713652	35713789	MACS_peak_11893	1081.35	137	0	1	0	luma
20	35954426	35954782	MACS_peak_11895	413.31	356	2	0	0	luma
20	37368439	37368642	MACS_peak_11900	343.13	203	0	1	0	luma
20	37384743	37384991	MACS_peak_11901	1208.41	248	0	1	0	luma
20	38512188	38512424	MACS_peak_11908	465.7	236	0	1	0	luma
20	38751330	38751685	MACS_peak_11909	529.16	355	1	0	0	luma
20	41411505	41411742	MACS_peak_11929	516.86	237	0	1	0	luma
20	41571134	41571401	MACS_peak_11930	391.8	267	0	1	0	luma
20	41571994	41572307	MACS_peak_11931	429.13	313	0	1	0	luma
20	45373958	45374113	MACS_peak_11973	1134.69	155	1	2	0	luma
20	45422880	45423092	MACS_peak_11974	423.63	212	0	1	0	luma
20	45446030	45446197	MACS_peak_11975	814.37	167	0	1	1	luma
20	45799222	45799466	MACS_peak_11980	409.44	244	0	1	0	luma
20	49065208	49065347	MACS_peak_12071	471.15	139	0	1	0	luma
20	49082684	49083032	MACS_peak_12072	480.06	348	0	1	0	luma
20	49132946	49133243	MACS_peak_12073	565.98	297	0	1	0	luma
20	49858144	49858392	MACS_peak_12080	763.02	248	0	1	0	luma
20	49888465	49888806	MACS_peak_12081	659.85	341	0	1	0	luma
20	49943768	49943908	MACS_peak_12083	1345.15	140	0	1	0	luma
20	50085439	50085720	MACS_peak_12087	925.1	281	2	0	0	luma
20	50929307	50929720	MACS_peak_12126	968.33	413	0	1	0	luma
20	51594946	51595390	MACS_peak_12135	388.99	444	1	0	0	luma
20	51624362	51624600	MACS_peak_12136	415.95	238	0	1	0	luma
20	51700801	51701070	MACS_peak_12137	1091.86	269	0	1	0	luma
20	51704091	51704310	MACS_peak_12138	566.67	219	0	1	0	luma
20	51712505	51712776	MACS_peak_12139	777.55	271	0	1	0	luma
20	52083749	52083958	MACS_peak_12143	525.79	209	0	1	0	luma
20	52150599	52151039	MACS_peak_12144	717.1	440	0	1	0	luma
20	54207693	54207989	MACS_peak_12267	3100	296	1	0	0	luma
20	54214769	54215075	MACS_peak_12269	118.28	306	0	1	0	luma
20	54224193	54224327	MACS_peak_12271	514.05	134	0	1	0	luma
20	56400108	56400336	MACS_peak_12358	465.76	228	0	1	0	luma
20	56505631	56506022	MACS_peak_12359	594.54	391	0	2	0	luma
20	56516133	56516556	MACS_peak_12360	611.86	423	1	2	0	luma
20	57346420	57346691	MACS_peak_12397	1183.08	271	1	0	0	luma
20	58403100	58403341	MACS_peak_12416	208.93	241	0	1	0	luma
20	58447699	58448169	MACS_peak_12417	812.61	470	0	1	0	luma
20	58650547	58650935	MACS_peak_12420	1857.04	388	2	0	0	luma
20	59222426	59222791	MACS_peak_12429	409.04	365	0	1	0	luma
20	59234686	59234941	MACS_peak_12430	506	255	0	1	0	luma
20	61981123	61981285	MACS_peak_12468	1320.51	162	0	1	0	luma
20	62010900	62011120	MACS_peak_12469	564.54	220	0	1	0	luma
20	62136887	62137168	MACS_peak_12470	1192.27	281	1	0	0	luma
20	62156858	62157188	MACS_peak_12471	426.3	330	0	1	0	luma
20	62260264	62260643	MACS_peak_12472	402.61	379	0	1	0	luma
20	62270687	62271076	MACS_peak_12473	202.06	389	0	1	0	luma
20	62302632	62302849	MACS_peak_12474	580.62	217	1	0	0	luma
20	62791573	62791805	MACS_peak_12476	1824.95	232	1	0	0	luma
20	62808319	62808561	MACS_peak_12477	645.81	242	1	0	0	luma
20	62900203	62900525	MACS_peak_12479	802.9	322	0	1	0	luma
20	62900776	62901115	MACS_peak_12480	421.69	339	0	1	0	luma
20	62907439	62907645	MACS_peak_12481	629.38	206	0	1	0	luma
20	63614270	63614524	MACS_peak_12489	629.32	254	0	1	0	luma
20	63706798	63707167	MACS_peak_12490	640.87	369	2	1	0	luma
20	63909644	63909936	MACS_peak_12491	634.74	292	0	1	0	luma
21	25591074	25591210	MACS_peak_12657	1061.85	136	0	1	0	luma
21	31683944	31684175	MACS_peak_12690	532.66	231	0	1	0	luma
21	32601128	32601313	MACS_peak_12692	1348.66	185	0	2	0	luma
21	32653360	32653582	MACS_peak_12693	712.32	222	0	1	0	luma
21	33605689	33606087	MACS_peak_12697	381.26	398	0	2	0	luma
21	33701990	33702233	MACS_peak_12698	333.51	243	0	2	0	luma
21	36388368	36388596	MACS_peak_12715	675.78	228	1	0	0	luma
21	39244769	39244955	MACS_peak_12732	421.25	186	0	1	0	luma
21	39248547	39248784	MACS_peak_12733	511.17	237	0	1	0	luma
21	43789245	43789578	MACS_peak_12765	793.64	333	1	0	0	luma
21	43907014	43907157	MACS_peak_12767	2712.67	143	0	1	0	luma
21	43975580	43975856	MACS_peak_12768	845.51	276	0	1	0	luma
21	44793259	44793626	MACS_peak_12772	394.93	367	0	1	0	luma
21	44800180	44800438	MACS_peak_12773	468.72	258	0	1	0	luma
21	45270236	45270473	MACS_peak_12777	498.83	237	0	1	0	luma
21	46147417	46147762	MACS_peak_12784	1329.55	345	0	1	0	luma
21	46285548	46285894	MACS_peak_12785	325.68	346	1	1	0	luma
22	18076134	18076328	MACS_peak_12819	678.9	194	1	0	0	luma
22	19037038	19037233	MACS_peak_12836	662.31	195	1	0	0	luma
22	19947829	19948061	MACS_peak_12837	514.21	232	0	1	0	luma
22	20317648	20317932	MACS_peak_12839	575.25	284	1	0	0	luma
22	20460511	20460655	MACS_peak_12849	2638.81	144	0	1	0	luma
22	20496427	20496694	MACS_peak_12850	462.79	267	1	0	0	luma
22	20564217	20564577	MACS_peak_12851	488.85	360	0	1	0	luma
22	20741940	20742253	MACS_peak_12852	638.96	313	0	1	0	luma
22	20813763	20814081	MACS_peak_12853	432.66	318	0	1	0	luma
22	21773330	21773602	MACS_peak_12861	265.34	272	0	1	0	luma
22	23178489	23178702	MACS_peak_12877	1453.47	213	1	0	0	luma
22	24064427	24064842	MACS_peak_12883	115.17	415	0	1	0	luma
22	25129652	25129882	MACS_peak_12894	517.97	230	0	1	0	luma
22	27880875	27881118	MACS_peak_12898	501.16	243	0	1	0	luma
22	29406094	29406250	MACS_peak_12912	1506.46	156	0	1	1	luma
22	31345834	31346054	MACS_peak_12918	564.54	220	0	1	0	luma
22	31687710	31688041	MACS_peak_12919	127.5	331	0	1	0	luma
22	39514453	39514733	MACS_peak_12945	454.58	280	0	1	0	luma
22	39529271	39529452	MACS_peak_12946	936.57	181	1	0	0	luma
22	40372014	40372313	MACS_peak_12949	429.01	299	1	2	0	luma
22	40487702	40487986	MACS_peak_12950	452.13	284	0	1	0	luma
22	41125015	41125297	MACS_peak_12951	229.83	282	0	1	0	luma
22	42253851	42254109	MACS_peak_12952	380.3	258	0	1	0	luma
22	49874273	49874416	MACS_peak_12961	983.72	143	0	1	0	luma
22	50273284	50273554	MACS_peak_12962	476.21	270	1	0	0	luma
22	50276153	50276497	MACS_peak_12963	535.64	344	1	0	0	luma
22	25057278	25057471	MACS_peak_22007	678.9	193	0	1	1	luma
X	7132480	7132779	MACS_peak_22030	443.26	299	0	1	0	luma
X	9791900	9792225	MACS_peak_22041	1104.73	325	0	1	0	luma
X	9875077	9875236	MACS_peak_22042	485.23	159	0	1	0	luma
X	14016832	14017083	MACS_peak_22064	356.87	251	0	1	0	luma
X	16953446	16953660	MACS_peak_22081	1453.47	214	0	1	0	luma
X	56871608	56871983	MACS_peak_22256	79.24	375	0	1	0	luma
X	56879687	56880068	MACS_peak_22257	56.38	381	0	1	0	luma
X	65528815	65529016	MACS_peak_22328	645.81	201	0	1	0	luma
X	70365418	70365750	MACS_peak_22366	79.37	332	0	1	0	luma
X	71516533	71516858	MACS_peak_22375	405.72	325	0	1	0	luma
X	72271163	72271398	MACS_peak_22382	502.51	235	0	2	0	luma
X	77739953	77740185	MACS_peak_22413	941.25	232	0	1	0	luma
X	81147884	81148140	MACS_peak_22435	127.5	256	0	1	0	luma
X	101439765	101440114	MACS_peak_22536	104.89	349	0	1	0	luma
X	101474638	101474925	MACS_peak_22537	74.44	287	0	1	0	luma
X	106768467	106768832	MACS_peak_22593	124.55	365	0	1	0	luma
X	106788268	106788510	MACS_peak_22594	645.81	242	0	1	0	luma
X	106788649	106788975	MACS_peak_22595	546.72	326	0	1	0	luma
X	154051264	154051469	MACS_peak_22941	972.07	205	0	1	0	luma
X	154129115	154129250	MACS_peak_22942	1554.14	135	0	1	0	luma
X	154534807	154535060	MACS_peak_22949	470.06	253	1	0	0	luma
1	11149	11522	MACS_peak_1	2188.98	373	0	0	0	extreme
1	857883	858216	MACS_peak_41	793.64	333	0	0	1	extreme
1	1443392	1443724	MACS_peak_42	220.37	332	0	0	0	extreme
1	1681979	1682119	MACS_peak_43	275.54	140	0	1	0	extreme
1	2174377	2174590	MACS_peak_44	596.79	213	0	1	0	extreme
1	2364351	2364639	MACS_peak_45	103.45	288	0	1	0	extreme
1	3254892	3255248	MACS_peak_46	80.17	356	0	1	0	extreme
1	3724546	3724726	MACS_peak_48	746.04	180	0	1	0	extreme
1	3801606	3801829	MACS_peak_49	1180.64	223	0	0	0	extreme
1	5075519	5075919	MACS_peak_52	504.65	400	0	0	0	extreme
1	5825012	5825390	MACS_peak_56	129.87	378	0	0	0	extreme
1	6343512	6343735	MACS_peak_57	712.32	223	0	1	0	extreme
1	6404702	6405010	MACS_peak_58	473.53	308	0	0	0	extreme
1	6742514	6742846	MACS_peak_59	542.96	332	0	0	0	extreme
1	7667423	7667884	MACS_peak_65	825.38	461	0	1	0	extreme
1	8031286	8031506	MACS_peak_68	564.54	220	0	0	1	extreme
1	8277747	8277980	MACS_peak_69	538.37	233	0	0	0	extreme
1	9624718	9624853	MACS_peak_77	1143.32	135	0	0	0	extreme
1	10428138	10428392	MACS_peak_79	596.79	254	2	0	0	extreme
1	10507521	10507787	MACS_peak_80	463.44	266	0	1	0	extreme
1	11337637	11337810	MACS_peak_82	780.06	173	0	0	0	extreme
1	12106890	12107269	MACS_peak_85	402.61	379	0	1	0	extreme
1	12936314	12936672	MACS_peak_86	1314.22	358	1	0	0	extreme
1	15323590	15323850	MACS_peak_96	725.38	260	0	1	0	extreme
1	15638419	15638555	MACS_peak_97	1358.26	136	0	1	0	extreme
1	15833231	15833580	MACS_peak_99	416.71	349	0	0	0	extreme
1	16573281	16573628	MACS_peak_100	113.5	347	0	1	0	extreme
1	16951709	16951925	MACS_peak_110	580.62	216	0	1	0	extreme
1	17419828	17420134	MACS_peak_111	439.28	306	0	1	0	extreme
1	18820837	18821164	MACS_peak_117	546.09	327	0	0	0	extreme
1	20100972	20101209	MACS_peak_118	814.37	237	0	0	0	extreme
1	20522317	20522622	MACS_peak_121	497.03	305	0	0	0	extreme
1	20665211	20665513	MACS_peak_122	506.92	302	1	0	0	extreme
1	21370443	21370860	MACS_peak_126	611.54	417	0	0	0	extreme
1	22674250	22674416	MACS_peak_129	831.63	166	0	0	0	extreme
1	22889272	22889574	MACS_peak_130	441.54	302	0	1	0	extreme
1	23228552	23228765	MACS_peak_131	149.72	213	0	0	0	extreme
1	23703589	23703906	MACS_peak_132	552.5	317	0	0	0	extreme
1	23772166	23772389	MACS_peak_133	564.54	223	0	0	1	extreme
1	24527260	24527498	MACS_peak_135	1264.23	238	0	1	0	extreme
1	26399602	26399961	MACS_peak_151	734.33	359	0	0	0	extreme
1	26488429	26488729	MACS_peak_152	427.96	300	0	0	0	extreme
1	26602213	26602642	MACS_peak_153	767.78	429	0	0	0	extreme
1	26997648	26997903	MACS_peak_155	596.79	255	1	0	0	extreme
1	27284810	27285064	MACS_peak_157	1317.49	254	0	1	0	extreme
1	27556759	27557047	MACS_peak_158	572.35	288	0	1	0	extreme
1	27669177	27669561	MACS_peak_159	754.42	384	1	0	0	extreme
1	27672268	27672610	MACS_peak_160	420.18	342	0	0	1	extreme
1	28006676	28006885	MACS_peak_161	558.17	209	0	1	0	extreme
1	28409805	28409994	MACS_peak_162	1129.71	189	0	1	0	extreme
1	30567745	30568051	MACS_peak_176	270.85	306	0	0	0	extreme
1	31663926	31664194	MACS_peak_178	462.14	268	0	1	0	extreme
1	32066055	32066199	MACS_peak_179	392.74	144	0	0	1	extreme
1	32520352	32520710	MACS_peak_182	2805.6	358	0	1	0	extreme
1	32581070	32581419	MACS_peak_184	887.47	349	0	2	0	extreme
1	33194427	33194562	MACS_peak_185	1079.97	135	0	0	0	extreme
1	35274610	35274745	MACS_peak_198	702.09	135	0	1	0	extreme
1	36544545	36545008	MACS_peak_200	534.92	463	0	0	0	extreme
1	37209335	37209637	MACS_peak_202	75.54	302	0	0	0	extreme
1	37919368	37919591	MACS_peak_203	866.35	223	0	1	0	extreme
1	38562619	38562757	MACS_peak_206	960.73	138	0	0	0	extreme
1	39606234	39606628	MACS_peak_208	563.18	394	0	0	0	extreme
1	39799809	39800062	MACS_peak_209	470.06	253	0	0	1	extreme
1	39973476	39973831	MACS_peak_211	631.61	355	0	0	0	extreme
1	40367185	40367479	MACS_peak_218	50.35	294	0	1	0	extreme
1	40668937	40669328	MACS_peak_219	1006.73	391	0	0	0	extreme
1	42709055	42709277	MACS_peak_230	1528.09	222	0	0	0	extreme
1	43917396	43917753	MACS_peak_231	721.05	357	0	2	0	extreme
1	44036678	44037052	MACS_peak_232	637.63	374	0	0	1	extreme
1	44653006	44653253	MACS_peak_236	485.56	247	0	1	0	extreme
1	44796097	44796570	MACS_peak_238	2431.95	473	1	0	0	extreme
1	44835911	44836262	MACS_peak_239	531.49	351	0	1	0	extreme
1	45300383	45300572	MACS_peak_240	695.57	189	0	1	0	extreme
1	45725860	45726154	MACS_peak_242	219.32	294	0	1	0	extreme
1	46017307	46017645	MACS_peak_245	84.4	338	0	1	0	extreme
1	46223513	46223790	MACS_peak_246	564.42	277	0	0	0	extreme
1	46406366	46406745	MACS_peak_247	515.71	379	0	1	0	extreme
1	46584140	46584526	MACS_peak_250	511.95	386	0	1	0	extreme
1	47192897	47193225	MACS_peak_260	427.34	328	0	0	0	extreme
1	47380145	47380380	MACS_peak_261	468.75	235	0	0	0	extreme
1	49937811	49938179	MACS_peak_289	94.54	368	0	1	0	extreme
1	51192140	51192480	MACS_peak_297	421.18	340	0	0	0	extreme
1	51296903	51297132	MACS_peak_298	695.57	229	0	1	0	extreme
1	52690456	52690641	MACS_peak_301	650.69	185	0	1	0	extreme
1	53361250	53361485	MACS_peak_305	421.83	235	0	0	1	extreme
1	55022011	55022325	MACS_peak_308	301.54	314	0	0	0	extreme
1	58770782	58771186	MACS_peak_322	81.72	404	0	0	1	extreme
1	59001088	59001254	MACS_peak_323	831.63	166	0	0	1	extreme
1	62650379	62650613	MACS_peak_348	125.55	234	0	1	0	extreme
1	63240507	63240918	MACS_peak_349	76.72	411	0	0	1	extreme
1	63387051	63387271	MACS_peak_351	1472.89	220	0	1	0	extreme
1	63575180	63575531	MACS_peak_352	629.58	351	0	1	0	extreme
1	70132345	70132614	MACS_peak_394	243.49	269	0	1	0	extreme
1	70966036	70966220	MACS_peak_399	729.14	184	0	1	0	extreme
1	71119838	71120155	MACS_peak_400	93.4	317	0	0	1	extreme
1	73971754	73972172	MACS_peak_413	495.64	418	0	0	0	extreme
1	75708416	75708549	MACS_peak_431	1098.16	133	0	0	1	extreme
1	76973311	76973613	MACS_peak_438	441.54	302	0	1	0	extreme
1	77367657	77367954	MACS_peak_439	825.22	297	0	1	0	extreme
1	77512553	77512797	MACS_peak_442	108.03	244	0	1	0	extreme
1	78617554	78617744	MACS_peak_452	1235.46	190	1	0	0	extreme
1	78676451	78676672	MACS_peak_453	564.54	221	0	0	0	extreme
1	78846076	78846344	MACS_peak_456	58.19	268	0	0	0	extreme
1	79255445	79255727	MACS_peak_457	1564.49	282	0	0	0	extreme
1	84021095	84021292	MACS_peak_489	641.55	197	0	0	0	extreme
1	84844517	84844726	MACS_peak_493	613.04	209	0	1	0	extreme
1	85186768	85187116	MACS_peak_497	122.99	348	0	1	0	extreme
1	85254798	85255033	MACS_peak_498	516.86	235	0	0	0	extreme
1	85346931	85347167	MACS_peak_499	187.23	236	0	1	1	extreme
1	85644928	85645334	MACS_peak_500	170.56	406	1	0	0	extreme
1	86816335	86816793	MACS_peak_514	77.93	458	0	0	0	extreme
1	86953935	86954168	MACS_peak_515	385.14	233	0	1	0	extreme
1	88657171	88657397	MACS_peak_518	138.33	226	0	0	1	extreme
1	89388530	89388894	MACS_peak_520	115.7	364	0	0	0	extreme
1	90061124	90061445	MACS_peak_524	94.93	321	0	0	0	extreme
1	91459255	91459714	MACS_peak_533	1211.54	459	0	0	0	extreme
1	92232755	92233030	MACS_peak_535	94.11	275	0	1	0	extreme
1	92234895	92235277	MACS_peak_536	64.38	382	0	1	0	extreme
1	92538234	92538418	MACS_peak_537	829.69	184	0	1	0	extreme
1	92707928	92708212	MACS_peak_538	704	284	0	1	0	extreme
1	92894749	92895109	MACS_peak_539	84.06	360	0	1	0	extreme
1	92895525	92895808	MACS_peak_540	85.54	283	0	1	0	extreme
1	93257237	93257371	MACS_peak_542	1666.76	134	0	1	0	extreme
1	93391535	93391872	MACS_peak_543	142.05	337	0	0	0	extreme
1	93402920	93403284	MACS_peak_544	55.24	364	0	0	0	extreme
1	93629452	93629714	MACS_peak_545	466.05	262	0	1	0	extreme
1	93850836	93851104	MACS_peak_547	832.28	268	0	0	0	extreme
1	94018915	94019048	MACS_peak_548	1098.16	133	0	1	0	extreme
1	95043478	95043737	MACS_peak_551	726.32	259	0	1	0	extreme
1	95309058	95309397	MACS_peak_553	421.69	339	0	0	0	extreme
1	96609451	96609749	MACS_peak_558	163.87	298	0	0	0	extreme
1	97084211	97084410	MACS_peak_561	627.67	199	0	1	0	extreme
1	99707653	99707908	MACS_peak_579	470.06	255	1	0	0	extreme
1	100258755	100259101	MACS_peak_580	149.97	346	0	0	1	extreme
1	100666653	100667056	MACS_peak_581	112.08	403	0	0	0	extreme
1	100678027	100678356	MACS_peak_582	77.81	329	0	0	0	extreme
1	101373052	101373189	MACS_peak_584	1061.85	137	0	0	1	extreme
1	103461259	103461722	MACS_peak_598	586.55	463	0	0	1	extreme
1	104263264	104263543	MACS_peak_601	611.86	279	0	0	0	extreme
1	108676516	108676877	MACS_peak_688	239.82	361	0	0	0	extreme
1	108729797	108730062	MACS_peak_689	464.09	265	0	1	0	extreme
1	108898131	108898421	MACS_peak_692	413.6	290	0	2	0	extreme
1	109201075	109201416	MACS_peak_694	420.68	341	0	1	0	extreme
1	109640164	109640566	MACS_peak_699	620.31	402	0	0	0	extreme
1	109649757	109650076	MACS_peak_700	527.2	319	0	0	0	extreme
1	110079968	110080183	MACS_peak_703	543.04	215	0	0	0	extreme
1	110203075	110203278	MACS_peak_705	814.37	203	0	0	0	extreme
1	110457942	110458162	MACS_peak_706	416.26	220	0	0	0	extreme
1	110847840	110848044	MACS_peak_713	874.07	204	0	0	0	extreme
1	110947891	110948128	MACS_peak_714	516.86	237	1	0	1	extreme
1	111208725	111208963	MACS_peak_715	797.18	238	0	1	0	extreme
1	111290910	111291120	MACS_peak_716	1290.85	210	1	0	0	extreme
1	111769591	111769832	MACS_peak_717	1098.16	241	1	0	0	extreme
1	112340810	112341160	MACS_peak_725	69	350	0	0	1	extreme
1	112804116	112804493	MACS_peak_726	516.8	377	0	0	0	extreme
1	113140557	113140852	MACS_peak_730	445.58	295	0	0	0	extreme
1	113668439	113668717	MACS_peak_742	567.67	278	0	1	0	extreme
1	113835770	113836065	MACS_peak_743	1344.81	295	0	1	0	extreme
1	113874520	113874898	MACS_peak_745	832.59	378	1	0	1	extreme
1	114363365	114363614	MACS_peak_755	410.82	249	0	0	0	extreme
1	114558602	114559055	MACS_peak_762	907.19	453	0	0	0	extreme
1	114671496	114671811	MACS_peak_767	475.35	315	1	0	0	extreme
1	114859766	114860062	MACS_peak_770	367.21	296	0	0	0	extreme
1	115635585	115635768	MACS_peak_782	174.78	183	0	0	0	extreme
1	115784133	115784451	MACS_peak_783	237.25	318	0	0	0	extreme
1	116499002	116499387	MACS_peak_795	603.02	385	0	0	0	extreme
1	116724804	116725161	MACS_peak_802	399.64	357	0	0	0	extreme
1	117221937	117222228	MACS_peak_806	105.65	291	0	0	0	extreme
1	117312544	117312796	MACS_peak_807	761.83	252	0	0	1	extreme
1	117895633	117895936	MACS_peak_814	440.97	303	0	1	0	extreme
1	118151344	118151800	MACS_peak_815	590.18	456	0	1	0	extreme
1	121481487	121481756	MACS_peak_848	114.39	269	0	0	0	extreme
1	145258795	145259016	MACS_peak_913	166.81	221	0	0	0	extreme
1	148729802	148730075	MACS_peak_934	1804.99	273	0	0	0	extreme
1	146013043	146013337	MACS_peak_943	730.33	294	1	0	0	extreme
1	145977505	145977822	MACS_peak_945	536.57	317	0	1	0	extreme
1	145846180	145846428	MACS_peak_946	485.56	248	2	0	0	extreme
1	145845415	145845778	MACS_peak_947	769.88	363	2	0	0	extreme
1	145721263	145721456	MACS_peak_948	856.26	193	1	0	0	extreme
1	147126674	147126944	MACS_peak_967	60.64	270	0	0	0	extreme
1	147306269	147306568	MACS_peak_968	97.7	299	0	0	1	extreme
1	147892756	147893052	MACS_peak_980	1869.05	296	0	0	0	extreme
1	120874493	120874772	MACS_peak_994	190.74	279	0	0	0	extreme
1	148517256	148517636	MACS_peak_997	406.15	380	0	0	1	extreme
1	149483178	149483506	MACS_peak_1005	133.29	328	0	1	0	extreme
1	144578143	144578422	MACS_peak_1025	191.39	279	0	0	0	extreme
1	149792548	149792787	MACS_peak_1027	596.12	239	0	1	1	extreme
1	150001870	150002221	MACS_peak_1028	464.59	351	0	1	0	extreme
1	150050648	150050950	MACS_peak_1029	370.35	302	0	0	1	extreme
1	150221633	150221996	MACS_peak_1037	556.44	363	1	0	0	extreme
1	150560838	150561145	MACS_peak_1041	816.07	307	0	0	1	extreme
1	150631297	150631512	MACS_peak_1043	829.69	215	0	0	0	extreme
1	150813195	150813413	MACS_peak_1045	994.28	218	1	0	0	extreme
1	150979549	150979802	MACS_peak_1047	1965.34	253	1	0	0	extreme
1	151534531	151535002	MACS_peak_1053	1070.32	471	0	1	0	extreme
1	151693082	151693452	MACS_peak_1059	346.45	370	0	1	0	extreme
1	151888886	151889279	MACS_peak_1060	495.92	393	0	1	1	extreme
1	153364100	153364234	MACS_peak_1085	1377.21	134	0	0	0	extreme
1	153495066	153495372	MACS_peak_1086	439.28	306	0	0	0	extreme
1	153580493	153580686	MACS_peak_1087	654.75	193	0	0	0	extreme
1	153736548	153736890	MACS_peak_1088	786.29	342	0	1	0	extreme
1	154125655	154125910	MACS_peak_1093	201	255	0	1	0	extreme
1	154189006	154189477	MACS_peak_1094	202.06	471	0	1	0	extreme
1	154943865	154944161	MACS_peak_1097	445	296	1	0	0	extreme
1	154999086	154999425	MACS_peak_1098	661.26	339	1	0	0	extreme
1	155161151	155161481	MACS_peak_1101	312.33	330	0	0	0	extreme
1	155193551	155193779	MACS_peak_1102	1171.45	228	1	0	0	extreme
1	155633857	155634167	MACS_peak_1107	345.15	310	0	0	1	extreme
1	155989469	155989697	MACS_peak_1109	485.73	228	0	1	0	extreme
1	156146009	156146394	MACS_peak_1111	512.49	385	1	0	0	extreme
1	156474637	156474833	MACS_peak_1117	662.31	196	0	1	0	extreme
1	156584087	156584257	MACS_peak_1118	797.18	170	1	0	0	extreme
1	157163717	157163880	MACS_peak_1120	848.95	163	0	0	0	extreme
1	157963731	157963967	MACS_peak_1129	1965.34	236	0	0	0	extreme
1	158308374	158308698	MACS_peak_1132	107.09	324	0	0	0	extreme
1	158762556	158762997	MACS_peak_1136	51.59	441	0	1	0	extreme
1	158867369	158867662	MACS_peak_1137	392.5	293	0	0	0	extreme
1	158890208	158890630	MACS_peak_1139	61.15	422	0	0	0	extreme
1	159198045	159198277	MACS_peak_1145	989.9	232	0	1	1	extreme
1	159211647	159211887	MACS_peak_1146	516.86	240	0	0	0	extreme
1	159265315	159265664	MACS_peak_1147	129.98	349	0	0	0	extreme
1	159331775	159332162	MACS_peak_1148	137.06	387	0	0	0	extreme
1	159735576	159736016	MACS_peak_1154	171.32	440	0	0	0	extreme
1	160319913	160320045	MACS_peak_1156	1116.4	132	0	1	0	extreme
1	160726897	160727066	MACS_peak_1160	1025.76	169	0	0	0	extreme
1	160788581	160788886	MACS_peak_1161	264.16	305	0	0	0	extreme
1	160990384	160990561	MACS_peak_1163	1171.45	177	1	0	0	extreme
1	161071838	161072160	MACS_peak_1164	936.39	322	1	0	0	extreme
1	161097641	161097957	MACS_peak_1165	845.32	316	2	0	0	extreme
1	161291495	161291921	MACS_peak_1166	488.85	426	0	0	0	extreme
1	161382066	161382428	MACS_peak_1167	372.06	362	0	0	0	extreme
1	162392207	162392446	MACS_peak_1174	777.13	239	1	0	0	extreme
1	165752392	165752543	MACS_peak_1197	2840.91	151	0	1	0	extreme
1	165964474	165964729	MACS_peak_1198	322.82	255	0	0	0	extreme
1	166739817	166740204	MACS_peak_1210	1728.83	387	0	0	0	extreme
1	166943381	166943631	MACS_peak_1211	222.96	250	0	1	0	extreme
1	167886201	167886584	MACS_peak_1218	165.11	383	0	1	0	extreme
1	168348876	168349289	MACS_peak_1219	319.91	413	0	0	1	extreme
1	169466319	169466568	MACS_peak_1232	613.04	249	1	0	0	extreme
1	169694271	169694609	MACS_peak_1233	1195.93	338	1	1	0	extreme
1	173730240	173730423	MACS_peak_1265	138.14	183	0	1	0	extreme
1	174986968	174987260	MACS_peak_1286	1107.47	292	0	1	0	extreme
1	175042630	175042825	MACS_peak_1287	662.31	195	0	0	0	extreme
1	182962565	182962866	MACS_peak_1369	563.21	301	0	0	0	extreme
1	192610090	192610483	MACS_peak_1465	1004.98	393	0	0	1	extreme
1	192795789	192796012	MACS_peak_1466	870.43	223	0	0	1	extreme
1	192865716	192865849	MACS_peak_1467	1686.4	133	0	0	1	extreme
1	196881426	196881740	MACS_peak_1503	208.44	314	0	0	1	extreme
1	197180312	197180754	MACS_peak_1504	597.62	442	0	1	0	extreme
1	197399999	197400332	MACS_peak_1507	1236.43	333	0	1	0	extreme
1	198250462	198250896	MACS_peak_1515	118.84	434	0	1	0	extreme
1	201602549	201602891	MACS_peak_1552	312.33	342	0	0	0	extreme
1	202063633	202063916	MACS_peak_1553	601.91	283	0	0	0	extreme
1	202852277	202852679	MACS_peak_1569	487.83	402	0	0	1	extreme
1	202970844	202970977	MACS_peak_1570	733.5	133	0	0	0	extreme
1	203751800	203752037	MACS_peak_1592	375.48	237	0	0	0	extreme
1	203871054	203871271	MACS_peak_1595	1239.92	217	0	0	0	extreme
1	205061627	205061970	MACS_peak_1614	721.05	343	0	1	0	extreme
1	205122227	205122492	MACS_peak_1615	553.87	265	0	0	0	extreme
1	206175583	206175900	MACS_peak_1634	395.81	317	0	0	1	extreme
1	206032275	206032587	MACS_peak_1636	435.94	312	0	0	0	extreme
1	206583756	206583992	MACS_peak_1643	814.37	236	0	2	0	extreme
1	206734553	206734874	MACS_peak_1645	1074.74	321	0	0	0	extreme
1	206864937	206865251	MACS_peak_1648	554.47	314	1	0	0	extreme
1	207797374	207797607	MACS_peak_1666	972.07	233	0	0	0	extreme
1	208744683	208744911	MACS_peak_1667	342.86	228	0	0	0	extreme
1	209726268	209726580	MACS_peak_1670	470.9	312	0	1	0	extreme
1	210013610	210013881	MACS_peak_1671	460.22	271	0	1	0	extreme
1	210950055	210950235	MACS_peak_1676	382.98	180	0	2	0	extreme
1	212455918	212456230	MACS_peak_1678	1084.56	312	0	0	0	extreme
1	212630125	212630362	MACS_peak_1679	662.31	237	0	0	0	extreme
1	213074736	213075009	MACS_peak_1680	458.95	273	0	1	0	extreme
1	213374394	213374564	MACS_peak_1683	797.18	170	0	0	0	extreme
1	214833976	214834289	MACS_peak_1684	1198.83	313	0	0	0	extreme
1	216932606	216932738	MACS_peak_1709	1028.85	132	0	1	0	extreme
1	219922095	219922299	MACS_peak_1736	501.94	204	0	1	0	extreme
1	220471005	220471298	MACS_peak_1743	488.85	293	0	0	0	extreme
1	221543874	221544108	MACS_peak_1747	532.66	234	0	0	0	extreme
1	221860862	221861239	MACS_peak_1748	62.38	377	0	0	0	extreme
1	222477647	222477884	MACS_peak_1754	649.5	237	0	0	1	extreme
1	222873017	222873420	MACS_peak_1755	62.23	403	1	0	1	extreme
1	224101466	224101845	MACS_peak_1773	76.3	379	0	0	0	extreme
1	224170708	224170942	MACS_peak_1774	644.94	234	0	0	0	extreme
1	224372418	224372776	MACS_peak_1775	229.83	358	0	1	0	extreme
1	225965764	225966022	MACS_peak_1784	482.41	258	0	0	0	extreme
1	226064851	226065195	MACS_peak_1785	1050.85	344	1	0	0	extreme
1	226333457	226333858	MACS_peak_1786	620.91	401	0	0	0	extreme
1	226711270	226711568	MACS_peak_1787	380.3	298	0	1	0	extreme
1	226927247	226927617	MACS_peak_1788	68.3	370	0	1	0	extreme
1	227555449	227555790	MACS_peak_1790	76.27	341	0	0	0	extreme
1	227946670	227946906	MACS_peak_1791	516.86	236	0	1	0	extreme
1	227966818	227967164	MACS_peak_1792	297.28	346	0	0	0	extreme
1	228131037	228131313	MACS_peak_1793	710.92	276	0	0	0	extreme
1	228608906	228609206	MACS_peak_1795	54.69	300	0	0	0	extreme
1	229227612	229227819	MACS_peak_1817	613.04	207	0	0	0	extreme
1	229675732	229676058	MACS_peak_1819	546.72	326	0	0	0	extreme
1	230871959	230872108	MACS_peak_1823	3040.58	149	0	0	0	extreme
1	231052269	231052664	MACS_peak_1824	624.52	395	0	0	0	extreme
1	231121835	231122239	MACS_peak_1825	449.73	404	0	0	0	extreme
1	231756788	231757084	MACS_peak_1826	566.68	296	0	2	0	extreme
1	235093852	235094168	MACS_peak_1835	1080.16	316	0	0	0	extreme
1	235353682	235353993	MACS_peak_1836	534.92	311	0	1	0	extreme
1	236035243	236035697	MACS_peak_1840	122.09	454	0	1	0	extreme
1	241244597	241244837	MACS_peak_1855	223.38	240	0	1	0	extreme
1	241627575	241627791	MACS_peak_1856	580.62	216	1	1	0	extreme
1	246532603	246532816	MACS_peak_1883	596.79	213	0	0	0	extreme
1	246689550	246689771	MACS_peak_1884	564.54	221	0	0	0	extreme
1	246721616	246721759	MACS_peak_1886	834.89	143	1	0	0	extreme
1	247004695	247004977	MACS_peak_1887	576.71	282	0	2	0	extreme
1	247125315	247125454	MACS_peak_1888	869.22	139	1	0	0	extreme
1	247826620	247826755	MACS_peak_1893	1965.34	135	0	0	0	extreme
1	248119487	248119944	MACS_peak_1894	80.72	457	0	0	0	extreme
1	248677134	248677525	MACS_peak_1900	180.31	391	1	0	0	extreme
1	248867081	248867228	MACS_peak_1901	871.29	147	0	0	0	extreme
1	248924698	248925042	MACS_peak_1902	656.28	344	0	0	0	extreme
1	146900554	146900770	MACS_peak_9821	746.04	216	0	0	1	extreme
2	18713	19110	MACS_peak_9840	745.28	397	0	0	0	extreme
2	246511	246781	MACS_peak_9841	460.86	270	0	1	0	extreme
2	530911	531084	MACS_peak_9842	1208.41	173	0	0	0	extreme
2	3462314	3462773	MACS_peak_9859	826.72	459	0	1	0	extreme
2	3959173	3959526	MACS_peak_9860	651.52	353	0	0	1	extreme
2	6651481	6651859	MACS_peak_9873	312.33	378	0	0	0	extreme
2	9395486	9395649	MACS_peak_9886	668.89	163	0	1	0	extreme
2	9506249	9506482	MACS_peak_9887	831.63	233	0	1	1	extreme
2	10097421	10097793	MACS_peak_9891	405.79	372	0	0	0	extreme
2	11124530	11124848	MACS_peak_9898	676.68	318	0	0	1	extreme
2	15548872	15549120	MACS_peak_9932	613.04	248	0	1	0	extreme
2	15848462	15848813	MACS_peak_9933	221.76	351	0	0	0	extreme
2	23908290	23908682	MACS_peak_9994	170.04	392	0	1	0	extreme
2	24194422	24194879	MACS_peak_9996	105.03	457	0	1	0	extreme
2	25196482	25196834	MACS_peak_9999	1464.78	352	0	0	0	extreme
2	25361998	25362190	MACS_peak_10002	866.35	192	0	0	0	extreme
2	26418479	26418827	MACS_peak_10008	380.3	348	0	1	0	extreme
2	26605321	26605713	MACS_peak_10009	508.79	392	0	1	0	extreme
2	26846321	26846511	MACS_peak_10010	1079.97	190	1	0	0	extreme
2	27016975	27017177	MACS_peak_10012	645.81	202	0	1	0	extreme
2	27098616	27098978	MACS_peak_10013	770.64	362	1	1	0	extreme
2	27303526	27303822	MACS_peak_10015	882.02	296	1	1	0	extreme
2	27370308	27370497	MACS_peak_10016	695.57	189	1	0	0	extreme
2	31837433	31837582	MACS_peak_10049	1128.57	149	0	0	0	extreme
2	33395652	33395993	MACS_peak_10062	773.86	341	0	1	0	extreme
2	33583306	33583761	MACS_peak_10063	954.68	455	1	0	0	extreme
2	36918272	36918675	MACS_peak_10089	866.86	403	0	1	0	extreme
2	37395971	37396217	MACS_peak_10090	485.56	246	0	0	0	extreme
2	38947695	38947942	MACS_peak_10110	629.38	247	0	1	0	extreme
2	42663141	42663398	MACS_peak_10133	469.39	257	0	1	0	extreme
2	42813042	42813452	MACS_peak_10134	499.59	410	0	0	0	extreme
2	46464489	46464814	MACS_peak_10160	547.36	325	0	0	1	extreme
2	46776780	46777111	MACS_peak_10161	1105.5	331	0	1	1	extreme
2	55014058	55014241	MACS_peak_10209	710.43	183	0	1	0	extreme
2	55446883	55447250	MACS_peak_10210	60.83	367	0	0	0	extreme
2	57759791	57760083	MACS_peak_10236	447.34	292	0	0	1	extreme
2	61848769	61849158	MACS_peak_10264	1662.16	389	0	1	0	extreme
2	62022442	62022577	MACS_peak_10265	1828.2	135	0	1	0	extreme
2	63544131	63544431	MACS_peak_10282	442.68	300	0	1	0	extreme
2	68292223	68292497	MACS_peak_10317	847.52	274	0	1	0	extreme
2	68449593	68449935	MACS_peak_10318	308.09	342	0	0	0	extreme
2	69817044	69817266	MACS_peak_10335	712.32	222	0	1	0	extreme
2	70429912	70430234	MACS_peak_10336	59.93	322	0	0	0	extreme
2	70785365	70785542	MACS_peak_10338	763.02	177	0	1	0	extreme
2	70861826	70862056	MACS_peak_10339	532.66	230	0	0	0	extreme
2	71157511	71157732	MACS_peak_10341	374.94	221	0	0	0	extreme
2	72887907	72888129	MACS_peak_10356	564.54	222	1	0	0	extreme
2	73212536	73212849	MACS_peak_10358	1083.46	313	1	0	0	extreme
2	73541382	73541805	MACS_peak_10360	63.13	423	0	1	0	extreme
2	73839643	73839888	MACS_peak_10367	629.38	245	0	1	0	extreme
2	74129312	74129449	MACS_peak_10368	552.8	137	0	0	0	extreme
2	74973333	74973756	MACS_peak_10374	161.97	423	0	0	0	extreme
2	86590125	86590401	MACS_peak_10473	960.3	276	0	1	1	extreme
2	86888006	86888179	MACS_peak_10474	641.15	173	0	0	1	extreme
2	95115395	95115684	MACS_peak_10605	555.65	289	0	1	0	extreme
2	95192891	95193153	MACS_peak_10606	762.37	262	0	0	0	extreme
2	95780402	95780773	MACS_peak_10609	83.56	371	0	0	0	extreme
2	96384502	96384802	MACS_peak_10613	74.03	300	0	0	0	extreme
2	96509404	96509691	MACS_peak_10615	450.32	287	0	0	0	extreme
2	96987168	96987309	MACS_peak_10616	382.33	141	0	0	0	extreme
2	97597032	97597365	MACS_peak_10624	69.11	333	0	0	0	extreme
2	97697194	97697578	MACS_peak_10625	513.02	384	0	1	0	extreme
2	97885218	97885494	MACS_peak_10626	380.3	276	0	1	0	extreme
2	98990956	98991366	MACS_peak_10632	172.39	410	0	0	0	extreme
2	99006387	99006822	MACS_peak_10633	97.26	435	0	1	0	extreme
2	99454546	99454685	MACS_peak_10634	475.03	139	0	1	0	extreme
2	100262652	100263093	MACS_peak_10640	965.4	441	0	0	0	extreme
2	101439102	101439289	MACS_peak_10650	712.32	187	0	1	0	extreme
2	102703762	102704041	MACS_peak_10656	455.19	279	0	1	0	extreme
2	108989215	108989495	MACS_peak_10706	578.19	280	0	0	0	extreme
2	109792721	109792997	MACS_peak_10709	430.51	276	1	0	0	extreme
2	111589811	111590144	MACS_peak_10742	56.31	333	0	0	2	extreme
2	112726814	112727019	MACS_peak_10760	629.38	205	0	1	0	extreme
2	112876559	112876708	MACS_peak_10761	954.29	149	0	0	0	extreme
2	117814350	117814777	MACS_peak_10811	1372.86	427	1	0	0	extreme
2	119299080	119299271	MACS_peak_10825	695.57	191	1	0	0	extreme
2	120026826	120027178	MACS_peak_10826	499.41	352	0	1	0	extreme
2	126305896	126306028	MACS_peak_10863	1116.4	132	0	0	0	extreme
2	127797087	127797426	MACS_peak_10864	380.3	339	0	1	0	extreme
2	128036002	128036146	MACS_peak_10865	537.26	144	0	0	0	extreme
2	129963130	129963510	MACS_peak_10874	294.76	380	0	0	0	extreme
2	130244941	130245410	MACS_peak_10876	62.89	469	0	0	0	extreme
2	131007355	131007726	MACS_peak_10878	540.91	371	0	1	0	extreme
2	131305516	131305648	MACS_peak_10879	1090.31	132	0	1	2	extreme
2	131672624	131672979	MACS_peak_10881	529.16	355	0	0	0	extreme
2	134756641	134756778	MACS_peak_10917	1326.27	137	0	0	1	extreme
2	136193589	136193842	MACS_peak_10924	470.06	253	0	0	0	extreme
2	147910974	147911228	MACS_peak_10992	596.79	254	0	1	0	extreme
2	148381906	148382289	MACS_peak_11000	127.98	383	0	1	0	extreme
2	149263556	149263793	MACS_peak_11007	516.86	237	0	0	0	extreme
2	149549633	149549946	MACS_peak_11008	63.13	313	0	0	0	extreme
2	151238897	151239270	MACS_peak_11019	1438.77	373	0	0	0	extreme
2	151580861	151581168	MACS_peak_11020	989.38	307	0	1	0	extreme
2	151633289	151633546	MACS_peak_11023	595.98	257	0	1	0	extreme
2	156259241	156259535	MACS_peak_11060	62.05	294	0	0	0	extreme
2	156371402	156371745	MACS_peak_11061	52.99	343	0	0	0	extreme
2	156695664	156695854	MACS_peak_11062	695.57	190	0	0	0	extreme
2	158084303	158084668	MACS_peak_11077	768.37	365	0	1	0	extreme
2	158724257	158724456	MACS_peak_11082	645.81	199	0	0	2	extreme
2	161566827	161567226	MACS_peak_11108	81.72	399	0	1	0	extreme
2	169456034	169456302	MACS_peak_11166	111.72	268	0	0	0	extreme
2	169767412	169767626	MACS_peak_11170	746.04	214	0	1	1	extreme
2	170324635	170324863	MACS_peak_11171	695.57	228	0	1	0	extreme
2	170648558	170648818	MACS_peak_11174	593.56	260	0	1	1	extreme
2	170873309	170873547	MACS_peak_11176	662.31	238	0	0	0	extreme
2	171642352	171642630	MACS_peak_11180	95.03	278	0	0	0	extreme
2	174341574	174341802	MACS_peak_11208	1171.45	228	0	0	0	extreme
2	175964204	175964506	MACS_peak_11222	490.09	302	0	1	0	extreme
2	176732518	176732759	MACS_peak_11224	645.81	241	0	0	1	extreme
2	177489701	177489970	MACS_peak_11233	461.5	269	0	1	0	extreme
2	177763709	177763966	MACS_peak_11234	595.98	257	0	2	0	extreme
2	179751240	179751529	MACS_peak_11255	226.26	289	0	1	0	extreme
2	180077317	180077626	MACS_peak_11256	1406.8	309	0	0	0	extreme
2	181386272	181386545	MACS_peak_11263	1025.27	273	0	0	1	extreme
2	186468175	186468407	MACS_peak_11310	532.66	232	0	0	0	extreme
2	186781050	186781425	MACS_peak_11311	1436.37	375	0	0	0	extreme
2	187291883	187292113	MACS_peak_11316	496.47	230	0	0	1	extreme
2	187497935	187498222	MACS_peak_11317	603.02	287	0	1	1	extreme
2	188826321	188826676	MACS_peak_11323	85.58	355	0	0	1	extreme
2	189287924	189288213	MACS_peak_11328	1027.23	289	0	0	0	extreme
2	189416067	189416447	MACS_peak_11330	147.83	380	0	0	0	extreme
2	189698384	189698601	MACS_peak_11333	1079.97	217	0	1	0	extreme
2	190372412	190372707	MACS_peak_11338	445.58	295	0	0	0	extreme
2	190727739	190728202	MACS_peak_11339	586.55	463	0	0	0	extreme
2	191690383	191690681	MACS_peak_11347	443.84	298	0	1	0	extreme
2	191986445	191986578	MACS_peak_11348	1431.06	133	0	1	1	extreme
2	196181266	196181457	MACS_peak_11390	695.57	191	0	0	0	extreme
2	197260849	197261322	MACS_peak_11402	142.22	473	0	1	1	extreme
2	197575669	197575938	MACS_peak_11403	586.5	269	0	1	0	extreme
2	199861283	199861563	MACS_peak_11424	707.43	280	0	0	0	extreme
2	200131579	200131802	MACS_peak_11426	712.32	223	0	0	0	extreme
2	200575952	200576287	MACS_peak_11430	423.72	335	0	1	0	extreme
2	200905679	200906086	MACS_peak_11432	555.48	407	1	0	0	extreme
2	201169161	201169497	MACS_peak_11433	265.34	336	0	1	0	extreme
2	201291827	201292164	MACS_peak_11435	84.4	337	1	0	0	extreme
2	201835842	201836260	MACS_peak_11436	1353.18	418	0	1	0	extreme
2	203225494	203225707	MACS_peak_11443	1282.94	213	0	1	0	extreme
2	206071176	206071397	MACS_peak_11459	255.86	221	0	1	0	extreme
2	206164312	206164617	MACS_peak_11460	475.52	305	0	0	0	extreme
2	216033930	216034288	MACS_peak_11545	648.14	358	0	1	0	extreme
2	216404083	216404304	MACS_peak_11546	549.18	221	0	0	1	extreme
2	216696786	216696996	MACS_peak_11547	772.8	210	0	0	1	extreme
2	218186271	218186572	MACS_peak_11557	689.95	301	0	0	0	extreme
2	218301321	218301567	MACS_peak_11558	458.27	246	0	1	0	extreme
2	218687493	218687752	MACS_peak_11559	830.88	259	0	1	0	extreme
2	219594623	219594979	MACS_peak_11565	284.23	356	1	0	0	extreme
2	222154905	222155170	MACS_peak_11578	106.55	265	0	0	0	extreme
2	222690670	222690963	MACS_peak_11579	446.75	293	0	1	0	extreme
2	224232020	224232265	MACS_peak_11589	450.38	245	0	0	0	extreme
2	225128806	225129074	MACS_peak_11591	76.3	268	0	0	0	extreme
2	227107186	227107377	MACS_peak_11603	866.35	191	0	1	0	extreme
2	227379442	227379695	MACS_peak_11604	425.33	253	0	1	0	extreme
2	227890475	227890721	MACS_peak_11605	485.56	246	0	1	0	extreme
2	229743861	229744193	MACS_peak_11614	149.97	332	0	0	0	extreme
2	230118987	230119326	MACS_peak_11615	974.11	339	0	0	0	extreme
2	230230544	230230865	MACS_peak_11616	431.05	321	0	1	0	extreme
2	230291685	230291997	MACS_peak_11617	435.94	312	0	1	0	extreme
2	230611444	230611655	MACS_peak_11618	1023.29	211	0	0	0	extreme
2	231679640	231679795	MACS_peak_11627	1904.96	155	0	0	0	extreme
2	231900512	231900813	MACS_peak_11628	563.21	301	0	0	0	extreme
2	232688373	232688505	MACS_peak_11632	1028.85	132	0	0	0	extreme
2	233186607	233186808	MACS_peak_11633	68.85	201	0	1	0	extreme
2	233577614	233577799	MACS_peak_11636	281.97	185	0	0	0	extreme
2	234288840	234289246	MACS_peak_11638	722.05	406	0	0	0	extreme
2	235307386	235307748	MACS_peak_11641	62.29	362	0	0	0	extreme
2	238065117	238065313	MACS_peak_11651	644.94	196	1	1	0	extreme
2	238256643	238256871	MACS_peak_11652	848.95	228	0	1	0	extreme
2	238717727	238718001	MACS_peak_11653	71.7	274	0	0	0	extreme
2	238785081	238785328	MACS_peak_11655	763.02	247	0	0	0	extreme
2	239837993	239838280	MACS_peak_11657	107.62	287	0	0	0	extreme
2	240233002	240233174	MACS_peak_11659	1007.8	172	0	0	1	extreme
2	240699197	240699387	MACS_peak_11665	695.57	190	0	0	0	extreme
2	241338580	241339056	MACS_peak_11666	939.22	476	0	1	0	extreme
2	241396147	241396553	MACS_peak_11667	59.93	406	0	1	0	extreme
2	241732668	241732899	MACS_peak_11668	1090.36	231	1	0	0	extreme
2	242182006	242182309	MACS_peak_11672	540.43	303	0	0	0	extreme
3	135689	135884	MACS_peak_12964	472.76	195	0	0	0	extreme
3	2600447	2600831	MACS_peak_12990	105.65	384	0	1	0	extreme
3	3131771	3132144	MACS_peak_12992	74.1	373	0	0	0	extreme
3	3200482	3200940	MACS_peak_12993	1483.9	458	0	0	0	extreme
3	4980394	4980683	MACS_peak_13015	699.78	289	1	0	0	extreme
3	5226689	5227123	MACS_peak_13017	843.98	434	0	0	0	extreme
3	9302667	9303033	MACS_peak_13046	435.67	366	0	1	1	extreme
3	9503308	9503568	MACS_peak_13048	593.56	260	0	0	0	extreme
3	9821036	9821248	MACS_peak_13049	919.78	212	0	2	0	extreme
3	10225016	10225187	MACS_peak_13050	932.24	171	0	1	0	extreme
3	12194666	12194931	MACS_peak_13071	621.04	265	0	0	0	extreme
3	12706526	12706747	MACS_peak_13072	1226.97	221	0	0	0	extreme
3	12770686	12770969	MACS_peak_13073	506.92	283	0	0	0	extreme
3	12841625	12841980	MACS_peak_13074	529.16	355	0	1	0	extreme
3	14075019	14075394	MACS_peak_13086	115.17	375	0	0	1	extreme
3	14203558	14203863	MACS_peak_13087	560.48	305	0	0	0	extreme
3	14508802	14509186	MACS_peak_13090	881.79	384	0	1	0	extreme
3	14673798	14674114	MACS_peak_13091	553.16	316	1	0	0	extreme
3	14925672	14925981	MACS_peak_13094	814.28	309	0	1	1	extreme
3	15055304	15055527	MACS_peak_13095	650.69	223	0	1	0	extreme
3	15108168	15108361	MACS_peak_13096	678.9	193	0	0	0	extreme
3	15305303	15305551	MACS_peak_13101	471.88	248	0	1	0	extreme
3	16178445	16178671	MACS_peak_13111	848.95	226	1	0	0	extreme
3	19866781	19867235	MACS_peak_13162	915.58	454	0	0	0	extreme
3	20031270	20031452	MACS_peak_13163	919.78	182	0	0	0	extreme
3	20089256	20089421	MACS_peak_13165	1127.44	165	0	1	0	extreme
3	20225833	20226041	MACS_peak_13166	931.22	208	0	0	1	extreme
3	23888663	23889049	MACS_peak_13201	880.18	386	1	1	0	extreme
3	23998995	23999295	MACS_peak_13202	406.81	300	0	0	0	extreme
3	25333882	25334213	MACS_peak_13212	63.13	331	0	1	0	extreme
3	25856885	25857230	MACS_peak_13215	657.04	345	0	0	0	extreme
3	26993768	26994099	MACS_peak_13226	109.76	331	0	0	0	extreme
3	27681315	27681481	MACS_peak_13234	831.63	166	0	0	0	extreme
3	27817461	27817746	MACS_peak_13235	56.02	285	0	0	1	extreme
3	28062018	28062375	MACS_peak_13237	55.08	357	0	0	0	extreme
3	31644676	31645064	MACS_peak_13260	337.18	388	0	0	0	extreme
3	32177343	32177542	MACS_peak_13264	645.81	199	0	0	0	extreme
3	32510203	32510407	MACS_peak_13266	629.38	204	0	0	0	extreme
3	32573255	32573387	MACS_peak_13268	977.06	132	0	0	0	extreme
3	33456193	33456325	MACS_peak_13272	1046.12	132	0	0	0	extreme
3	33787405	33787771	MACS_peak_13275	408.57	366	0	0	0	extreme
3	36798174	36798542	MACS_peak_13301	114.26	368	0	0	0	extreme
3	37530615	37530925	MACS_peak_13302	127.5	310	0	1	0	extreme
3	37967329	37967661	MACS_peak_13304	425.26	332	0	1	0	extreme
3	38341959	38342282	MACS_peak_13305	75.01	323	1	0	0	extreme
3	38937474	38937744	MACS_peak_13309	90.4	270	0	1	0	extreme
3	39291833	39292231	MACS_peak_13310	1000.63	398	0	0	0	extreme
3	39378091	39378426	MACS_peak_13312	791.99	335	0	0	0	extreme
3	39417288	39417651	MACS_peak_13313	730.17	363	0	0	0	extreme
3	40137253	40137540	MACS_peak_13322	91.5	287	0	1	0	extreme
3	40317118	40317458	MACS_peak_13324	919.5	340	0	0	1	extreme
3	40327619	40327915	MACS_peak_13325	1940.72	296	0	0	1	extreme
3	40580454	40580798	MACS_peak_13326	419.18	344	0	0	0	extreme
3	40904727	40905190	MACS_peak_13330	50.94	463	0	0	0	extreme
3	41935101	41935323	MACS_peak_13338	831.64	222	0	1	0	extreme
3	43069728	43070210	MACS_peak_13343	88.78	482	0	0	0	extreme
3	44323374	44323673	MACS_peak_13349	1242.54	299	0	1	0	extreme
3	45037781	45038151	MACS_peak_13350	482.49	370	0	0	0	extreme
3	45040822	45041096	MACS_peak_13351	847.52	274	0	0	0	extreme
3	46866828	46867072	MACS_peak_13357	501.16	244	0	1	0	extreme
3	48239424	48239560	MACS_peak_13362	783.1	136	1	0	0	extreme
3	50211465	50211692	MACS_peak_13369	224.15	227	0	1	0	extreme
3	51366526	51366925	MACS_peak_13382	55.51	399	0	1	0	extreme
3	52447095	52447346	MACS_peak_13383	485.56	251	1	0	0	extreme
3	52859427	52859636	MACS_peak_13384	725.36	209	0	2	0	extreme
3	53691645	53692021	MACS_peak_13385	506.92	376	0	1	0	extreme
3	53923802	53924058	MACS_peak_13386	56.38	256	0	0	0	extreme
3	56579214	56579526	MACS_peak_13402	76.3	312	0	1	0	extreme
3	56702503	56702825	MACS_peak_13403	549.27	322	0	0	0	extreme
3	57127132	57127486	MACS_peak_13407	761.56	354	0	1	0	extreme
3	57329373	57329831	MACS_peak_13408	58.18	458	0	1	0	extreme
3	57480301	57480524	MACS_peak_13410	119.34	223	0	1	0	extreme
3	57608308	57608741	MACS_peak_13411	147.59	433	0	0	0	extreme
3	63820578	63821019	MACS_peak_13482	505.83	441	1	0	1	extreme
3	63889360	63889661	MACS_peak_13485	2496.33	301	0	1	1	extreme
3	65785007	65785459	MACS_peak_13552	592.28	452	0	1	0	extreme
3	68972460	68972837	MACS_peak_13567	403.51	377	1	0	0	extreme
3	69161658	69161902	MACS_peak_13569	780.06	244	0	0	0	extreme
3	70979267	70979414	MACS_peak_13586	649.42	147	0	2	0	extreme
3	71859291	71859495	MACS_peak_13587	629.38	204	0	0	0	extreme
3	72045362	72045806	MACS_peak_13588	714.62	444	0	0	1	extreme
3	72570604	72570807	MACS_peak_13589	629.38	203	0	0	0	extreme
3	72946282	72946416	MACS_peak_13591	1330.81	134	0	1	0	extreme
3	73191289	73191423	MACS_peak_13592	1072.4	134	0	0	0	extreme
3	87206746	87207061	MACS_peak_13715	1236.43	315	0	0	0	extreme
3	87298217	87298465	MACS_peak_13716	485.56	248	0	0	0	extreme
3	88005158	88005470	MACS_peak_13727	555.79	312	0	0	0	extreme
3	88203261	88203686	MACS_peak_13728	843.52	425	0	0	0	extreme
3	100186028	100186162	MACS_peak_13829	1666.76	134	0	0	1	extreme
3	100462934	100463215	MACS_peak_13831	561.46	281	0	0	0	extreme
3	100618116	100618408	MACS_peak_13834	84.4	292	0	1	0	extreme
3	101113863	101114295	MACS_peak_13835	137.06	432	0	0	0	extreme
3	101537486	101537702	MACS_peak_13837	133.76	216	0	0	0	extreme
3	101573598	101573960	MACS_peak_13838	770.64	362	1	0	0	extreme
3	101578776	101579120	MACS_peak_13839	722.05	344	0	0	0	extreme
3	101699554	101699805	MACS_peak_13840	540.72	251	0	0	0	extreme
3	107932683	107932923	MACS_peak_13895	936.57	240	0	0	0	extreme
3	108477685	108477907	MACS_peak_13900	549.18	222	0	1	0	extreme
3	111193901	111194069	MACS_peak_13926	814.37	168	0	1	0	extreme
3	111832838	111833224	MACS_peak_13929	349.84	386	0	2	0	extreme
3	112531379	112531649	MACS_peak_13936	830.22	270	1	0	0	extreme
3	112663671	112663982	MACS_peak_13937	71.7	311	0	0	0	extreme
3	112915369	112915614	MACS_peak_13940	179.63	245	0	0	0	extreme
3	113025477	113025828	MACS_peak_13941	415.79	351	0	0	1	extreme
3	113626690	113627141	MACS_peak_13944	1086.69	451	0	1	0	extreme
3	119387127	119387489	MACS_peak_13986	665.71	362	0	1	0	extreme
3	119690216	119690383	MACS_peak_13987	1264.23	167	0	0	0	extreme
3	120377132	120377486	MACS_peak_13994	78.38	354	0	0	1	extreme
3	120507282	120507605	MACS_peak_13995	429.98	323	0	0	0	extreme
3	120583387	120583682	MACS_peak_13998	115.76	295	0	0	0	extreme
3	120794997	120795361	MACS_peak_14001	524.01	364	0	0	0	extreme
3	122392926	122393342	MACS_peak_14018	496.62	416	0	1	0	extreme
3	122752467	122752843	MACS_peak_14019	403.97	376	0	1	0	extreme
3	122942951	122943183	MACS_peak_14021	532.66	232	0	1	0	extreme
3	123559077	123559357	MACS_peak_14026	707.43	280	0	1	0	extreme
3	124559929	124560203	MACS_peak_14035	582.68	274	0	1	0	extreme
3	124838023	124838222	MACS_peak_14036	645.81	199	0	1	0	extreme
3	124995439	124995705	MACS_peak_14038	463.44	266	0	1	0	extreme
3	127882633	127882765	MACS_peak_14064	665.1	132	0	1	0	extreme
3	128138921	128139125	MACS_peak_14065	893.54	204	0	1	0	extreme
3	128584488	128584926	MACS_peak_14069	599.79	438	0	0	0	extreme
3	128845958	128846147	MACS_peak_14072	695.57	189	0	0	0	extreme
3	129328750	129329108	MACS_peak_14073	368.21	358	0	0	0	extreme
3	129627842	129628218	MACS_peak_14074	464.3	376	0	0	0	extreme
3	130295004	130295411	MACS_peak_14083	137.06	407	0	0	0	extreme
3	130747171	130747467	MACS_peak_14086	93.4	296	0	0	0	extreme
3	131443954	131444089	MACS_peak_14091	1546.53	135	0	0	0	extreme
3	132376424	132376890	MACS_peak_14103	140.38	466	0	0	0	extreme
3	133562794	133563106	MACS_peak_14118	158.81	312	0	0	0	extreme
3	133723472	133723604	MACS_peak_14119	496.86	132	0	0	1	extreme
3	133727245	133727551	MACS_peak_14121	81.2	306	0	0	1	extreme
3	134096235	134096541	MACS_peak_14122	146.78	306	0	1	0	extreme
3	138068657	138068981	MACS_peak_14171	429.45	324	0	1	0	extreme
3	138594745	138595009	MACS_peak_14174	590.39	264	0	0	0	extreme
3	138744288	138744432	MACS_peak_14175	2140.36	144	0	1	0	extreme
3	138848064	138848200	MACS_peak_14176	954.83	136	0	0	0	extreme
3	142340360	142340678	MACS_peak_14204	388.29	318	0	1	0	extreme
3	142678419	142678729	MACS_peak_14205	51.39	310	0	1	0	extreme
3	148947308	148947670	MACS_peak_14262	900.06	362	0	0	1	extreme
3	148955557	148955748	MACS_peak_14263	866.35	191	0	0	1	extreme
3	149035649	149035787	MACS_peak_14264	630.2	138	0	1	0	extreme
3	149273190	149273498	MACS_peak_14265	950.21	308	0	0	1	extreme
3	150528602	150528839	MACS_peak_14284	654.12	237	0	0	0	extreme
3	150787812	150788015	MACS_peak_14286	814.37	203	0	0	0	extreme
3	150925725	150925934	MACS_peak_14288	613.04	209	1	1	2	extreme
3	155360772	155360981	MACS_peak_14338	596.67	209	0	0	0	extreme
3	155753104	155753359	MACS_peak_14343	729.14	255	0	0	0	extreme
3	155859921	155860301	MACS_peak_14344	545.6	380	0	0	0	extreme
3	160976806	160977142	MACS_peak_14406	68.11	336	0	1	0	extreme
3	169744716	169744897	MACS_peak_14501	662.55	181	0	0	0	extreme
3	170189238	170189457	MACS_peak_14503	729.14	219	0	0	0	extreme
3	170209619	170209785	MACS_peak_14505	579.03	166	0	0	0	extreme
3	170310178	170310478	MACS_peak_14506	790.3	300	0	0	0	extreme
3	170961370	170961757	MACS_peak_14520	603.02	387	0	0	0	extreme
3	179015425	179015786	MACS_peak_14581	397.74	361	1	0	0	extreme
3	179280766	179281062	MACS_peak_14582	349.84	296	0	0	0	extreme
3	180567433	180567672	MACS_peak_14601	284.38	239	0	0	1	extreme
3	181176710	181176887	MACS_peak_14605	763.02	177	0	0	1	extreme
3	182678425	182678557	MACS_peak_14611	1116.4	132	0	0	0	extreme
3	183031487	183031713	MACS_peak_14612	347.46	226	0	1	0	extreme
3	183469353	183469719	MACS_peak_14617	618.41	366	0	0	0	extreme
3	183738656	183738973	MACS_peak_14618	109.53	317	0	1	0	extreme
3	184129098	184129407	MACS_peak_14622	437.6	309	0	0	0	extreme
3	184250410	184250754	MACS_peak_14625	389.72	344	2	0	0	extreme
3	184468370	184468685	MACS_peak_14626	678.97	315	0	0	0	extreme
3	184697458	184697602	MACS_peak_14630	656.44	144	0	0	0	extreme
3	184748528	184748954	MACS_peak_14631	491.76	426	0	0	0	extreme
3	185569743	185569974	MACS_peak_14636	332.27	231	0	0	0	extreme
3	186540572	186540840	MACS_peak_14642	718.04	268	1	0	0	extreme
3	186614901	186615138	MACS_peak_14643	1282.94	237	1	0	1	extreme
3	189741607	189741815	MACS_peak_14676	459.7	208	0	1	0	extreme
3	189961507	189961807	MACS_peak_14677	442.68	300	0	0	0	extreme
3	193582493	193582863	MACS_peak_14704	520.65	370	0	1	1	extreme
3	194343894	194344254	MACS_peak_14709	901.78	360	1	0	0	extreme
3	194472231	194472599	MACS_peak_14710	894.97	368	0	1	0	extreme
3	194594723	194595094	MACS_peak_14711	1019.52	371	0	1	0	extreme
3	194914476	194914634	MACS_peak_14712	553.97	158	0	0	0	extreme
3	195215011	195215439	MACS_peak_14714	71.64	428	0	1	0	extreme
3	195994486	195994800	MACS_peak_14723	510.43	314	0	0	0	extreme
3	196537318	196537582	MACS_peak_14725	447.99	264	0	0	0	extreme
3	196609317	196609617	MACS_peak_14726	690.75	300	0	0	0	extreme
3	196837910	196838173	MACS_peak_14729	680.87	263	0	0	0	extreme
3	197156862	197157107	MACS_peak_14731	629.38	245	0	1	0	extreme
3	197665138	197665359	MACS_peak_14736	1396.21	221	0	0	1	extreme
3	197942981	197943313	MACS_peak_14738	1238.08	332	0	1	0	extreme
3	197992086	197992218	MACS_peak_14739	1116.4	132	0	1	0	extreme
3	198217743	198217980	MACS_peak_14748	929.7	237	0	0	1	extreme
4	21079	21471	MACS_peak_14749	844.39	392	0	0	0	extreme
4	259217	259454	MACS_peak_14752	775.87	237	0	0	0	extreme
4	602690	603014	MACS_peak_14753	801.19	324	0	0	0	extreme
4	1130608	1130925	MACS_peak_14755	413.23	317	0	0	2	extreme
4	1707048	1707379	MACS_peak_14758	181.92	331	0	1	0	extreme
4	2354240	2354498	MACS_peak_14760	488.85	258	0	1	0	extreme
4	3136360	3136723	MACS_peak_14761	524.58	363	0	1	0	extreme
4	4161244	4161716	MACS_peak_14767	568.39	472	0	0	0	extreme
4	4430703	4430900	MACS_peak_14768	662.31	197	0	1	0	extreme
4	5523319	5523717	MACS_peak_14779	104.01	398	0	0	0	extreme
4	6250734	6250993	MACS_peak_14781	594.37	259	0	0	0	extreme
4	6625932	6626167	MACS_peak_14782	1201.14	235	0	0	0	extreme
4	6654949	6655268	MACS_peak_14783	93.4	319	0	0	1	extreme
4	7844342	7844571	MACS_peak_14784	548.55	229	0	1	0	extreme
4	8407004	8407311	MACS_peak_14787	1065.38	307	0	1	0	extreme
4	8624930	8625380	MACS_peak_14788	732.96	450	0	0	0	extreme
4	12907141	12907515	MACS_peak_14855	53.29	374	0	0	0	extreme
4	13661382	13661727	MACS_peak_14856	76.3	345	0	0	1	extreme
4	15282233	15282483	MACS_peak_14879	60.61	250	0	0	1	extreme
4	17168941	17169107	MACS_peak_14888	810.9	166	0	0	0	extreme
4	17792649	17792953	MACS_peak_14890	56.38	304	0	0	0	extreme
4	17848850	17849210	MACS_peak_14891	207.85	360	0	1	0	extreme
4	24419526	24419751	MACS_peak_14931	712.32	225	0	0	0	extreme
4	24687448	24687690	MACS_peak_14932	1079.97	242	0	0	0	extreme
4	36976520	36976933	MACS_peak_14987	159.03	413	0	0	0	extreme
4	38675582	38675892	MACS_peak_14994	437.04	310	0	1	0	extreme
4	38860949	38861164	MACS_peak_14995	596.79	215	0	0	0	extreme
4	41888126	41888520	MACS_peak_15006	873.84	394	0	0	1	extreme
4	42275053	42275398	MACS_peak_15008	76.3	345	0	0	0	extreme
4	47283258	47283407	MACS_peak_15032	689.09	149	0	1	0	extreme
4	47668828	47669101	MACS_peak_15035	713.56	273	0	1	0	extreme
4	48649009	48649260	MACS_peak_15039	485.56	251	0	1	0	extreme
4	48943830	48944110	MACS_peak_15040	722.05	280	0	0	0	extreme
4	51985843	51986191	MACS_peak_15081	91.29	348	0	0	0	extreme
4	52167814	52168021	MACS_peak_15082	178.91	207	0	0	0	extreme
4	53331476	53331875	MACS_peak_15090	97.64	399	0	1	0	extreme
4	54063079	54063282	MACS_peak_15098	629.38	203	0	2	0	extreme
4	55046399	55046621	MACS_peak_15102	119.34	222	0	0	0	extreme
4	55845287	55845572	MACS_peak_15108	79.96	285	0	0	0	extreme
4	56303186	56303368	MACS_peak_15109	687.62	182	0	1	0	extreme
4	56685989	56686245	MACS_peak_15111	470.06	256	0	0	0	extreme
4	56960345	56960511	MACS_peak_15114	810.9	166	1	1	0	extreme
4	57164059	57164304	MACS_peak_15115	501.16	245	0	0	1	extreme
4	67327311	67327546	MACS_peak_15178	456.86	235	0	0	0	extreme
4	67657438	67657814	MACS_peak_15180	130.59	376	0	1	0	extreme
4	74019135	74019538	MACS_peak_15225	514.14	403	0	0	0	extreme
4	74134374	74134565	MACS_peak_15226	850.54	191	0	1	0	extreme
4	75468833	75469227	MACS_peak_15240	469.92	394	0	0	0	extreme
4	75533916	75534203	MACS_peak_15242	202.06	287	0	1	0	extreme
4	75848370	75848649	MACS_peak_15244	1123.24	279	0	0	0	extreme
4	75916582	75916914	MACS_peak_15245	611.86	332	1	0	0	extreme
4	76511128	76511394	MACS_peak_15246	719.85	266	0	1	0	extreme
4	82300427	82300861	MACS_peak_15284	101.68	434	0	0	1	extreme
4	82909290	82909545	MACS_peak_15288	470.06	255	1	1	0	extreme
4	83401087	83401418	MACS_peak_15294	82.43	331	0	0	0	extreme
4	83639936	83640260	MACS_peak_15295	429.45	324	0	0	0	extreme
4	84524588	84525000	MACS_peak_15299	101.39	412	0	0	0	extreme
4	88161759	88161977	MACS_peak_15327	76.21	218	0	1	0	extreme
4	88602374	88602543	MACS_peak_15329	1243.44	169	0	2	0	extreme
4	93791645	93791885	MACS_peak_15367	645.81	240	0	1	0	extreme
4	94406743	94406993	MACS_peak_15368	726.99	250	0	0	0	extreme
4	98725666	98726030	MACS_peak_15399	107.27	364	0	0	0	extreme
4	99116169	99116482	MACS_peak_15401	108.02	313	0	0	1	extreme
4	99462929	99463275	MACS_peak_15403	481.23	346	0	0	0	extreme
4	100093399	100093661	MACS_peak_15404	466.05	262	0	0	1	extreme
4	100382946	100383309	MACS_peak_15406	80.08	363	0	0	0	extreme
4	102701574	102701920	MACS_peak_15424	68.2	346	0	1	0	extreme
4	102952214	102952511	MACS_peak_15425	63.25	297	0	1	0	extreme
4	105561374	105561584	MACS_peak_15440	597.38	210	0	1	0	extreme
4	107556202	107556510	MACS_peak_15453	953.02	308	0	0	0	extreme
4	108009966	108010103	MACS_peak_15454	1420.82	137	0	1	0	extreme
4	108438083	108438357	MACS_peak_15457	108.84	274	0	0	0	extreme
4	108810264	108810472	MACS_peak_15458	780.06	208	1	0	0	extreme
4	109894950	109895273	MACS_peak_15461	59.66	323	0	0	0	extreme
4	112088757	112089119	MACS_peak_15485	86.52	362	0	0	0	extreme
4	112482821	112483266	MACS_peak_15486	114.09	445	0	0	0	extreme
4	118539307	118539664	MACS_peak_15516	468.18	357	0	0	1	extreme
4	119043935	119044073	MACS_peak_15517	1043.77	138	0	1	0	extreme
4	120045902	120046037	MACS_peak_15523	1717.19	135	0	0	0	extreme
4	120121676	120121896	MACS_peak_15524	734.14	220	0	0	1	extreme
4	121370705	121371026	MACS_peak_15534	549.92	321	0	1	0	extreme
4	122110982	122111360	MACS_peak_15535	87.93	378	0	0	0	extreme
4	122652373	122652750	MACS_peak_15539	284.37	377	0	0	1	extreme
4	123512379	123512594	MACS_peak_15546	66.31	215	0	0	2	extreme
4	127851697	127851924	MACS_peak_15566	736.56	227	0	0	0	extreme
4	128897309	128897685	MACS_peak_15567	118.57	376	0	1	0	extreme
4	138860397	138860780	MACS_peak_15613	178.37	383	0	0	1	extreme
4	139619709	139619916	MACS_peak_15614	1134.69	207	0	0	1	extreme
4	139944617	139944991	MACS_peak_15616	57.86	374	0	1	0	extreme
4	140884497	140884793	MACS_peak_15620	445	296	0	1	0	extreme
4	143449180	143449562	MACS_peak_15633	52.41	382	0	1	0	extreme
4	143659434	143659854	MACS_peak_15634	61.72	420	0	1	1	extreme
4	144811202	144811578	MACS_peak_15644	58.28	376	0	1	1	extreme
4	145378121	145378476	MACS_peak_15646	106.53	355	0	0	0	extreme
4	146668709	146669122	MACS_peak_15654	69.82	413	0	0	0	extreme
4	147470215	147470516	MACS_peak_15662	203.85	301	0	0	0	extreme
4	147708220	147708618	MACS_peak_15663	1048.74	398	0	0	0	extreme
4	150559672	150560034	MACS_peak_15687	896.32	362	0	1	0	extreme
4	151198289	151198520	MACS_peak_15688	483.43	231	0	1	0	extreme
4	152631692	152631940	MACS_peak_15692	389.4	248	0	1	0	extreme
4	152922121	152922388	MACS_peak_15693	67.03	267	0	0	0	extreme
4	152923131	152923438	MACS_peak_15694	59.31	307	0	0	0	extreme
4	154104257	154104547	MACS_peak_15695	63.52	290	0	0	0	extreme
4	155031579	155031832	MACS_peak_15701	302.07	253	0	0	0	extreme
4	155861588	155861795	MACS_peak_15703	613.04	207	0	2	0	extreme
4	156617835	156618113	MACS_peak_15707	455.81	278	0	0	0	extreme
4	156983347	156983701	MACS_peak_15709	529.74	354	0	0	0	extreme
4	157355810	157356179	MACS_peak_15710	894.13	369	0	1	0	extreme
4	158089601	158089913	MACS_peak_15711	102.99	312	0	0	0	extreme
4	158479354	158479558	MACS_peak_15712	343.13	204	0	1	0	extreme
4	162695869	162696318	MACS_peak_15739	506.92	449	0	0	0	extreme
4	163548540	163548820	MACS_peak_15740	454.58	280	0	1	0	extreme
4	167707941	167708320	MACS_peak_15772	56.38	379	0	0	0	extreme
4	169810235	169810590	MACS_peak_15776	529.16	355	0	0	0	extreme
4	173268334	173268553	MACS_peak_15796	729.14	219	0	1	0	extreme
4	173483100	173483362	MACS_peak_15797	466.05	262	0	0	0	extreme
4	174089542	174089704	MACS_peak_15805	1074.92	162	0	0	0	extreme
4	176983709	176983852	MACS_peak_15825	1264.23	143	0	0	0	extreme
4	177587425	177587701	MACS_peak_15826	457.06	276	0	0	1	extreme
4	182935408	182935755	MACS_peak_15838	63.89	347	0	0	0	extreme
4	184759530	184759847	MACS_peak_15839	63.13	317	1	0	0	extreme
4	186044580	186044894	MACS_peak_15840	210.76	314	0	0	0	extreme
4	186362959	186363275	MACS_peak_15841	553.16	316	0	0	1	extreme
4	190104818	190105166	MACS_peak_15850	404.2	348	0	0	0	extreme
5	21682	21940	MACS_peak_15858	626.84	258	0	0	0	extreme
5	188472	188800	MACS_peak_15860	427.34	328	1	1	0	extreme
5	650037	650389	MACS_peak_15861	229.83	352	0	1	0	extreme
5	903171	903433	MACS_peak_15862	1002.15	262	0	1	0	extreme
5	1307679	1307923	MACS_peak_15865	501.16	244	0	0	0	extreme
5	1641653	1641943	MACS_peak_15866	586.2	290	0	0	0	extreme
5	1713299	1713676	MACS_peak_15869	87.64	377	0	0	0	extreme
5	2146201	2146543	MACS_peak_15873	208.27	342	0	0	0	extreme
5	3057010	3057227	MACS_peak_15875	496.96	217	0	0	0	extreme
5	4862623	4862918	MACS_peak_15881	567.38	295	0	0	1	extreme
5	5680904	5681121	MACS_peak_15883	580.62	217	0	0	0	extreme
5	6647227	6647512	MACS_peak_15884	158.81	285	0	1	0	extreme
5	6765740	6766080	MACS_peak_15885	660.56	340	0	0	0	extreme
5	7839853	7840033	MACS_peak_15892	701.06	180	0	1	0	extreme
5	10060065	10060279	MACS_peak_15904	746.04	214	0	0	0	extreme
5	10249796	10250027	MACS_peak_15905	1377.45	231	1	0	0	extreme
5	10347393	10347779	MACS_peak_15907	511.95	386	0	0	0	extreme
5	10452772	10452976	MACS_peak_15908	1171.45	204	0	1	0	extreme
5	16022973	16023153	MACS_peak_15935	644.42	180	0	0	0	extreme
5	31232377	31232565	MACS_peak_16038	695.57	188	0	1	1	extreme
5	31929293	31929580	MACS_peak_16039	380.3	287	0	1	0	extreme
5	32418030	32418366	MACS_peak_16040	178.37	336	0	1	0	extreme
5	34780088	34780450	MACS_peak_16059	50.92	362	0	1	0	extreme
5	35003456	35003683	MACS_peak_16060	548.55	227	0	1	0	extreme
5	35713759	35714041	MACS_peak_16071	440.04	282	0	1	1	extreme
5	36474934	36475283	MACS_peak_16073	112.75	349	0	0	0	extreme
5	36870537	36870923	MACS_peak_16077	752.99	386	0	0	1	extreme
5	37098384	37098631	MACS_peak_16082	369	247	0	0	0	extreme
5	40736412	40736647	MACS_peak_16101	1134.69	235	0	1	0	extreme
5	40856485	40856964	MACS_peak_16102	117.8	479	0	1	0	extreme
5	41843554	41843855	MACS_peak_16111	262.32	301	0	1	0	extreme
5	42221923	42222055	MACS_peak_16113	1116.4	132	0	0	0	extreme
5	42662498	42662795	MACS_peak_16118	87.33	297	0	1	0	extreme
5	42889382	42889643	MACS_peak_16120	860.98	261	0	0	0	extreme
5	43056270	43056609	MACS_peak_16127	106.26	339	0	0	1	extreme
5	43389739	43390075	MACS_peak_16131	540.49	336	0	1	0	extreme
5	43670339	43670551	MACS_peak_16132	209.52	212	0	1	0	extreme
5	50380269	50380587	MACS_peak_16209	114.74	318	0	0	0	extreme
5	50498792	50499172	MACS_peak_16210	64.17	380	0	0	0	extreme
5	50512995	50513341	MACS_peak_16211	488.85	346	0	0	0	extreme
5	50963037	50963284	MACS_peak_16213	389.4	247	0	0	0	extreme
5	52973897	52974240	MACS_peak_16223	154.62	343	0	0	1	extreme
5	53146240	53146570	MACS_peak_16225	72.48	330	0	0	0	extreme
5	53280338	53280589	MACS_peak_16226	59.77	251	0	0	0	extreme
5	53662103	53662411	MACS_peak_16227	64.74	308	0	1	0	extreme
5	55077468	55077830	MACS_peak_16238	164.26	362	0	0	1	extreme
5	56891799	56892176	MACS_peak_16250	62.6	377	0	1	0	extreme
5	58220660	58220989	MACS_peak_16256	96.08	329	0	0	0	extreme
5	58553249	58553615	MACS_peak_16257	87.75	366	0	0	1	extreme
5	60318309	60318628	MACS_peak_16273	102.16	319	0	1	0	extreme
5	60862806	60863179	MACS_peak_16276	89.75	373	0	0	0	extreme
5	60960589	60961026	MACS_peak_16277	718.97	437	0	1	0	extreme
5	61768759	61768971	MACS_peak_16279	596.79	212	0	0	0	extreme
5	62225048	62225377	MACS_peak_16283	335.28	329	0	0	0	extreme
5	64712847	64713138	MACS_peak_16300	56.46	291	0	1	0	extreme
5	65165744	65166136	MACS_peak_16303	102.68	392	0	1	0	extreme
5	65696610	65696842	MACS_peak_16305	532.66	232	0	1	0	extreme
5	66386595	66386806	MACS_peak_16310	111.64	211	0	0	0	extreme
5	69024188	69024502	MACS_peak_16334	434.84	314	0	0	1	extreme
5	69629633	69629837	MACS_peak_16336	182.8	204	0	0	0	extreme
5	70784177	70784538	MACS_peak_16374	64.91	361	0	0	1	extreme
5	71032452	71032692	MACS_peak_16375	457.25	240	1	0	0	extreme
5	71851849	71852132	MACS_peak_16387	106.51	283	0	0	0	extreme
5	72532183	72532521	MACS_peak_16388	721.05	338	0	0	0	extreme
5	73469047	73469417	MACS_peak_16397	128.68	370	0	0	1	extreme
5	73792783	73793024	MACS_peak_16398	797.18	241	0	1	0	extreme
5	74746454	74746679	MACS_peak_16402	844.95	225	0	1	0	extreme
5	74903509	74903769	MACS_peak_16403	441.71	260	0	0	0	extreme
5	75265747	75266042	MACS_peak_16406	694.81	295	0	0	0	extreme
5	75681344	75681588	MACS_peak_16407	918.92	244	0	1	0	extreme
5	76836706	76836896	MACS_peak_16420	830.25	190	0	0	0	extreme
5	77107211	77107452	MACS_peak_16421	438.69	241	0	2	1	extreme
5	81108501	81108697	MACS_peak_16459	827.89	196	0	1	0	extreme
5	81595506	81595928	MACS_peak_16460	147.82	422	0	1	0	extreme
5	83461871	83462243	MACS_peak_16474	62.22	372	0	0	0	extreme
5	83718269	83718486	MACS_peak_16475	1079.97	217	0	1	0	extreme
5	86501870	86502119	MACS_peak_16496	485.56	249	0	0	0	extreme
5	86665423	86665782	MACS_peak_16497	312.33	359	0	0	0	extreme
5	94019003	94019343	MACS_peak_16549	186.49	340	0	1	0	extreme
5	95201379	95201527	MACS_peak_16559	911.89	148	0	1	0	extreme
5	95847116	95847409	MACS_peak_16560	568.79	293	0	0	1	extreme
5	97017048	97017404	MACS_peak_16567	413.31	356	0	1	0	extreme
5	97213307	97213559	MACS_peak_16568	883.81	252	0	0	1	extreme
5	103065889	103066026	MACS_peak_16633	914.41	137	0	0	0	extreme
5	103256305	103256499	MACS_peak_16634	678.9	194	1	0	0	extreme
5	109163086	109163262	MACS_peak_16663	763.02	176	0	1	0	extreme
5	109602713	109602882	MACS_peak_16666	151.54	169	0	0	0	extreme
5	114675471	114675894	MACS_peak_16702	54.47	423	0	0	0	extreme
5	115298007	115298395	MACS_peak_16703	180.31	388	0	0	0	extreme
5	115603783	115603916	MACS_peak_16705	1087.62	133	0	1	1	extreme
5	115679139	115679572	MACS_peak_16706	106.71	433	0	0	0	extreme
5	115690984	115691305	MACS_peak_16707	93.4	321	0	0	0	extreme
5	119021983	119022176	MACS_peak_16731	647.86	193	0	0	1	extreme
5	121951371	121951636	MACS_peak_16749	75.5	265	0	0	0	extreme
5	122210026	122210330	MACS_peak_16750	76.3	304	0	0	0	extreme
5	122914451	122914670	MACS_peak_16757	219.2	219	0	1	0	extreme
5	123279212	123279417	MACS_peak_16758	629.38	205	0	0	0	extreme
5	126739462	126739879	MACS_peak_16784	832.49	417	0	0	0	extreme
5	127267988	127268291	MACS_peak_16785	62.38	303	0	0	0	extreme
5	127492969	127493270	MACS_peak_16786	563.21	301	0	0	0	extreme
5	127573030	127573260	MACS_peak_16787	532.66	230	0	0	0	extreme
5	131110072	131110257	MACS_peak_16810	675.42	185	0	0	0	extreme
5	132283464	132283726	MACS_peak_16823	466.05	262	0	1	0	extreme
5	132982491	132982791	MACS_peak_16824	178.37	300	0	0	0	extreme
5	133944300	133944631	MACS_peak_16832	490.28	331	0	0	0	extreme
5	134026637	134026880	MACS_peak_16833	346.41	243	0	0	0	extreme
5	134083169	134083312	MACS_peak_16835	2430.3	143	0	0	0	extreme
5	134184082	134184478	MACS_peak_16836	488.85	396	0	1	0	extreme
5	134321002	134321134	MACS_peak_16837	1028.85	132	0	1	1	extreme
5	134480548	134480823	MACS_peak_16838	265.34	275	0	0	1	extreme
5	135191425	135191611	MACS_peak_16839	676.7	186	0	0	1	extreme
5	135553961	135554165	MACS_peak_16840	616.96	204	0	0	0	extreme
5	135830185	135830404	MACS_peak_16842	729.14	219	0	1	0	extreme
5	138036097	138036270	MACS_peak_16858	780.06	173	0	1	1	extreme
5	138645128	138645493	MACS_peak_16864	409.04	365	0	1	0	extreme
5	139517957	139518124	MACS_peak_16870	768.86	167	0	0	0	extreme
5	140073238	140073526	MACS_peak_16878	572.35	288	0	0	1	extreme
5	140357728	140357963	MACS_peak_16879	516.86	235	1	0	0	extreme
5	141100126	141100436	MACS_peak_16883	437.04	310	1	0	0	extreme
5	141564155	141564511	MACS_peak_16891	1605.51	356	0	1	1	extreme
5	142151885	142152147	MACS_peak_16893	859.93	262	0	1	0	extreme
5	142351705	142352049	MACS_peak_16895	915.87	344	0	0	1	extreme
5	142866972	142867352	MACS_peak_16896	402.16	380	0	1	1	extreme
5	143968120	143968414	MACS_peak_16902	380.3	294	0	0	0	extreme
5	144299273	144299616	MACS_peak_16903	419.68	343	0	1	0	extreme
5	145903206	145903404	MACS_peak_16921	808.21	198	0	1	0	extreme
5	146622526	146622738	MACS_peak_16924	596.79	212	0	1	0	extreme
5	148360671	148361107	MACS_peak_16936	63.13	436	0	0	1	extreme
5	148615272	148615545	MACS_peak_16937	56.27	273	0	1	0	extreme
5	149990777	149991091	MACS_peak_16952	809.85	314	1	1	0	extreme
5	150561089	150561292	MACS_peak_16954	629.38	203	0	0	0	extreme
5	153974421	153974683	MACS_peak_16988	528.22	262	0	0	0	extreme
5	154795852	154796206	MACS_peak_16994	776.79	354	0	1	0	extreme
5	157477041	157477205	MACS_peak_17020	972.46	164	0	1	0	extreme
5	159881176	159881427	MACS_peak_17030	810.91	251	0	1	1	extreme
5	160080882	160081263	MACS_peak_17032	406.81	381	0	1	0	extreme
5	160438363	160438643	MACS_peak_17033	578.19	280	0	0	0	extreme
5	163779775	163779997	MACS_peak_17059	85.48	222	0	0	0	extreme
5	168219883	168220064	MACS_peak_17079	1134.69	181	0	1	0	extreme
5	168679551	168679874	MACS_peak_17080	429.98	323	0	1	0	extreme
5	169581693	169581956	MACS_peak_17082	452.06	263	1	0	0	extreme
5	170267913	170268129	MACS_peak_17088	580.62	216	0	1	0	extreme
5	170420900	170421163	MACS_peak_17089	722.6	263	0	1	1	extreme
5	171630166	171630360	MACS_peak_17096	678.9	194	0	0	0	extreme
5	172451264	172451508	MACS_peak_17103	629.38	244	0	1	0	extreme
5	172478957	172479231	MACS_peak_17105	458.32	274	0	0	0	extreme
5	172854218	172854399	MACS_peak_17106	746.04	181	0	1	0	extreme
5	172939104	172939339	MACS_peak_17107	662.31	235	0	1	0	extreme
5	172978798	172979029	MACS_peak_17108	527.71	231	1	0	0	extreme
5	176327445	176327646	MACS_peak_17128	588.69	201	0	1	0	extreme
5	176434516	176434892	MACS_peak_17129	93.4	376	0	0	0	extreme
5	177113955	177114160	MACS_peak_17135	1418.09	205	0	0	0	extreme
5	177309704	177309985	MACS_peak_17137	453.96	281	0	1	0	extreme
5	177456386	177456629	MACS_peak_17139	936.57	243	1	0	0	extreme
5	177757644	177757933	MACS_peak_17140	56.85	289	0	1	0	extreme
5	178075972	178076349	MACS_peak_17145	403.51	377	0	0	0	extreme
5	178551137	178551376	MACS_peak_17147	628.77	239	0	1	0	extreme
5	179634446	179634695	MACS_peak_17149	547.91	249	0	1	0	extreme
5	179657850	179658099	MACS_peak_17150	588.38	249	0	0	1	extreme
5	179993717	179994011	MACS_peak_17152	67.82	294	0	1	0	extreme
5	180670627	180670809	MACS_peak_17157	729.14	182	0	0	0	extreme
5	180896638	180896973	MACS_peak_17158	180.31	335	1	0	0	extreme
5	181091222	181091647	MACS_peak_17161	217.12	425	0	0	0	extreme
5	181176137	181176283	MACS_peak_17162	1334.07	146	0	0	0	extreme
5	181319914	181320151	MACS_peak_17164	821.39	237	0	0	1	extreme
5	181462769	181463175	MACS_peak_17174	1207.95	406	0	0	0	extreme
6	188743	189073	MACS_peak_17180	426.3	330	0	0	1	extreme
6	460676	460948	MACS_peak_17181	488.85	272	0	0	0	extreme
6	797580	797786	MACS_peak_17188	629.38	206	0	0	0	extreme
6	2738457	2738722	MACS_peak_17206	932.22	265	0	1	0	extreme
6	3863989	3864385	MACS_peak_17211	87.62	396	0	0	1	extreme
6	4210776	4211090	MACS_peak_17212	434.84	314	0	0	0	extreme
6	4864079	4864465	MACS_peak_17216	603.02	386	0	1	0	extreme
6	7243530	7243942	MACS_peak_17235	735.11	412	0	1	0	extreme
6	7718300	7718473	MACS_peak_17237	1109.31	173	0	0	0	extreme
6	8253903	8254228	MACS_peak_17240	547.36	325	0	0	2	extreme
6	10582111	10582502	MACS_peak_17254	509.31	391	0	1	0	extreme
6	11044492	11044677	MACS_peak_17259	901.33	185	0	0	1	extreme
6	11455020	11455392	MACS_peak_17260	80.18	372	0	0	1	extreme
6	11456572	11456953	MACS_peak_17261	105.65	381	0	0	1	extreme
6	12911337	12911648	MACS_peak_17273	436.49	311	0	1	0	extreme
6	13867440	13867768	MACS_peak_17274	776.53	328	0	0	0	extreme
6	17585708	17586079	MACS_peak_17295	892.45	371	0	0	0	extreme
6	18324274	18324489	MACS_peak_17296	596.79	215	0	0	0	extreme
6	21364175	21364533	MACS_peak_17316	132.14	358	0	0	0	extreme
6	21999618	21999871	MACS_peak_17317	470.06	253	0	0	1	extreme
6	24389284	24389509	MACS_peak_17328	324.92	225	0	0	0	extreme
6	24942761	24943054	MACS_peak_17329	88.97	293	0	1	0	extreme
6	25657926	25658127	MACS_peak_17333	252.32	201	0	1	0	extreme
6	26205122	26205308	MACS_peak_17334	858.56	186	1	0	0	extreme
6	26248840	26248977	MACS_peak_17335	1162.25	137	3	0	0	extreme
6	26572649	26572906	MACS_peak_17336	469.39	257	0	0	1	extreme
6	27100412	27100608	MACS_peak_17342	451.06	196	0	0	0	extreme
6	27161908	27162280	MACS_peak_17343	891.62	372	0	0	0	extreme
6	27792172	27792552	MACS_peak_17350	265.34	380	0	0	0	extreme
6	28055418	28055783	MACS_peak_17351	507.59	365	0	0	0	extreme
6	28491101	28491371	MACS_peak_17352	460.86	270	0	0	0	extreme
6	28854008	28854293	MACS_peak_17354	122.91	285	0	0	0	extreme
6	29113347	29113588	MACS_peak_17355	351.25	241	0	1	0	extreme
6	29653452	29653766	MACS_peak_17360	434.84	314	1	0	0	extreme
6	29753021	29753406	MACS_peak_17361	753.71	385	0	0	1	extreme
6	29834926	29835144	MACS_peak_17363	901.33	218	0	0	0	extreme
6	30013433	30013651	MACS_peak_17364	729.14	218	0	0	1	extreme
6	30037261	30037571	MACS_peak_17365	813.39	310	0	0	1	extreme
6	30116816	30116949	MACS_peak_17366	1098.16	133	0	0	0	extreme
6	30131048	30131338	MACS_peak_17367	1254.18	290	0	0	0	extreme
6	30544733	30544955	MACS_peak_17368	564.54	222	1	0	0	extreme
6	30678863	30679236	MACS_peak_17369	518.99	373	1	0	0	extreme
6	30722685	30723043	MACS_peak_17370	903.5	358	1	0	0	extreme
6	31137441	31137710	MACS_peak_17377	911.65	269	2	1	0	extreme
6	31397001	31397264	MACS_peak_17379	575.16	263	1	0	0	extreme
6	31493705	31494035	MACS_peak_17381	426.3	330	1	0	0	extreme
6	32087679	32087881	MACS_peak_17386	814.37	202	0	1	0	extreme
6	32259763	32260116	MACS_peak_17387	69	353	0	0	1	extreme
6	32415339	32415723	MACS_peak_17390	881.79	384	0	0	0	extreme
6	32692047	32692484	MACS_peak_17391	538.64	437	0	0	0	extreme
6	33484558	33484924	MACS_peak_17393	72.96	366	0	0	0	extreme
6	34258405	34258764	MACS_peak_17394	339.44	359	0	0	1	extreme
6	34609636	34609884	MACS_peak_17395	712.61	248	0	1	0	extreme
6	35146481	35146655	MACS_peak_17397	780.06	174	0	1	0	extreme
6	35560358	35560559	MACS_peak_17402	755.27	201	0	0	0	extreme
6	36360532	36360797	MACS_peak_17408	589.61	265	0	1	0	extreme
6	36429036	36429414	MACS_peak_17409	403.06	378	0	1	0	extreme
6	36623491	36623750	MACS_peak_17410	468.05	259	0	0	0	extreme
6	36759228	36759415	MACS_peak_17411	901.33	187	0	1	0	extreme
6	37044490	37044717	MACS_peak_17412	548.55	227	0	0	0	extreme
6	37382973	37383211	MACS_peak_17418	516.86	238	0	1	0	extreme
6	37860279	37860561	MACS_peak_17419	1235.43	282	0	1	0	extreme
6	38872040	38872302	MACS_peak_17423	1145.01	262	0	1	0	extreme
6	39578218	39578352	MACS_peak_17424	1630.94	134	0	1	0	extreme
6	41066871	41067146	MACS_peak_17433	457.69	275	0	1	0	extreme
6	41368756	41369227	MACS_peak_17434	1910.74	471	0	0	0	extreme
6	41683712	41683902	MACS_peak_17435	695.57	190	1	0	0	extreme
6	42726642	42726911	MACS_peak_17438	448.17	269	0	0	0	extreme
6	43129900	43130062	MACS_peak_17441	848.95	162	0	1	0	extreme
6	43470871	43471147	MACS_peak_17442	239.85	276	0	0	0	extreme
6	44313323	44313497	MACS_peak_17444	780.06	174	0	1	0	extreme
6	46090189	46090468	MACS_peak_17453	578.93	279	0	0	0	extreme
6	46221266	46221597	MACS_peak_17455	337.29	331	1	0	0	extreme
6	46514577	46514981	MACS_peak_17456	1128.3	404	0	0	1	extreme
6	46781521	46781775	MACS_peak_17457	596.79	254	0	0	0	extreme
6	52839623	52839910	MACS_peak_17505	573.07	287	0	1	0	extreme
6	56904610	56904865	MACS_peak_17550	543.04	255	0	1	0	extreme
6	57268111	57268447	MACS_peak_17551	133.43	336	0	0	0	extreme
6	62781894	62782287	MACS_peak_17585	1138.75	393	0	0	0	extreme
6	63316365	63316781	MACS_peak_17586	496.62	416	0	1	0	extreme
6	63547382	63547534	MACS_peak_17589	602.31	152	0	1	0	extreme
6	64012165	64012574	MACS_peak_17590	500.09	409	0	1	0	extreme
6	73326508	73326904	MACS_peak_17652	453.78	396	0	0	0	extreme
6	73675550	73675789	MACS_peak_17653	516.86	239	0	0	0	extreme
6	75186103	75186335	MACS_peak_17670	678.9	232	0	1	0	extreme
6	79956898	79957122	MACS_peak_17717	175.61	224	0	0	0	extreme
6	80138610	80138912	MACS_peak_17718	55.69	302	0	1	0	extreme
6	81581699	81582052	MACS_peak_17731	96.22	353	0	1	0	extreme
6	83055327	83055699	MACS_peak_17740	294.26	372	0	1	0	extreme
6	83334214	83334662	MACS_peak_17741	62.17	448	0	1	0	extreme
6	83801641	83801865	MACS_peak_17743	119.34	224	0	0	0	extreme
6	85483043	85483442	MACS_peak_17760	869.94	399	0	1	0	extreme
6	85894350	85894662	MACS_peak_17763	50.75	312	0	0	0	extreme
6	87324848	87325104	MACS_peak_17780	64.69	256	1	1	0	extreme
6	87708762	87709103	MACS_peak_17783	137.06	341	0	0	0	extreme
6	88422883	88423105	MACS_peak_17790	564.54	222	0	0	0	extreme
6	89368160	89368468	MACS_peak_17797	815.17	308	1	0	0	extreme
6	90056011	90056357	MACS_peak_17800	148.5	346	0	1	0	extreme
6	90286914	90287195	MACS_peak_17801	706.57	281	0	1	0	extreme
6	90951577	90951828	MACS_peak_17802	746.04	251	0	0	0	extreme
6	96445832	96446022	MACS_peak_17829	485.67	190	0	0	1	extreme
6	96655214	96655366	MACS_peak_17830	201.93	152	0	0	0	extreme
6	99007934	99008248	MACS_peak_17843	262.07	314	0	0	0	extreme
6	99330140	99330385	MACS_peak_17847	612.68	245	0	1	0	extreme
6	99654513	99654848	MACS_peak_17850	70.79	335	0	0	0	extreme
6	100457937	100458154	MACS_peak_17860	746.04	217	0	1	0	extreme
6	104668295	104668500	MACS_peak_17889	1134.84	205	0	0	0	extreme
6	105246429	105246847	MACS_peak_17892	160.82	418	0	0	0	extreme
6	105403497	105403791	MACS_peak_17893	488.85	294	0	0	0	extreme
6	105683823	105684172	MACS_peak_17894	160.72	349	0	0	1	extreme
6	106360348	106360610	MACS_peak_17896	452.71	262	1	0	0	extreme
6	106423592	106423957	MACS_peak_17897	229.83	365	0	1	0	extreme
6	106839667	106840048	MACS_peak_17898	380.3	381	0	0	0	extreme
6	106997664	106997965	MACS_peak_17899	821.52	301	0	0	0	extreme
6	108526679	108526986	MACS_peak_17904	951.22	307	0	0	0	extreme
6	109194228	109194516	MACS_peak_17905	178.37	288	0	0	1	extreme
6	110056385	110056536	MACS_peak_17913	1813.76	151	0	0	0	extreme
6	110454519	110454942	MACS_peak_17916	722.05	423	0	1	0	extreme
6	110473395	110473543	MACS_peak_17917	698.1	148	0	1	0	extreme
6	110949783	110950102	MACS_peak_17919	934.53	319	0	0	0	extreme
6	111057362	111057676	MACS_peak_17921	1516.12	314	0	0	0	extreme
6	111913692	111914044	MACS_peak_17924	415.24	352	0	0	0	extreme
6	113909364	113909587	MACS_peak_17936	712.32	223	0	0	1	extreme
6	115848751	115848924	MACS_peak_17946	760.34	173	0	0	0	extreme
6	116268598	116268949	MACS_peak_17948	779.13	351	0	1	0	extreme
6	116350037	116350272	MACS_peak_17949	447.22	235	0	1	0	extreme
6	116561300	116561682	MACS_peak_17951	401.26	382	0	0	0	extreme
6	116816446	116816756	MACS_peak_17952	125.66	310	0	1	0	extreme
6	117346219	117346442	MACS_peak_17959	712.32	223	0	2	0	extreme
6	117821699	117821857	MACS_peak_17960	279.72	158	0	0	0	extreme
6	118796900	118797277	MACS_peak_17965	141.38	377	0	0	0	extreme
6	118962977	118963256	MACS_peak_17966	455.19	279	1	0	1	extreme
6	122381566	122381914	MACS_peak_17988	177.74	348	0	0	0	extreme
6	122475982	122476423	MACS_peak_17990	695.38	441	1	0	1	extreme
6	125314137	125314378	MACS_peak_18011	571.15	241	0	0	0	extreme
6	125773433	125773582	MACS_peak_18014	1035.47	149	0	0	0	extreme
6	127190581	127190910	MACS_peak_18021	426.82	329	0	1	0	extreme
6	127339206	127339460	MACS_peak_18022	596.79	254	0	1	0	extreme
6	129730583	129730844	MACS_peak_18041	466.72	261	0	0	0	extreme
6	131460067	131460368	MACS_peak_18052	442.11	301	0	0	0	extreme
6	131628212	131628496	MACS_peak_18053	575.25	284	1	0	0	extreme
6	131915117	131915535	MACS_peak_18055	1828.14	418	0	0	1	extreme
6	132218139	132218389	MACS_peak_18056	485.56	250	0	0	0	extreme
6	132578558	132578759	MACS_peak_18059	645.81	201	0	0	0	extreme
6	132929001	132929295	MACS_peak_18060	265.34	294	0	0	0	extreme
6	137615678	137615889	MACS_peak_18101	596.79	211	0	0	0	extreme
6	137939850	137940222	MACS_peak_18102	405.79	372	0	0	0	extreme
6	138109494	138109742	MACS_peak_18104	613.04	248	0	0	0	extreme
6	138692263	138692517	MACS_peak_18105	470.06	254	0	1	0	extreme
6	138816159	138816412	MACS_peak_18107	682.16	253	0	1	0	extreme
6	139213292	139213602	MACS_peak_18108	56.49	310	0	0	2	extreme
6	143427186	143427545	MACS_peak_18135	647.47	359	1	0	0	extreme
6	143941977	143942380	MACS_peak_18136	503.12	403	1	0	0	extreme
6	144013496	144013744	MACS_peak_18137	813.44	248	0	1	0	extreme
6	144216168	144216552	MACS_peak_18138	513.02	384	0	0	0	extreme
6	145299900	145300213	MACS_peak_18140	69	313	0	0	1	extreme
6	146522885	146523189	MACS_peak_18146	92.72	304	0	0	0	extreme
6	149354008	149354256	MACS_peak_18158	1511.13	248	0	1	0	extreme
6	150387255	150387452	MACS_peak_18161	831.63	197	0	1	0	extreme
6	152552591	152552985	MACS_peak_18176	507.75	394	0	1	0	extreme
6	152748887	152749061	MACS_peak_18177	780.06	174	1	0	0	extreme
6	154675605	154675912	MACS_peak_18191	685.18	307	0	0	0	extreme
6	156330331	156330661	MACS_peak_18199	70.12	330	0	0	0	extreme
6	157342006	157342233	MACS_peak_18201	186.93	227	0	0	0	extreme
6	158522308	158522446	MACS_peak_18205	630.2	138	0	0	0	extreme
6	158756526	158756757	MACS_peak_18206	313.77	231	0	1	0	extreme
6	165369466	165369897	MACS_peak_18226	123.2	431	0	1	0	extreme
6	166641616	166641967	MACS_peak_18229	229.83	351	0	1	0	extreme
6	166890243	166890439	MACS_peak_18231	247.08	196	0	2	0	extreme
6	167371923	167372203	MACS_peak_18235	454.58	280	0	1	0	extreme
6	168115738	168116017	MACS_peak_18236	578.93	279	0	0	0	extreme
6	169358368	169358646	MACS_peak_18240	66.26	278	0	0	0	extreme
6	169831535	169831917	MACS_peak_18242	388.11	382	0	0	0	extreme
6	170466036	170466462	MACS_peak_18243	260.52	426	0	0	0	extreme
6	170517072	170517321	MACS_peak_18244	485.56	249	0	0	0	extreme
6	170641355	170641751	MACS_peak_18246	839.74	396	0	0	0	extreme
6	170736310	170736708	MACS_peak_18253	1088.93	398	0	0	1	extreme
6	86192	86384	MACS_peak_21985	678.9	192	0	0	0	extreme
7	25120	25441	MACS_peak_18256	402.95	321	0	0	2	extreme
7	394258	394533	MACS_peak_18261	60.37	275	0	0	0	extreme
7	1432483	1432757	MACS_peak_18272	458.32	274	1	0	0	extreme
7	1519285	1519637	MACS_peak_18273	149.97	352	0	0	0	extreme
7	2348053	2348350	MACS_peak_18276	316.38	297	0	1	0	extreme
7	2691025	2691159	MACS_peak_18280	1377.21	134	0	1	0	extreme
7	4409742	4410114	MACS_peak_18296	488.85	372	0	0	0	extreme
7	4830232	4830415	MACS_peak_18299	666.39	183	0	1	0	extreme
7	5002417	5002600	MACS_peak_18302	729.14	183	0	1	1	extreme
7	5085542	5085877	MACS_peak_18303	601.83	335	0	0	0	extreme
7	5611085	5611400	MACS_peak_18307	634.13	315	0	0	0	extreme
7	5827791	5828264	MACS_peak_18311	3100	473	0	0	1	extreme
7	6322940	6323271	MACS_peak_18316	1492.41	331	0	0	0	extreme
7	6348968	6349393	MACS_peak_18317	545.23	425	0	0	0	extreme
7	6574580	6574882	MACS_peak_18323	441.54	302	1	0	0	extreme
7	6745453	6745589	MACS_peak_18324	977.68	136	0	0	1	extreme
7	7313658	7313940	MACS_peak_18332	137.51	282	0	0	0	extreme
7	12182330	12182722	MACS_peak_18359	50.58	392	0	0	0	extreme
7	12322356	12322591	MACS_peak_18360	662.31	235	0	0	0	extreme
7	16516318	16516545	MACS_peak_18397	695.57	227	0	1	0	extreme
7	16801180	16801453	MACS_peak_18398	458.95	273	0	1	0	extreme
7	17640752	17641044	MACS_peak_18408	697.28	292	0	0	0	extreme
7	19396816	19397041	MACS_peak_18417	712.32	225	0	0	1	extreme
7	20278445	20278842	MACS_peak_18418	453.27	397	0	0	0	extreme
7	20440688	20441053	MACS_peak_18420	306.6	365	0	0	0	extreme
7	20598624	20598998	MACS_peak_18423	404.88	374	0	0	0	extreme
7	20993460	20993688	MACS_peak_18424	548.55	228	0	0	2	extreme
7	23086115	23086454	MACS_peak_18443	349.84	339	0	0	0	extreme
7	23283109	23283355	MACS_peak_18446	629.38	246	0	0	0	extreme
7	23547011	23547251	MACS_peak_18447	637.77	240	0	0	0	extreme
7	25105603	25105893	MACS_peak_18460	445.88	290	0	0	0	extreme
7	25216830	25217110	MACS_peak_18461	707.43	280	0	0	0	extreme
7	26667560	26667892	MACS_peak_18469	425.26	332	1	0	0	extreme
7	26955369	26955728	MACS_peak_18472	201.59	359	0	1	0	extreme
7	27179592	27179975	MACS_peak_18475	380.3	383	1	2	0	extreme
7	29878059	29878364	MACS_peak_18486	1234.98	305	0	1	0	extreme
7	30509268	30509632	MACS_peak_18487	769.12	364	0	1	0	extreme
7	32479649	32479956	MACS_peak_18511	438.71	307	0	0	0	extreme
7	32851485	32851742	MACS_peak_18521	1595.61	257	0	0	0	extreme
7	35624651	35624877	MACS_peak_18555	548.55	226	0	0	0	extreme
7	35709554	35709813	MACS_peak_18557	468.05	259	0	0	0	extreme
7	36319151	36319452	MACS_peak_18558	371.47	301	0	0	0	extreme
7	37495662	37495975	MACS_peak_18563	1369.92	313	0	0	0	extreme
7	37853593	37853802	MACS_peak_18564	780.06	209	0	1	0	extreme
7	38632784	38632924	MACS_peak_18573	1301.7	140	0	0	0	extreme
7	39015854	39016276	MACS_peak_18574	288.34	422	0	1	0	extreme
7	39026264	39026553	MACS_peak_18575	137.11	289	0	1	0	extreme
7	39746257	39746451	MACS_peak_18576	619.53	194	0	0	1	extreme
7	40364216	40364472	MACS_peak_18578	62.38	256	0	1	0	extreme
7	41979862	41980055	MACS_peak_18584	678.9	193	0	1	0	extreme
7	43261345	43261634	MACS_peak_18585	681.12	289	0	1	0	extreme
7	43582770	43583029	MACS_peak_18586	468.05	259	1	0	0	extreme
7	43838859	43839222	MACS_peak_18588	317.72	363	0	0	0	extreme
7	43983770	43984033	MACS_peak_18589	708.18	263	0	0	2	extreme
7	44020199	44020494	MACS_peak_18592	455.15	295	0	0	1	extreme
7	44588156	44588407	MACS_peak_18594	479.11	251	0	0	0	extreme
7	45136178	45136659	MACS_peak_18595	1755.86	481	0	0	0	extreme
7	50142397	50142731	MACS_peak_18621	925.03	334	0	1	1	extreme
7	50696660	50696986	MACS_peak_18622	932.56	326	0	1	0	extreme
7	55250228	55250461	MACS_peak_18657	532.66	233	0	0	1	extreme
7	55603256	55603501	MACS_peak_18659	501.16	245	0	0	0	extreme
7	55748437	55748792	MACS_peak_18662	641.34	355	0	0	0	extreme
7	56377747	56378177	MACS_peak_18664	618.73	430	0	0	0	extreme
7	64163879	64164248	MACS_peak_18784	128.01	369	0	0	0	extreme
7	65133079	65133321	MACS_peak_18787	402.63	242	0	0	0	extreme
7	65722211	65722555	MACS_peak_18799	274.31	344	0	0	1	extreme
7	65990528	65990660	MACS_peak_18800	652.77	132	0	0	0	extreme
7	66232089	66232229	MACS_peak_18801	914.92	140	0	1	0	extreme
7	71761060	71761432	MACS_peak_18817	638.92	372	0	0	0	extreme
7	72873653	72874032	MACS_peak_18822	322.31	379	0	0	0	extreme
7	73124047	73124346	MACS_peak_18824	341.9	299	0	0	0	extreme
7	73658992	73659236	MACS_peak_18826	210.91	244	0	0	0	extreme
7	73667738	73667942	MACS_peak_18827	629.38	204	1	0	0	extreme
7	73979178	73979492	MACS_peak_18828	809.85	314	0	0	0	extreme
7	74566802	74567170	MACS_peak_18830	410.58	368	0	1	0	extreme
7	74866258	74866460	MACS_peak_18831	745.98	202	0	0	0	extreme
7	75077656	75077858	MACS_peak_18835	966.16	202	0	0	0	extreme
7	75268331	75268626	MACS_peak_18836	360.95	295	0	0	0	extreme
7	75301610	75301880	MACS_peak_18838	678.13	270	0	0	0	extreme
7	75642972	75643295	MACS_peak_18844	429.98	323	0	1	0	extreme
7	76130598	76130914	MACS_peak_18847	433.75	316	0	0	1	extreme
7	77641124	77641262	MACS_peak_18860	652.22	138	0	0	0	extreme
7	79898314	79898590	MACS_peak_18877	1126.98	276	0	1	0	extreme
7	87044966	87045398	MACS_peak_18941	65.87	432	0	1	0	extreme
7	90115065	90115491	MACS_peak_18967	892.96	426	0	0	1	extreme
7	91593464	91593876	MACS_peak_18981	59.61	412	0	0	0	extreme
7	92128755	92128994	MACS_peak_18989	645.81	239	1	2	0	extreme
7	92461614	92461872	MACS_peak_18994	821.51	258	0	0	1	extreme
7	92590434	92590633	MACS_peak_18995	477.68	199	0	0	0	extreme
7	93071076	93071315	MACS_peak_18999	150.71	239	0	0	0	extreme
7	93228334	93228538	MACS_peak_19000	972.07	204	1	0	0	extreme
7	93902901	93903139	MACS_peak_19009	662.31	238	0	1	0	extreme
7	94020271	94020569	MACS_peak_19010	129.78	298	0	0	0	extreme
7	94289066	94289348	MACS_peak_19013	839.55	282	0	0	1	extreme
7	94449227	94449439	MACS_peak_19016	763.02	212	0	0	0	extreme
7	94998383	94998644	MACS_peak_19017	720.73	261	0	1	0	extreme
7	96075493	96075695	MACS_peak_19032	989.9	202	0	1	0	extreme
7	96414898	96415233	MACS_peak_19033	1199.31	335	0	0	0	extreme
7	98241280	98241699	MACS_peak_19055	730.49	419	0	1	0	extreme
7	98420978	98421381	MACS_peak_19056	619.72	403	0	0	0	extreme
7	98836883	98837177	MACS_peak_19061	568.08	294	0	0	0	extreme
7	99187697	99187938	MACS_peak_19062	589.76	241	0	1	0	extreme
7	99312988	99313232	MACS_peak_19064	1226.97	244	0	0	1	extreme
7	99801815	99802079	MACS_peak_19067	84.46	264	0	0	0	extreme
7	99812956	99813174	MACS_peak_19069	73.48	218	0	0	0	extreme
7	99949707	99950007	MACS_peak_19071	380.3	300	0	0	0	extreme
7	99990987	99991275	MACS_peak_19072	460.03	288	0	0	0	extreme
7	99994231	99994463	MACS_peak_19073	1472.64	232	0	0	0	extreme
7	100131099	100131295	MACS_peak_19075	635.31	196	1	0	1	extreme
7	100345209	100345602	MACS_peak_19079	567.67	393	0	0	2	extreme
7	100718523	100718761	MACS_peak_19081	540.48	238	1	0	0	extreme
7	101059333	101059602	MACS_peak_19082	501.18	269	0	0	0	extreme
7	101121166	101121302	MACS_peak_19084	691.33	136	0	0	0	extreme
7	101192546	101192995	MACS_peak_19085	506.92	449	1	0	0	extreme
7	101350089	101350230	MACS_peak_19087	1269.22	141	0	0	0	extreme
7	102279569	102279760	MACS_peak_19094	695.57	191	0	1	0	extreme
7	102357313	102357636	MACS_peak_19095	798.35	323	0	0	0	extreme
7	102479872	102480235	MACS_peak_19097	486.95	363	2	0	0	extreme
7	102725563	102725889	MACS_peak_19113	84.4	326	0	0	0	extreme
7	103061967	103062237	MACS_peak_19117	950.42	270	0	1	0	extreme
7	103247461	103247698	MACS_peak_19118	158.88	237	0	0	1	extreme
7	103282734	103283201	MACS_peak_19119	997.64	467	0	0	0	extreme
7	103573506	103573879	MACS_peak_19120	1129.28	373	0	1	0	extreme
7	103909625	103909973	MACS_peak_19121	82.14	348	0	1	0	extreme
7	104981254	104981546	MACS_peak_19134	434.05	292	0	0	1	extreme
7	105401608	105401834	MACS_peak_19138	1472.42	226	0	0	0	extreme
7	105652341	105652603	MACS_peak_19139	591.97	262	0	1	0	extreme
7	106042889	106043124	MACS_peak_19141	662.31	235	0	0	0	extreme
7	106153917	106154174	MACS_peak_19142	355.73	257	0	0	0	extreme
7	106959779	106960073	MACS_peak_19152	695.63	294	0	0	0	extreme
7	107725202	107725489	MACS_peak_19164	701.46	287	0	0	0	extreme
7	107848696	107848975	MACS_peak_19168	103.45	279	0	0	0	extreme
7	108131722	108131962	MACS_peak_19169	903.02	240	0	0	0	extreme
7	108298489	108298693	MACS_peak_19171	573.39	204	0	1	0	extreme
7	108613172	108613521	MACS_peak_19172	719	349	0	0	1	extreme
7	112550514	112550740	MACS_peak_19211	869.63	226	0	0	0	extreme
7	112947284	112947560	MACS_peak_19214	380.3	276	0	0	0	extreme
7	116168284	116168519	MACS_peak_19229	662.31	235	0	0	0	extreme
7	116711304	116711543	MACS_peak_19234	1264.23	239	0	1	0	extreme
7	120710803	120711036	MACS_peak_19259	924.44	233	0	1	0	extreme
7	120792022	120792347	MACS_peak_19260	428.92	325	0	0	0	extreme
7	121081705	121081916	MACS_peak_19262	596.79	211	0	1	0	extreme
7	123526438	123526864	MACS_peak_19284	160.72	426	0	1	0	extreme
7	124785246	124785482	MACS_peak_19299	514.01	236	0	1	0	extreme
7	127107615	127107931	MACS_peak_19309	678.2	316	0	1	0	extreme
7	127453863	127454101	MACS_peak_19310	241.08	238	0	0	0	extreme
7	127519768	127520071	MACS_peak_19311	201.59	303	0	0	0	extreme
7	127650702	127650849	MACS_peak_19312	1491.86	147	1	0	1	extreme
7	128398586	128398842	MACS_peak_19318	470.06	256	0	1	0	extreme
7	128537471	128537764	MACS_peak_19322	1098.77	293	0	0	1	extreme
7	128672997	128673380	MACS_peak_19327	489.71	383	1	0	0	extreme
7	129163975	129164421	MACS_peak_19328	482.39	446	0	1	0	extreme
7	130010937	130011133	MACS_peak_19335	1094.87	196	0	0	1	extreme
7	130581280	130581468	MACS_peak_19338	50.92	188	0	1	0	extreme
7	131063958	131064370	MACS_peak_19343	899.87	412	0	0	2	extreme
7	132318756	132319019	MACS_peak_19350	465.4	263	0	1	0	extreme
7	133230656	133230879	MACS_peak_19352	564.54	223	0	0	0	extreme
7	135170799	135170977	MACS_peak_19366	763.02	178	0	0	0	extreme
7	135645401	135645865	MACS_peak_19368	823.38	464	0	1	0	extreme
7	136009382	136009758	MACS_peak_19369	403.97	376	0	0	0	extreme
7	138886386	138886762	MACS_peak_19390	603.02	376	0	1	0	extreme
7	139216425	139216630	MACS_peak_19393	79.93	205	0	0	0	extreme
7	139321050	139321268	MACS_peak_19394	564.92	218	0	0	0	extreme
7	140387669	140387902	MACS_peak_19399	831.63	233	0	1	0	extreme
7	141067590	141067989	MACS_peak_19401	103.92	399	0	0	0	extreme
7	141533433	141533644	MACS_peak_19404	526.96	211	0	0	1	extreme
7	141816255	141816563	MACS_peak_19406	424.89	308	0	0	0	extreme
7	143215012	143215438	MACS_peak_19421	1108.24	426	0	0	0	extreme
7	143345382	143345721	MACS_peak_19422	661.26	339	0	1	0	extreme
7	143413947	143414179	MACS_peak_19423	521.25	232	0	0	1	extreme
7	144057707	144058012	MACS_peak_19433	721.05	305	0	1	0	extreme
7	144219162	144219504	MACS_peak_19434	1052.86	342	0	0	1	extreme
7	144331470	144331812	MACS_peak_19435	1191.46	342	0	0	2	extreme
7	144454523	144454768	MACS_peak_19436	501.16	245	1	0	0	extreme
7	148505178	148505410	MACS_peak_19464	831.63	232	0	0	0	extreme
7	148966749	148967076	MACS_peak_19465	570.85	327	0	0	0	extreme
7	149275020	149275296	MACS_peak_19467	349.84	276	0	1	0	extreme
7	149669270	149669465	MACS_peak_19468	604.07	195	0	0	0	extreme
7	149963937	149964258	MACS_peak_19469	431.05	321	0	0	0	extreme
7	150299363	150299503	MACS_peak_19473	1313.07	140	0	1	0	extreme
7	150756909	150757180	MACS_peak_19474	263.82	271	0	0	0	extreme
7	150810380	150810577	MACS_peak_19475	241.08	197	0	0	0	extreme
7	151172497	151172900	MACS_peak_19476	1129.23	403	1	1	0	extreme
7	151244412	151244664	MACS_peak_19477	613.04	252	0	1	0	extreme
7	151316524	151316754	MACS_peak_19480	73.24	230	0	0	0	extreme
7	151546066	151546303	MACS_peak_19481	440.38	237	0	0	0	extreme
7	152071417	152071775	MACS_peak_19485	148.59	358	0	1	0	extreme
7	155768371	155768643	MACS_peak_19505	735.52	272	0	1	0	extreme
7	157298369	157298599	MACS_peak_19512	123.06	230	0	0	0	extreme
7	158055134	158055400	MACS_peak_19513	463.44	266	0	1	0	extreme
7	158696125	158696368	MACS_peak_19517	554.96	243	0	1	0	extreme
7	159132763	159133113	MACS_peak_19519	910.51	350	0	1	0	extreme
8	70960	71348	MACS_peak_19527	622.99	388	0	0	0	extreme
8	190071	190409	MACS_peak_19534	141.67	338	0	0	0	extreme
8	299267	299600	MACS_peak_19535	925.96	333	0	0	0	extreme
8	359466	359699	MACS_peak_19536	416.25	233	0	0	0	extreme
8	1169958	1170437	MACS_peak_19537	64.38	479	0	1	0	extreme
8	1678765	1678981	MACS_peak_19539	580.62	216	0	1	0	extreme
8	1969415	1969678	MACS_peak_19540	722.6	263	1	0	0	extreme
8	5883956	5884334	MACS_peak_19554	114.74	378	0	0	0	extreme
8	6845715	6846094	MACS_peak_19556	70.48	379	0	0	1	extreme
8	8201117	8201484	MACS_peak_19571	1078.73	367	0	0	2	extreme
8	8736980	8737264	MACS_peak_19572	837.6	284	0	0	1	extreme
8	8976421	8976796	MACS_peak_19573	391.26	375	0	0	1	extreme
8	9830945	9831325	MACS_peak_19577	885.03	380	0	0	0	extreme
8	11246963	11247177	MACS_peak_19578	596.79	214	0	0	0	extreme
8	11839579	11839813	MACS_peak_19581	706.21	234	1	0	0	extreme
8	12221675	12222042	MACS_peak_19583	958.48	367	0	0	0	extreme
8	12223821	12224259	MACS_peak_19584	1097.74	438	0	0	0	extreme
8	12464197	12464564	MACS_peak_19586	841.34	367	0	0	1	extreme
8	12642620	12642859	MACS_peak_19591	954.29	239	0	0	1	extreme
8	12840723	12840986	MACS_peak_19592	591.18	263	0	0	0	extreme
8	16946357	16946758	MACS_peak_19610	54.34	401	0	0	0	extreme
8	17495283	17495540	MACS_peak_19611	469.39	257	1	0	0	extreme
8	17871498	17871764	MACS_peak_19612	560.75	266	0	1	0	extreme
8	18191417	18191842	MACS_peak_19616	65.91	425	0	1	0	extreme
8	18752422	18752706	MACS_peak_19622	488.85	284	0	1	0	extreme
8	19440408	19440727	MACS_peak_19625	55.34	319	0	1	0	extreme
8	19870381	19870644	MACS_peak_19626	858.87	263	0	0	0	extreme
8	19933786	19934240	MACS_peak_19627	70.13	454	0	1	0	extreme
8	20503665	20503986	MACS_peak_19628	778.98	321	0	0	0	extreme
8	21830100	21830492	MACS_peak_19637	86.78	392	0	0	0	extreme
8	22756173	22756491	MACS_peak_19642	432.66	318	0	1	1	extreme
8	22898287	22898517	MACS_peak_19643	1582.7	230	0	1	0	extreme
8	23589630	23589832	MACS_peak_19644	645.81	202	0	0	0	extreme
8	25172537	25172850	MACS_peak_19654	555.13	313	0	0	0	extreme
8	25605598	25605889	MACS_peak_19656	265.34	291	0	0	0	extreme
8	26243070	26243388	MACS_peak_19661	488.85	318	0	0	0	extreme
8	27114060	27114481	MACS_peak_19666	141.15	421	0	0	0	extreme
8	28260131	28260280	MACS_peak_19673	954.29	149	0	0	1	extreme
8	29666636	29667105	MACS_peak_19677	699.65	469	0	0	0	extreme
8	30447572	30447817	MACS_peak_19678	918.92	245	0	1	0	extreme
8	31498810	31499197	MACS_peak_19679	64.95	387	0	0	0	extreme
8	33319524	33319791	MACS_peak_19687	462.79	267	0	0	0	extreme
8	37533989	37534282	MACS_peak_19704	446.75	293	0	0	1	extreme
8	38073592	38073921	MACS_peak_19705	649.88	329	0	0	0	extreme
8	38074927	38075339	MACS_peak_19707	595.96	412	0	0	0	extreme
8	38508968	38509281	MACS_peak_19708	422.13	313	1	0	0	extreme
8	38856199	38856431	MACS_peak_19709	532.66	232	0	0	0	extreme
8	39327423	39327826	MACS_peak_19710	503.12	403	0	0	1	extreme
8	40432612	40432908	MACS_peak_19715	73.35	296	0	0	0	extreme
8	42172251	42172494	MACS_peak_19717	651.03	243	1	0	0	extreme
8	42385480	42385729	MACS_peak_19718	748.7	249	0	0	0	extreme
8	42727870	42728093	MACS_peak_19719	549.18	223	0	1	0	extreme
8	43323321	43323710	MACS_peak_19722	57.86	389	0	0	1	extreme
8	47754420	47754725	MACS_peak_19775	178.37	305	0	0	0	extreme
8	48172131	48172430	MACS_peak_19777	691.56	299	0	0	0	extreme
8	53698882	53699125	MACS_peak_19811	119.29	243	0	0	0	extreme
8	54024036	54024237	MACS_peak_19814	554.96	201	0	0	0	extreme
8	54234535	54234833	MACS_peak_19815	297.73	298	0	0	0	extreme
8	55653092	55653458	MACS_peak_19823	89.02	366	0	0	0	extreme
8	55842070	55842419	MACS_peak_19824	257.95	349	0	0	0	extreme
8	56929206	56929422	MACS_peak_19835	746.04	216	0	0	0	extreme
8	58375072	58375291	MACS_peak_19844	97.43	219	0	0	0	extreme
8	58513308	58513583	MACS_peak_19845	711.8	275	0	0	0	extreme
8	60233256	60233460	MACS_peak_19853	629.38	204	0	1	0	extreme
8	62814645	62815085	MACS_peak_19871	100.78	440	0	1	0	extreme
8	63111142	63111539	MACS_peak_19872	506.19	397	0	0	0	extreme
8	63261958	63262236	MACS_peak_19873	455.81	278	0	0	0	extreme
8	65437213	65437582	MACS_peak_19888	78.17	369	0	0	0	extreme
8	65706141	65706390	MACS_peak_19889	613.04	249	0	1	0	extreme
8	66421734	66422084	MACS_peak_19893	416.22	350	0	0	1	extreme
8	66703565	66703934	MACS_peak_19896	142.05	369	0	1	0	extreme
8	66843985	66844122	MACS_peak_19897	567.81	137	0	1	0	extreme
8	67462820	67463087	MACS_peak_19900	3100	267	0	1	0	extreme
8	67754953	67755306	MACS_peak_19904	50.6	353	0	0	0	extreme
8	68338550	68338752	MACS_peak_19905	645.81	202	0	1	0	extreme
8	69946136	69946445	MACS_peak_19914	683.61	309	0	0	0	extreme
8	72918625	72918856	MACS_peak_19934	532.66	231	0	1	0	extreme
8	73255526	73255768	MACS_peak_19938	74.77	242	0	1	0	extreme
8	73305587	73305830	MACS_peak_19939	645.81	243	0	1	1	extreme
8	73350279	73350502	MACS_peak_19940	161.29	223	0	0	1	extreme
8	74251956	74252206	MACS_peak_19943	105.81	250	0	1	0	extreme
8	76565270	76565585	MACS_peak_19960	363.79	315	0	0	1	extreme
8	77006907	77007129	MACS_peak_19961	513.05	222	0	0	0	extreme
8	79823791	79823979	MACS_peak_19991	635.07	188	0	0	1	extreme
8	81277743	81278033	MACS_peak_20009	448.52	290	1	0	0	extreme
8	81651427	81651693	MACS_peak_20010	418.76	266	0	0	0	extreme
8	86266509	86266880	MACS_peak_20064	362.19	371	0	1	0	extreme
8	89848226	89848529	MACS_peak_20124	1097.2	303	0	0	0	extreme
8	94813454	94813850	MACS_peak_20190	870.72	396	1	0	0	extreme
8	96333029	96333499	MACS_peak_20202	699.07	470	0	1	0	extreme
8	102197502	102197748	MACS_peak_20286	508.42	246	0	0	0	extreme
8	102814688	102814916	MACS_peak_20294	541.47	228	0	0	0	extreme
8	103373176	103373521	MACS_peak_20299	1603.33	345	1	0	0	extreme
8	103707306	103707631	MACS_peak_20300	722.05	325	0	1	0	extreme
8	108287201	108287371	MACS_peak_20380	797.18	170	0	1	0	extreme
8	108496626	108496871	MACS_peak_20381	883.94	245	0	0	0	extreme
8	109213557	109213905	MACS_peak_20391	707.97	348	0	0	0	extreme
8	109346875	109347213	MACS_peak_20396	921.33	338	0	0	0	extreme
8	109383065	109383452	MACS_peak_20398	823.36	387	0	1	0	extreme
8	116887584	116887973	MACS_peak_20465	1008.5	389	0	0	0	extreme
8	116912709	116912920	MACS_peak_20466	765.58	211	0	0	0	extreme
8	117330175	117330445	MACS_peak_20468	569.72	270	0	0	0	extreme
8	117467922	117468253	MACS_peak_20469	312.33	331	0	0	0	extreme
8	117862073	117862391	MACS_peak_20470	482.12	318	0	1	0	extreme
8	119655167	119655383	MACS_peak_20489	2235.66	216	0	1	0	extreme
8	119862955	119863260	MACS_peak_20490	395.39	305	0	0	0	extreme
8	120010002	120010258	MACS_peak_20492	470.06	256	0	1	0	extreme
8	122904869	122905148	MACS_peak_20549	578.93	279	0	1	0	extreme
8	123065726	123066123	MACS_peak_20550	596.52	397	0	1	0	extreme
8	123693781	123694047	MACS_peak_20558	2086.01	266	0	1	0	extreme
8	124440463	124440756	MACS_peak_20569	1823.57	293	0	0	0	extreme
8	124525999	124526248	MACS_peak_20570	547.91	249	0	1	0	extreme
8	124953780	124953983	MACS_peak_20574	556.2	203	0	0	1	extreme
8	132489574	132489863	MACS_peak_20649	571.63	289	0	0	0	extreme
8	132875452	132875797	MACS_peak_20653	657.04	345	0	1	0	extreme
8	133449474	133449746	MACS_peak_20654	849.55	272	0	0	0	extreme
8	139630861	139631208	MACS_peak_20686	417.69	347	0	1	0	extreme
8	141726987	141727329	MACS_peak_20702	536.84	342	0	0	0	extreme
8	142447375	142447771	MACS_peak_20704	1002.36	396	1	0	0	extreme
8	142710408	142710701	MACS_peak_20705	446.75	293	0	0	1	extreme
8	142943620	142943903	MACS_peak_20708	575.98	283	0	0	0	extreme
8	143131001	143131315	MACS_peak_20713	434.84	314	0	0	0	extreme
8	143281581	143281932	MACS_peak_20714	652.89	351	0	0	0	extreme
8	143401309	143401525	MACS_peak_20716	1079.97	216	0	0	0	extreme
8	143843922	143844237	MACS_peak_20720	348.12	315	0	0	0	extreme
8	145022169	145022530	MACS_peak_20727	348.12	361	0	0	0	extreme
9	11262	11712	MACS_peak_20730	832.82	450	1	0	0	extreme
9	176171	176527	MACS_peak_20733	588.26	356	0	1	0	extreme
9	687737	687985	MACS_peak_20735	613.04	248	0	1	0	extreme
9	1936923	1937298	MACS_peak_20747	211.42	375	0	0	0	extreme
9	4604627	4604844	MACS_peak_20760	353.56	217	0	1	0	extreme
9	4735192	4735543	MACS_peak_20761	1466.06	351	0	1	0	extreme
9	4759453	4759645	MACS_peak_20762	678.9	192	0	0	0	extreme
9	4948663	4948978	MACS_peak_20763	68.21	315	0	0	0	extreme
9	4950628	4951056	MACS_peak_20764	56.93	428	0	0	0	extreme
9	5424440	5424828	MACS_peak_20768	510.89	388	0	1	0	extreme
9	6137147	6137504	MACS_peak_20772	73.17	357	0	0	0	extreme
9	6259905	6260222	MACS_peak_20773	57.81	317	0	0	0	extreme
9	6708500	6708977	MACS_peak_20775	695.04	477	0	0	0	extreme
9	17823320	17823713	MACS_peak_20819	142.43	393	0	0	0	extreme
9	19541522	19541832	MACS_peak_20821	63.44	310	0	1	0	extreme
9	21253077	21253299	MACS_peak_20837	564.54	222	0	0	0	extreme
9	21455401	21455641	MACS_peak_20838	334.14	240	0	0	0	extreme
9	21789611	21789864	MACS_peak_20843	596.79	253	0	0	0	extreme
9	25484505	25484825	MACS_peak_20862	50.92	320	0	0	0	extreme
9	25887515	25887860	MACS_peak_20863	1329.55	345	0	0	0	extreme
9	26834980	26835340	MACS_peak_20869	90.41	360	0	0	0	extreme
9	32228345	32228726	MACS_peak_20897	50.92	381	0	0	0	extreme
9	32579697	32580083	MACS_peak_20899	630.05	386	0	0	0	extreme
9	33088220	33088566	MACS_peak_20904	58.44	346	0	0	0	extreme
9	33374880	33375250	MACS_peak_20906	488.85	370	0	0	0	extreme
9	33714338	33714692	MACS_peak_20908	414.27	354	0	0	0	extreme
9	34309965	34310106	MACS_peak_20913	1077.51	141	0	1	0	extreme
9	34548077	34548359	MACS_peak_20914	576.71	282	1	0	0	extreme
9	34658759	34658944	MACS_peak_20915	901.33	185	1	1	0	extreme
9	34664372	34664600	MACS_peak_20916	695.57	228	2	0	1	extreme
9	35494845	35495212	MACS_peak_20917	611.86	367	0	0	0	extreme
9	35554056	35554307	MACS_peak_20918	613.04	251	0	1	0	extreme
9	35848566	35848698	MACS_peak_20919	977.06	132	0	1	0	extreme
9	35954986	35955262	MACS_peak_20921	651.13	276	1	0	0	extreme
9	37305881	37306094	MACS_peak_20928	659.6	213	0	1	0	extreme
9	37594629	37594943	MACS_peak_20929	434.84	314	0	1	0	extreme
9	38371275	38371473	MACS_peak_20931	662.31	198	0	0	1	extreme
9	65275520	65275827	MACS_peak_20952	96.3	307	0	0	0	extreme
9	41311514	41311860	MACS_peak_20965	1143.87	346	0	0	1	extreme
9	67907023	67907376	MACS_peak_21044	119.78	353	0	0	1	extreme
9	41088667	41089118	MACS_peak_21052	1922.78	451	0	0	1	extreme
9	41311554	41311860	MACS_peak_21109	411.47	306	0	0	1	extreme
9	68342475	68342926	MACS_peak_21112	2118.01	451	0	1	0	extreme
9	70352799	70353168	MACS_peak_21126	640.87	369	0	1	0	extreme
9	70432414	70432800	MACS_peak_21127	52.99	386	0	0	0	extreme
9	74570958	74571211	MACS_peak_21153	746.04	253	0	1	0	extreme
9	75185606	75185848	MACS_peak_21155	645.81	242	0	0	0	extreme
9	76175128	76175360	MACS_peak_21162	289.29	232	0	1	0	extreme
9	76403223	76403563	MACS_peak_21163	421.18	340	0	0	0	extreme
9	77116087	77116219	MACS_peak_21166	1028.85	132	0	0	0	extreme
9	77657320	77657658	MACS_peak_21171	418.39	338	0	0	0	extreme
9	86158253	86158671	MACS_peak_21229	62.29	418	0	0	0	extreme
9	86377632	86377904	MACS_peak_21231	80.93	272	0	0	0	extreme
9	87812907	87813328	MACS_peak_21243	1977	421	0	0	2	extreme
9	88173474	88173682	MACS_peak_21244	596.67	208	0	0	0	extreme
9	88343829	88344200	MACS_peak_21246	520.09	371	0	0	0	extreme
9	92140312	92140530	MACS_peak_21267	901.33	218	0	0	0	extreme
9	92502040	92502329	MACS_peak_21269	571.63	289	0	2	0	extreme
9	92996472	92996824	MACS_peak_21276	100.11	352	0	1	0	extreme
9	93302713	93302992	MACS_peak_21278	980.98	279	0	1	0	extreme
9	93682193	93682421	MACS_peak_21279	848.95	228	0	0	0	extreme
9	94270646	94271029	MACS_peak_21288	573.91	383	0	1	0	extreme
9	94539536	94539820	MACS_peak_21290	928.69	284	0	0	0	extreme
9	96327855	96328071	MACS_peak_21303	564.92	216	0	2	0	extreme
9	96441846	96442109	MACS_peak_21304	893.83	263	0	0	0	extreme
9	96666704	96667108	MACS_peak_21306	761.42	404	0	0	0	extreme
9	96856884	96857150	MACS_peak_21307	588.83	266	0	1	0	extreme
9	98205784	98206048	MACS_peak_21318	1165.47	264	0	1	0	extreme
9	99140698	99141054	MACS_peak_21329	905.24	356	0	1	0	extreme
9	99816413	99816699	MACS_peak_21333	406.36	286	0	0	1	extreme
9	100483573	100483855	MACS_peak_21339	611.86	282	0	2	0	extreme
9	101292797	101293112	MACS_peak_21345	56.38	315	0	1	0	extreme
9	101449898	101450140	MACS_peak_21346	501.16	242	0	0	0	extreme
9	104063205	104063496	MACS_peak_21370	77.53	291	0	0	0	extreme
9	104177005	104177327	MACS_peak_21371	936.39	322	0	0	0	extreme
9	107255923	107256142	MACS_peak_21400	150.32	219	0	0	0	extreme
9	108850313	108850689	MACS_peak_21415	403.97	376	1	0	0	extreme
9	108954101	108954323	MACS_peak_21416	693.94	222	0	1	0	extreme
9	111352466	111352739	MACS_peak_21443	3100	273	0	0	0	extreme
9	111581235	111581434	MACS_peak_21444	1208.41	199	0	1	0	extreme
9	112665437	112665833	MACS_peak_21458	406.81	396	0	1	0	extreme
9	113112839	113113221	MACS_peak_21463	1883.99	382	0	0	0	extreme
9	113309200	113309570	MACS_peak_21467	1494.88	370	1	0	0	extreme
9	113401408	113401729	MACS_peak_21468	549.92	321	0	0	0	extreme
9	114849522	114849796	MACS_peak_21479	826.15	274	1	0	0	extreme
9	115015119	115015346	MACS_peak_21480	695.57	227	1	1	0	extreme
9	121169147	121169438	MACS_peak_21525	698.11	291	0	1	0	extreme
9	122125083	122125398	MACS_peak_21539	1222.71	315	0	0	0	extreme
9	122217804	122218076	MACS_peak_21540	459.58	272	0	1	0	extreme
9	122453251	122453424	MACS_peak_21541	561.45	173	0	0	0	extreme
9	122764817	122765124	MACS_peak_21547	73.66	307	0	0	0	extreme
9	122991385	122991757	MACS_peak_21549	506.92	372	0	1	0	extreme
9	124320404	124320693	MACS_peak_21560	449.12	289	0	1	0	extreme
9	124711985	124712426	MACS_peak_21565	1804.08	441	0	1	0	extreme
9	125374736	125374995	MACS_peak_21569	594.37	259	0	0	0	extreme
9	126705285	126705559	MACS_peak_21583	582.68	274	0	0	0	extreme
9	126940661	126940889	MACS_peak_21585	1144.35	228	0	1	0	extreme
9	127311255	127311598	MACS_peak_21588	596.19	343	0	1	0	extreme
9	127455309	127455631	MACS_peak_21589	430.51	322	1	0	0	extreme
9	127618366	127618630	MACS_peak_21590	702.98	264	0	1	0	extreme
9	127870019	127870228	MACS_peak_21592	606	209	2	0	0	extreme
9	128130117	128130418	MACS_peak_21597	1212.36	301	0	0	1	extreme
9	128291972	128292129	MACS_peak_21600	428.95	157	0	0	0	extreme
9	128414533	128414906	MACS_peak_21601	762.41	373	1	0	0	extreme
9	128420097	128420415	MACS_peak_21602	758.83	318	0	1	0	extreme
9	128851942	128852373	MACS_peak_21606	580.49	431	0	1	0	extreme
9	128927928	128928303	MACS_peak_21607	563.34	375	0	1	0	extreme
9	129028498	129028825	MACS_peak_21608	889.59	327	0	0	0	extreme
9	129182626	129182950	MACS_peak_21611	547.99	324	0	0	1	extreme
9	129720637	129720875	MACS_peak_21615	516.86	238	0	1	0	extreme
9	129885703	129885964	MACS_peak_21617	466.72	261	1	0	0	extreme
9	129907481	129907619	MACS_peak_21619	672.15	138	0	1	0	extreme
9	130442556	130442689	MACS_peak_21622	1396.21	133	1	0	0	extreme
9	130682613	130682845	MACS_peak_21623	514.21	232	0	1	0	extreme
9	130707472	130707651	MACS_peak_21624	876.89	179	0	0	0	extreme
9	131057909	131058077	MACS_peak_21628	982.95	168	0	1	0	extreme
9	131363809	131363954	MACS_peak_21632	814.98	145	0	0	0	extreme
9	131740110	131740340	MACS_peak_21634	827.5	230	0	0	0	extreme
9	131747523	131747908	MACS_peak_21635	145.73	385	0	0	0	extreme
9	132977510	132977884	MACS_peak_21645	404.88	374	0	1	0	extreme
9	133180002	133180193	MACS_peak_21649	834.1	191	0	0	0	extreme
9	133514022	133514380	MACS_peak_21652	57.86	358	1	0	0	extreme
9	134561114	134561319	MACS_peak_21659	469.81	205	0	0	0	extreme
9	135206577	135206885	MACS_peak_21661	272.05	308	0	0	1	extreme
9	135412586	135412957	MACS_peak_21662	954.43	371	0	0	0	extreme
9	135603976	135604163	MACS_peak_21666	901.33	187	1	0	0	extreme
9	136226228	136226459	MACS_peak_21668	678.9	231	0	1	0	extreme
9	136631517	136631736	MACS_peak_21669	901.33	219	0	0	0	extreme
9	136766437	136766763	MACS_peak_21670	428.39	326	0	0	0	extreme
9	137004103	137004542	MACS_peak_21672	803.92	439	1	0	0	extreme
9	137118514	137118891	MACS_peak_21674	640.09	377	0	0	0	extreme
9	137121449	137121768	MACS_peak_21675	834.03	319	0	0	0	extreme
9	137236522	137236787	MACS_peak_21677	1141.07	265	1	0	0	extreme
9	137295351	137295664	MACS_peak_21679	422.13	313	0	0	1	extreme
9	137509931	137510216	MACS_peak_21680	350.33	285	0	1	0	extreme
9	137545536	137545902	MACS_peak_21683	1460.78	366	0	1	0	extreme
9	137672811	137673112	MACS_peak_21685	442.11	301	0	1	1	extreme
9	138226951	138227272	MACS_peak_21692	266.88	321	0	0	1	extreme
10	36490	36814	MACS_peak_1903	61.31	324	0	0	0	extreme
10	122226	122587	MACS_peak_1905	90.07	361	0	0	0	extreme
10	668100	668285	MACS_peak_1910	712.32	185	0	2	0	extreme
10	2839096	2839380	MACS_peak_1926	452.13	284	0	0	0	extreme
10	3192908	3193124	MACS_peak_1927	1079.97	216	0	0	0	extreme
10	5629841	5630133	MACS_peak_1948	484.4	292	0	0	0	extreme
10	6151532	6151746	MACS_peak_1950	918.92	214	0	1	0	extreme
10	7687270	7687571	MACS_peak_1968	509.73	301	0	0	0	extreme
10	7871898	7872284	MACS_peak_1970	511.95	386	0	1	0	extreme
10	11819891	11820094	MACS_peak_1995	509.1	203	1	0	0	extreme
10	13126170	13126337	MACS_peak_2010	856.32	167	0	1	0	extreme
10	13217229	13217633	MACS_peak_2013	204.25	404	1	0	0	extreme
10	13371882	13372232	MACS_peak_2014	416.22	350	0	0	0	extreme
10	14536976	14537265	MACS_peak_2024	699.78	289	0	1	0	extreme
10	14991447	14991789	MACS_peak_2027	659.14	342	0	0	0	extreme
10	15725843	15726125	MACS_peak_2030	453.35	282	0	0	0	extreme
10	15878992	15879257	MACS_peak_2031	555.87	265	0	0	0	extreme
10	16129700	16130087	MACS_peak_2033	118.14	387	0	0	0	extreme
10	16545179	16545444	MACS_peak_2034	589.61	265	0	0	0	extreme
10	17607509	17607782	MACS_peak_2041	571.62	273	0	1	0	extreme
10	17742894	17743221	MACS_peak_2042	427.87	327	0	0	0	extreme
10	17742894	17743221	MACS_peak_2043	427.87	327	0	0	0	extreme
10	18536237	18536374	MACS_peak_2053	693.63	137	0	1	1	extreme
10	18818515	18818966	MACS_peak_2059	166.7	451	0	0	0	extreme
10	20292388	20292785	MACS_peak_2071	137.17	397	0	0	0	extreme
10	21433755	21433974	MACS_peak_2087	852.08	219	0	0	0	extreme
10	21675243	21675470	MACS_peak_2088	548.55	227	0	1	0	extreme
10	22646243	22646466	MACS_peak_2097	462.45	223	0	1	0	extreme
10	26632485	26632863	MACS_peak_2133	124.74	378	0	0	0	extreme
10	26890929	26891224	MACS_peak_2134	609.45	295	0	0	0	extreme
10	27312280	27312616	MACS_peak_2136	540.49	336	0	0	0	extreme
10	27885514	27885902	MACS_peak_2137	722.05	388	0	1	0	extreme
10	28475159	28475308	MACS_peak_2142	933.27	149	0	0	1	extreme
10	28626047	28626183	MACS_peak_2143	1061.85	136	0	0	0	extreme
10	30298323	30298552	MACS_peak_2150	548.55	229	0	0	0	extreme
10	30392570	30392720	MACS_peak_2151	936.57	150	0	0	0	extreme
10	31714707	31715029	MACS_peak_2171	100.97	322	0	0	0	extreme
10	32086282	32086513	MACS_peak_2172	584.47	231	0	0	0	extreme
10	32210862	32211177	MACS_peak_2175	627.13	315	0	0	0	extreme
10	32399780	32400107	MACS_peak_2176	125.66	327	0	0	0	extreme
10	34994686	34994926	MACS_peak_2194	797.18	240	0	0	0	extreme
10	35218550	35218706	MACS_peak_2195	901.33	156	0	0	0	extreme
10	37998301	37998657	MACS_peak_2215	120.97	356	0	0	0	extreme
10	38263580	38263923	MACS_peak_2217	56.38	343	0	1	1	extreme
10	42669006	42669294	MACS_peak_2357	147.8	288	0	0	0	extreme
10	43498011	43498306	MACS_peak_2358	178.37	295	0	0	0	extreme
10	43528425	43528878	MACS_peak_2359	102.92	453	0	0	0	extreme
10	44098924	44099215	MACS_peak_2360	603.06	291	0	0	0	extreme
10	44932652	44932959	MACS_peak_2372	559.13	307	0	1	1	extreme
10	45013689	45014014	MACS_peak_2374	109.53	325	0	0	1	extreme
10	45349911	45350287	MACS_peak_2377	130.59	376	0	0	0	extreme
10	46565507	46565934	MACS_peak_2387	887.67	427	0	0	0	extreme
10	46468172	46468472	MACS_peak_2388	563.9	300	0	0	1	extreme
10	47687543	47687753	MACS_peak_2391	1210.75	210	0	0	0	extreme
10	50156451	50156788	MACS_peak_2394	65.52	337	0	0	0	extreme
10	47340674	47340895	MACS_peak_2396	564.54	221	0	0	0	extreme
10	48064411	48064604	MACS_peak_2405	678.9	193	0	0	1	extreme
10	49263298	49263647	MACS_peak_2413	416.71	349	0	0	0	extreme
10	49716901	49717249	MACS_peak_2416	54.59	348	0	0	0	extreme
10	46089029	46089162	MACS_peak_2418	1396.21	133	0	0	0	extreme
10	56349732	56349946	MACS_peak_2469	682.16	214	0	0	0	extreme
10	56442674	56442908	MACS_peak_2471	363.11	234	0	0	0	extreme
10	58131329	58131519	MACS_peak_2481	806.28	190	0	0	0	extreme
10	58297469	58297789	MACS_peak_2483	103.45	320	0	0	0	extreme
10	58299449	58299796	MACS_peak_2484	307.54	347	0	0	0	extreme
10	58781870	58782145	MACS_peak_2486	825.15	275	0	1	0	extreme
10	60647314	60647546	MACS_peak_2495	532.66	232	0	1	0	extreme
10	60816590	60816860	MACS_peak_2497	851.59	270	0	0	0	extreme
10	62028959	62029171	MACS_peak_2502	596.79	212	0	1	0	extreme
10	62304482	62304646	MACS_peak_2503	534.96	164	0	0	0	extreme
10	62710013	62710250	MACS_peak_2507	404.91	237	0	0	1	extreme
10	62954925	62955229	MACS_peak_2508	119.15	304	0	0	0	extreme
10	63720019	63720359	MACS_peak_2511	1054.89	340	0	0	1	extreme
10	67855689	67855934	MACS_peak_2552	494.55	245	0	0	0	extreme
10	67974050	67974184	MACS_peak_2553	1072.4	134	0	1	0	extreme
10	68061779	68062020	MACS_peak_2555	430.9	241	0	1	0	extreme
10	69958192	69958553	MACS_peak_2560	1034.22	361	0	1	0	extreme
10	70220704	70221079	MACS_peak_2561	404.42	375	0	1	0	extreme
10	70387721	70388078	MACS_peak_2562	528	357	0	0	0	extreme
10	70759042	70759419	MACS_peak_2563	516.8	377	0	1	0	extreme
10	71023324	71023679	MACS_peak_2564	413.79	355	0	0	1	extreme
10	71853960	71854111	MACS_peak_2566	936.57	151	0	0	0	extreme
10	72696076	72696292	MACS_peak_2567	328.76	216	1	0	0	extreme
10	72875224	72875542	MACS_peak_2568	676.68	318	0	1	0	extreme
10	73307281	73307559	MACS_peak_2570	709.17	278	0	1	0	extreme
10	73328510	73328874	MACS_peak_2571	61.7	364	0	1	0	extreme
10	74103650	74103854	MACS_peak_2572	616.96	204	0	1	0	extreme
10	75187995	75188263	MACS_peak_2578	462.14	268	0	0	0	extreme
10	77793528	77793670	MACS_peak_2595	1549.78	142	1	0	0	extreme
10	86398182	86398542	MACS_peak_2665	178.37	360	0	0	0	extreme
10	86960470	86960735	MACS_peak_2666	464.09	265	1	1	0	extreme
10	87735160	87735524	MACS_peak_2674	409.51	364	0	1	0	extreme
10	88654032	88654308	MACS_peak_2680	229.83	276	0	0	0	extreme
10	89260428	89260657	MACS_peak_2683	548.55	229	0	1	0	extreme
10	89320368	89320661	MACS_peak_2684	97.29	293	0	1	0	extreme
10	89320840	89321269	MACS_peak_2685	208.52	429	0	1	0	extreme
10	90851327	90851630	MACS_peak_2692	312.33	303	0	1	0	extreme
10	92140577	92140960	MACS_peak_2708	109.04	383	0	1	0	extreme
10	92894942	92895124	MACS_peak_2711	522.04	182	0	1	0	extreme
10	93854408	93854547	MACS_peak_2721	1884.9	139	0	0	0	extreme
10	94444405	94444631	MACS_peak_2726	640.7	226	0	1	0	extreme
10	96511277	96511493	MACS_peak_2740	746.04	216	0	1	0	extreme
10	96734906	96735253	MACS_peak_2741	158.81	347	0	0	0	extreme
10	97277126	97277456	MACS_peak_2746	88.51	330	0	2	1	extreme
10	97676655	97676988	MACS_peak_2748	1344.22	333	1	0	0	extreme
10	97731835	97732126	MACS_peak_2750	447.93	291	0	0	0	extreme
10	99506764	99506957	MACS_peak_2768	866.35	193	0	0	0	extreme
10	99845913	99846091	MACS_peak_2771	763.02	178	0	1	0	extreme
10	99892567	99892837	MACS_peak_2772	127.5	270	0	1	0	extreme
10	100338516	100338896	MACS_peak_2774	608.29	380	0	0	1	extreme
10	100675061	100675322	MACS_peak_2776	142.05	261	0	0	0	extreme
10	100797930	100798126	MACS_peak_2777	848.95	196	0	1	0	extreme
10	101366735	101367066	MACS_peak_2785	667.02	331	0	1	0	extreme
10	102229677	102230104	MACS_peak_2787	491.28	427	2	0	0	extreme
10	102916884	102917097	MACS_peak_2792	451.43	213	1	0	0	extreme
10	103368822	103369002	MACS_peak_2794	936.57	180	1	0	0	extreme
10	103461864	103462157	MACS_peak_2795	201.59	293	0	0	1	extreme
10	103542829	103543065	MACS_peak_2796	662.31	236	0	1	0	extreme
10	104274719	104274999	MACS_peak_2798	454.58	280	0	1	0	extreme
10	109830474	109830862	MACS_peak_2839	87.24	388	0	0	0	extreme
10	110514369	110514605	MACS_peak_2841	235.88	236	0	0	0	extreme
10	110856324	110856749	MACS_peak_2842	137.17	425	0	0	0	extreme
10	112253430	112253745	MACS_peak_2857	114.44	315	0	0	0	extreme
10	113942482	113942869	MACS_peak_2858	488.85	387	0	0	0	extreme
10	117138075	117138219	MACS_peak_2876	989.9	144	0	1	0	extreme
10	117357679	117357899	MACS_peak_2877	360.97	220	0	1	0	extreme
10	117684734	117685085	MACS_peak_2878	415.73	351	0	0	0	extreme
10	118067262	118067549	MACS_peak_2880	62.8	287	0	0	1	extreme
10	118423820	118424145	MACS_peak_2881	428.92	325	0	0	0	extreme
10	118505924	118506176	MACS_peak_2883	470.06	252	0	0	0	extreme
10	118913215	118913552	MACS_peak_2885	539.88	337	0	0	0	extreme
10	119183334	119183498	MACS_peak_2886	685.59	164	0	0	0	extreme
10	119209487	119209718	MACS_peak_2888	532.66	231	1	0	1	extreme
10	119819209	119819347	MACS_peak_2890	1406.54	138	0	1	0	extreme
10	120441241	120441519	MACS_peak_2892	143.68	278	0	0	0	extreme
10	121734597	121734831	MACS_peak_2897	532.66	234	0	0	0	extreme
10	122612166	122612365	MACS_peak_2899	286.1	199	0	1	0	extreme
10	122807323	122807683	MACS_peak_2901	147.82	360	0	0	1	extreme
10	123532707	123532965	MACS_peak_2905	595.17	258	0	0	0	extreme
10	124532108	124532439	MACS_peak_2908	543.58	331	0	1	0	extreme
10	124745470	124745894	MACS_peak_2909	727.24	424	1	1	0	extreme
10	125048033	125048324	MACS_peak_2910	447.93	291	0	1	0	extreme
10	125700753	125700950	MACS_peak_2914	662.31	197	0	0	2	extreme
10	128072555	128072691	MACS_peak_2933	912.05	136	0	1	0	extreme
10	128571820	128572150	MACS_peak_2934	426.3	330	0	0	0	extreme
10	130109789	130110034	MACS_peak_2942	629.38	245	0	1	0	extreme
10	130316362	130316802	MACS_peak_2943	59.26	440	0	0	1	extreme
10	131704770	131705022	MACS_peak_2949	105.86	252	0	0	0	extreme
10	132052336	132052586	MACS_peak_2950	613.04	250	0	0	0	extreme
10	132080395	132080528	MACS_peak_2951	1087.62	133	0	0	0	extreme
10	132904212	132904538	MACS_peak_2952	670.69	326	0	1	0	extreme
10	133240779	133241133	MACS_peak_2954	312.33	354	1	0	0	extreme
10	133330386	133330622	MACS_peak_2956	303.43	236	0	2	0	extreme
10	133647136	133647610	MACS_peak_2958	524.9	474	0	0	0	extreme
11	68087	68350	MACS_peak_2959	238.44	263	0	0	0	extreme
11	135290	135527	MACS_peak_2964	950.21	237	0	0	2	extreme
11	362016	362287	MACS_peak_2968	272.05	271	0	0	0	extreme
11	509403	509703	MACS_peak_2969	380.3	300	0	0	0	extreme
11	1643847	1644229	MACS_peak_2971	331.44	382	0	0	0	extreme
11	2286522	2286694	MACS_peak_2973	625.78	172	0	0	0	extreme
11	3417100	3417304	MACS_peak_2974	1171.45	204	0	0	1	extreme
11	3609743	3610062	MACS_peak_2980	432.12	319	0	0	0	extreme
11	3899480	3899850	MACS_peak_2981	78.78	370	0	1	0	extreme
11	4001919	4002238	MACS_peak_2982	132.43	319	0	1	0	extreme
11	4171209	4171529	MACS_peak_2983	76.05	320	0	0	0	extreme
11	6189665	6189998	MACS_peak_3004	148.05	333	0	0	0	extreme
11	6282117	6282285	MACS_peak_3005	1626.92	168	0	0	0	extreme
11	6353376	6353725	MACS_peak_3006	532.67	349	0	0	0	extreme
11	6531347	6531655	MACS_peak_3007	438.15	308	0	1	0	extreme
11	6763206	6763351	MACS_peak_3008	452.67	145	1	0	0	extreme
11	7739598	7739943	MACS_peak_3017	80.32	345	0	0	1	extreme
11	8201099	8201434	MACS_peak_3018	331.06	335	0	0	0	extreme
11	8566758	8567013	MACS_peak_3024	470.06	255	0	1	0	extreme
11	9506832	9507101	MACS_peak_3026	526.09	269	0	1	0	extreme
11	10406135	10406575	MACS_peak_3033	485.15	440	0	1	0	extreme
11	10614733	10615087	MACS_peak_3034	110.89	354	0	1	0	extreme
11	11715098	11715313	MACS_peak_3035	267.62	215	0	0	0	extreme
11	12288572	12288846	MACS_peak_3036	582.68	274	0	1	0	extreme
11	13239013	13239444	MACS_peak_3042	722.76	431	0	0	0	extreme
11	14400859	14401024	MACS_peak_3057	847.14	165	0	0	0	extreme
11	14811236	14811494	MACS_peak_3071	78.59	258	0	1	0	extreme
11	15074887	15075228	MACS_peak_3073	918.59	341	0	1	0	extreme
11	16565499	16565762	MACS_peak_3084	247.51	263	0	1	0	extreme
11	17030571	17030815	MACS_peak_3087	129.76	244	0	0	1	extreme
11	17342326	17342659	MACS_peak_3088	64.79	333	0	1	0	extreme
11	17354538	17354673	MACS_peak_3089	1079.97	135	1	0	0	extreme
11	18053823	18054304	MACS_peak_3095	665.94	481	0	0	0	extreme
11	18120153	18120317	MACS_peak_3096	481.81	164	1	0	0	extreme
11	18171313	18171652	MACS_peak_3097	421.69	339	1	0	1	extreme
11	18732073	18732262	MACS_peak_3099	695.57	189	1	0	1	extreme
11	20110925	20111256	MACS_peak_3108	425.78	331	0	1	0	extreme
11	20576321	20576629	MACS_peak_3109	85.6	308	0	0	0	extreme
11	22525123	22525505	MACS_peak_3124	73.44	382	0	0	0	extreme
11	22697653	22698004	MACS_peak_3126	159.51	351	0	1	0	extreme
11	27268838	27269157	MACS_peak_3173	158.81	319	0	0	0	extreme
11	27485942	27486210	MACS_peak_3174	1587.43	268	0	0	0	extreme
11	28029415	28029635	MACS_peak_3178	127.99	220	0	1	0	extreme
11	30314678	30314909	MACS_peak_3201	532.66	231	0	0	0	extreme
11	30346194	30346402	MACS_peak_3202	1305.85	208	0	0	0	extreme
11	31356523	31356788	MACS_peak_3206	159.56	265	0	1	0	extreme
11	32323554	32323797	MACS_peak_3213	402.63	243	0	0	1	extreme
11	32606978	32607202	MACS_peak_3214	303.32	224	1	0	0	extreme
11	32884845	32885117	MACS_peak_3217	459.58	272	0	0	0	extreme
11	33166220	33166507	MACS_peak_3221	488.85	287	0	0	1	extreme
11	33988084	33988363	MACS_peak_3222	438.47	279	0	0	0	extreme
11	34687557	34687866	MACS_peak_3223	120.84	309	0	0	0	extreme
11	34776261	34776493	MACS_peak_3226	483.43	232	0	0	0	extreme
11	35238108	35238438	MACS_peak_3230	426.3	330	0	0	0	extreme
11	36350867	36351108	MACS_peak_3235	690.17	241	0	1	0	extreme
11	36557160	36557515	MACS_peak_3237	115.71	355	0	1	0	extreme
11	43282948	43283225	MACS_peak_3281	1125.73	277	0	0	0	extreme
11	43503536	43503747	MACS_peak_3283	591.86	211	0	0	0	extreme
11	44550608	44550953	MACS_peak_3288	914.97	345	0	0	0	extreme
11	46247627	46247806	MACS_peak_3295	746.04	179	0	0	0	extreme
11	46919784	46920266	MACS_peak_3301	448.43	482	0	0	0	extreme
11	47454260	47454504	MACS_peak_3304	1725.79	244	0	0	0	extreme
11	47853381	47853733	MACS_peak_3307	446.42	352	0	0	0	extreme
11	57025705	57026074	MACS_peak_3420	765.37	369	0	0	0	extreme
11	58052120	58052402	MACS_peak_3421	259.16	282	0	1	1	extreme
11	58541460	58541827	MACS_peak_3426	128.75	367	0	1	0	extreme
11	58817825	58818193	MACS_peak_3427	114.74	368	0	0	0	extreme
11	59018502	59018780	MACS_peak_3428	76.3	278	0	1	1	extreme
11	59405989	59406288	MACS_peak_3429	254.93	299	0	0	0	extreme
11	59406767	59407113	MACS_peak_3430	72.05	346	0	0	0	extreme
11	60012513	60012740	MACS_peak_3432	152.23	227	0	1	0	extreme
11	60158723	60159012	MACS_peak_3433	956.98	289	0	0	0	extreme
11	60193642	60193902	MACS_peak_3434	725.38	260	0	1	0	extreme
11	60343173	60343410	MACS_peak_3437	662.31	237	0	1	0	extreme
11	60535944	60536265	MACS_peak_3439	55.71	321	0	1	0	extreme
11	60660713	60660911	MACS_peak_3444	642.68	198	0	0	1	extreme
11	61086058	61086472	MACS_peak_3447	201.96	414	0	0	0	extreme
11	61181878	61182104	MACS_peak_3449	453.33	226	0	0	0	extreme
11	61671631	61671851	MACS_peak_3452	697.97	220	0	0	0	extreme
11	61989143	61989420	MACS_peak_3453	488.85	277	0	0	0	extreme
11	62082135	62082359	MACS_peak_3456	712.32	224	0	0	0	extreme
11	62153618	62153767	MACS_peak_3457	1187.29	149	0	0	0	extreme
11	62542772	62543008	MACS_peak_3461	814.37	236	0	1	0	extreme
11	62905950	62906283	MACS_peak_3463	542.34	333	1	0	0	extreme
11	63593144	63593390	MACS_peak_3477	485.56	246	0	1	0	extreme
11	64553572	64553821	MACS_peak_3480	485.56	249	1	0	0	extreme
11	64787623	64787829	MACS_peak_3481	629.38	206	1	0	0	extreme
11	65510835	65511079	MACS_peak_3485	629.38	244	0	0	0	extreme
11	65706054	65706514	MACS_peak_3487	1603.4	460	0	0	0	extreme
11	65769760	65770055	MACS_peak_3489	445.58	295	0	0	1	extreme
11	65989047	65989489	MACS_peak_3492	1065.16	442	0	0	0	extreme
11	66045164	66045468	MACS_peak_3493	561.16	304	1	0	0	extreme
11	66678570	66678825	MACS_peak_3498	596.79	255	0	0	0	extreme
11	67572682	67573000	MACS_peak_3504	551.85	318	0	0	0	extreme
11	67614294	67614514	MACS_peak_3505	729.14	220	0	0	1	extreme
11	67713911	67714246	MACS_peak_3506	796.34	335	0	0	1	extreme
11	67938951	67939361	MACS_peak_3510	2161.52	410	0	0	1	extreme
11	68632904	68633230	MACS_peak_3513	775.47	326	0	0	0	extreme
11	68950475	68950765	MACS_peak_3515	448.52	290	0	0	0	extreme
11	69000833	69001285	MACS_peak_3516	709.74	452	1	0	1	extreme
11	70196104	70196428	MACS_peak_3522	806.6	324	0	0	0	extreme
11	70467499	70467879	MACS_peak_3523	633.81	380	1	0	0	extreme
11	71343610	71343862	MACS_peak_3525	746.04	252	0	0	0	extreme
11	71773042	71773269	MACS_peak_3532	808.3	227	0	0	1	extreme
11	71813832	71814104	MACS_peak_3534	651.79	272	1	0	1	extreme
11	72144036	72144341	MACS_peak_3537	796.56	305	0	0	0	extreme
11	72176144	72176454	MACS_peak_3538	265.34	310	0	0	2	extreme
11	73295494	73295816	MACS_peak_3548	549.27	322	0	1	0	extreme
11	73625627	73626003	MACS_peak_3554	636.35	376	0	0	0	extreme
11	73989260	73989510	MACS_peak_3557	561.71	250	0	0	0	extreme
11	74255764	74256123	MACS_peak_3558	526.85	359	0	1	0	extreme
11	74453452	74453718	MACS_peak_3563	588.83	266	1	0	1	extreme
11	74702403	74702629	MACS_peak_3565	548.55	226	0	1	0	extreme
11	74929763	74930046	MACS_peak_3573	490.8	283	0	1	0	extreme
11	75022975	75023197	MACS_peak_3574	564.54	222	0	0	0	extreme
11	75371375	75371541	MACS_peak_3580	479.76	166	0	0	0	extreme
11	76207599	76207856	MACS_peak_3590	595.98	257	0	1	0	extreme
11	76432964	76433124	MACS_peak_3591	955.37	160	0	0	0	extreme
11	76826746	76827116	MACS_peak_3592	77.85	370	0	0	0	extreme
11	77091310	77091502	MACS_peak_3598	1061.85	192	0	1	0	extreme
11	77277738	77278103	MACS_peak_3599	63.13	365	0	1	0	extreme
11	77484191	77484324	MACS_peak_3603	1011.74	133	0	0	0	extreme
11	78420396	78420670	MACS_peak_3610	458.32	274	0	0	1	extreme
11	78586378	78586857	MACS_peak_3611	422.76	479	0	0	0	extreme
11	82718178	82718477	MACS_peak_3649	443.26	299	0	0	0	extreme
11	83324412	83324686	MACS_peak_3652	260.97	274	0	0	1	extreme
11	85504173	85504438	MACS_peak_3671	232.87	265	0	1	0	extreme
11	85694447	85694730	MACS_peak_3672	1236.43	283	1	0	0	extreme
11	85850626	85850965	MACS_peak_3675	112.52	339	1	0	0	extreme
11	86291879	86292075	MACS_peak_3677	662.31	196	0	0	0	extreme
11	86408895	86409259	MACS_peak_3680	898.35	364	0	1	0	extreme
11	90186799	90187182	MACS_peak_3715	114.74	383	0	1	0	extreme
11	90400233	90400569	MACS_peak_3716	133.12	336	0	0	1	extreme
11	93427739	93428185	MACS_peak_3735	159.56	446	0	1	0	extreme
11	94038731	94039074	MACS_peak_3736	87.67	343	0	1	0	extreme
11	94042075	94042461	MACS_peak_3738	100.37	386	0	1	0	extreme
11	94189894	94190157	MACS_peak_3739	240.87	263	0	0	0	extreme
11	94375177	94375559	MACS_peak_3743	76.3	382	1	0	0	extreme
11	94922177	94922391	MACS_peak_3744	746.04	214	0	0	1	extreme
11	95324560	95324899	MACS_peak_3745	530.67	339	0	0	0	extreme
11	95626547	95626754	MACS_peak_3749	212.94	207	0	0	1	extreme
11	101280770	101281113	MACS_peak_3775	260.74	343	0	0	0	extreme
11	101884152	101884409	MACS_peak_3781	595.98	257	0	0	0	extreme
11	102504198	102504508	MACS_peak_3782	62.07	310	0	0	0	extreme
11	103039077	103039381	MACS_peak_3784	60.35	304	0	0	0	extreme
11	103114190	103114488	MACS_peak_3785	692.37	298	0	0	0	extreme
11	105019044	105019451	MACS_peak_3795	76.41	407	0	1	0	extreme
11	105349036	105349402	MACS_peak_3796	272.05	366	0	1	0	extreme
11	105413721	105414178	MACS_peak_3797	124.51	457	0	1	0	extreme
11	106154533	106154665	MACS_peak_3798	977.06	132	0	0	0	extreme
11	107227918	107228053	MACS_peak_3801	1079.97	135	0	0	0	extreme
11	108136318	108136598	MACS_peak_3806	454.58	280	0	1	0	extreme
11	108374596	108374885	MACS_peak_3810	84.4	289	0	1	0	extreme
11	111446623	111446904	MACS_peak_3829	706.57	281	0	1	0	extreme
11	112324461	112324792	MACS_peak_3830	84.4	331	0	0	1	extreme
11	113532811	113533014	MACS_peak_3834	629.38	203	0	0	0	extreme
11	114124461	114124675	MACS_peak_3836	596.79	214	0	1	0	extreme
11	114537764	114538134	MACS_peak_3837	83.89	370	0	1	0	extreme
11	116574532	116574985	MACS_peak_3856	59.66	453	0	0	0	extreme
11	117637214	117637395	MACS_peak_3858	1426.21	181	0	1	0	extreme
11	118145281	118145513	MACS_peak_3866	678.9	232	0	1	0	extreme
11	118295902	118296125	MACS_peak_3868	1377.21	223	0	0	0	extreme
11	118353046	118353396	MACS_peak_3869	416.22	350	0	1	0	extreme
11	118659531	118659793	MACS_peak_3872	1000.58	262	1	0	0	extreme
11	118690199	118690436	MACS_peak_3874	662.31	237	0	0	1	extreme
11	119479747	119480049	MACS_peak_3877	562.53	302	0	0	1	extreme
11	119743932	119744184	MACS_peak_3878	309.73	252	0	0	0	extreme
11	121324251	121324468	MACS_peak_3879	146.53	217	0	0	0	extreme
11	123470490	123470637	MACS_peak_3894	893.54	147	0	1	0	extreme
11	124236602	124236931	MACS_peak_3895	105.65	329	1	0	0	extreme
11	124586123	124586448	MACS_peak_3899	671.43	325	0	0	0	extreme
11	124913118	124913541	MACS_peak_3900	1155.88	423	0	0	0	extreme
11	125131503	125131950	MACS_peak_3901	159.56	447	0	0	0	extreme
11	125383451	125383767	MACS_peak_3903	678.2	316	0	1	0	extreme
11	125784068	125784413	MACS_peak_3904	142.52	345	1	0	0	extreme
11	127375398	127375826	MACS_peak_3907	724.67	428	0	0	0	extreme
11	128378181	128378607	MACS_peak_3909	134.69	426	0	0	0	extreme
11	129713213	129713616	MACS_peak_3917	160.65	403	0	0	0	extreme
11	129912632	129912948	MACS_peak_3918	420.49	316	0	1	0	extreme
11	130942854	130943183	MACS_peak_3919	146.47	329	0	0	0	extreme
11	134106167	134106481	MACS_peak_3932	169.25	314	0	1	0	extreme
12	27818	28258	MACS_peak_3935	594.49	440	0	0	1	extreme
12	11279	11730	MACS_peak_3936	2807.74	451	0	0	0	extreme
12	576173	576377	MACS_peak_3939	797.18	204	0	1	0	extreme
12	1000313	1000509	MACS_peak_3941	662.31	196	0	1	0	extreme
12	2682883	2683226	MACS_peak_3949	536.24	343	0	1	1	extreme
12	4180414	4180752	MACS_peak_3961	79.97	338	0	0	0	extreme
12	4707934	4708122	MACS_peak_3965	883.81	188	0	1	1	extreme
12	5988618	5988841	MACS_peak_3978	564.54	223	0	1	0	extreme
12	6423520	6423862	MACS_peak_3979	420.18	342	0	0	0	extreme
12	7162635	7163008	MACS_peak_3982	405.33	373	0	0	0	extreme
12	7506456	7506792	MACS_peak_3984	59.47	336	0	0	0	extreme
12	7631634	7631975	MACS_peak_3986	641.27	341	0	0	0	extreme
12	8108854	8109102	MACS_peak_3988	485.56	248	0	0	1	extreme
12	8537669	8538016	MACS_peak_3991	260.52	347	1	0	0	extreme
12	8954764	8954958	MACS_peak_3992	584.47	194	1	0	0	extreme
12	9851216	9851371	MACS_peak_3997	783.55	155	1	0	0	extreme
12	10148318	10148584	MACS_peak_4001	450.1	266	0	0	0	extreme
12	10337178	10337473	MACS_peak_4002	93.4	295	0	0	1	extreme
12	12049721	12049856	MACS_peak_4020	1666.76	135	1	0	0	extreme
12	12779619	12779924	MACS_peak_4023	686.76	305	0	1	0	extreme
12	13607121	13607478	MACS_peak_4031	528	357	0	1	0	extreme
12	14723765	14724025	MACS_peak_4033	593.56	260	0	0	1	extreme
12	15856484	15856670	MACS_peak_4039	1965.34	186	0	1	0	extreme
12	15944700	15945006	MACS_peak_4040	172.39	306	0	1	0	extreme
12	22139924	22140184	MACS_peak_4071	106.93	260	0	1	0	extreme
12	22709314	22709591	MACS_peak_4072	456.44	277	0	0	1	extreme
12	26029273	26029573	MACS_peak_4088	958.39	300	0	1	0	extreme
12	26863776	26864137	MACS_peak_4093	488.85	361	0	0	0	extreme
12	27014441	27014644	MACS_peak_4094	629.38	203	0	0	0	extreme
12	27167939	27168322	MACS_peak_4097	218.92	383	0	0	0	extreme
12	27384132	27384463	MACS_peak_4098	667.02	331	0	1	0	extreme
12	27652277	27652458	MACS_peak_4100	936.57	181	0	1	0	extreme
12	28003609	28003794	MACS_peak_4102	300.04	185	0	0	0	extreme
12	28007233	28007517	MACS_peak_4106	85.58	284	0	0	0	extreme
12	28764429	28764843	MACS_peak_4110	105.25	414	0	0	0	extreme
12	29408414	29408840	MACS_peak_4111	50.33	426	1	0	1	extreme
12	32251994	32252236	MACS_peak_4126	936.57	242	0	1	0	extreme
12	32919106	32919477	MACS_peak_4128	1585.55	371	0	0	0	extreme
12	42228860	42229199	MACS_peak_4220	103.45	339	0	1	0	extreme
12	47010306	47010598	MACS_peak_4256	62.38	292	0	0	0	extreme
12	47717479	47717774	MACS_peak_4257	445.58	295	0	1	1	extreme
12	47837670	47837872	MACS_peak_4258	645.81	202	1	0	1	extreme
12	48577853	48578195	MACS_peak_4270	129.22	342	0	0	0	extreme
12	48959716	48960060	MACS_peak_4271	406.81	344	0	0	0	extreme
12	49150128	49150290	MACS_peak_4272	1501.05	162	0	0	0	extreme
12	49288300	49288678	MACS_peak_4276	758.75	378	1	0	0	extreme
12	49358719	49358964	MACS_peak_4277	629.38	245	0	0	0	extreme
12	49553552	49553805	MACS_peak_4279	596.79	253	1	1	0	extreme
12	49867181	49867396	MACS_peak_4283	746.04	215	1	0	0	extreme
12	50055951	50056241	MACS_peak_4284	831.82	290	1	0	0	extreme
12	50132596	50132878	MACS_peak_4286	576.71	282	1	0	1	extreme
12	50504733	50505013	MACS_peak_4287	465.75	280	1	0	0	extreme
12	50976872	50977240	MACS_peak_4292	101.93	368	1	0	0	extreme
12	51292183	51292446	MACS_peak_4293	420.71	263	0	1	0	extreme
12	51926784	51927023	MACS_peak_4302	516.86	239	0	0	0	extreme
12	52083459	52083797	MACS_peak_4303	539.27	338	1	0	0	extreme
12	52380174	52380442	MACS_peak_4312	587.27	268	1	0	0	extreme
12	52507021	52507391	MACS_peak_4313	520.65	370	0	0	0	extreme
12	52667551	52667763	MACS_peak_4314	763.02	212	0	0	0	extreme
12	53053668	53053937	MACS_peak_4321	717.14	269	0	1	1	extreme
12	53099445	53099820	MACS_peak_4323	1156.51	375	2	0	0	extreme
12	53421346	53421634	MACS_peak_4324	378.95	288	1	0	0	extreme
12	53451767	53451969	MACS_peak_4325	989.9	202	1	0	1	extreme
12	53791585	53791943	MACS_peak_4329	527.43	358	0	0	0	extreme
12	54220087	54220430	MACS_peak_4331	1015.34	343	0	0	0	extreme
12	54399248	54399540	MACS_peak_4333	697.28	292	1	0	2	extreme
12	54579795	54580062	MACS_peak_4334	588.05	267	1	0	0	extreme
12	54854040	54854360	MACS_peak_4342	404.16	320	0	1	0	extreme
12	55072240	55072533	MACS_peak_4343	696.46	293	0	0	0	extreme
12	55737207	55737476	MACS_peak_4359	842.54	269	0	0	0	extreme
12	56052156	56052459	MACS_peak_4362	363.26	303	0	0	0	extreme
12	56126130	56126433	MACS_peak_4363	561.84	303	0	2	1	extreme
12	56148897	56149030	MACS_peak_4364	843.09	133	1	0	0	extreme
12	56192934	56193259	MACS_peak_4365	1030.29	325	0	0	0	extreme
12	56302337	56302688	MACS_peak_4367	345.59	351	0	1	1	extreme
12	56757517	56757851	MACS_peak_4375	1102.09	334	0	1	0	extreme
12	56973099	56973398	MACS_peak_4379	147.3	299	0	0	0	extreme
12	57102760	57103015	MACS_peak_4380	283.13	255	0	1	0	extreme
12	57239078	57239388	MACS_peak_4383	557.12	310	2	0	0	extreme
12	57650754	57651104	MACS_peak_4385	133.58	350	0	0	0	extreme
12	63103567	63103939	MACS_peak_4441	519.54	372	0	0	0	extreme
12	63319353	63319659	MACS_peak_4442	439.28	306	0	0	1	extreme
12	64367111	64367379	MACS_peak_4462	377.04	268	0	1	1	extreme
12	65123356	65123783	MACS_peak_4468	605.87	427	0	0	0	extreme
12	66096985	66097414	MACS_peak_4479	63.8	429	0	0	0	extreme
12	66222425	66222665	MACS_peak_4480	468.75	240	0	1	0	extreme
12	66279239	66279534	MACS_peak_4482	488.85	295	0	0	0	extreme
12	66523872	66524232	MACS_peak_4483	52.4	360	0	1	0	extreme
12	68711530	68711663	MACS_peak_4504	811.9	133	0	1	0	extreme
12	70023053	70023267	MACS_peak_4528	561.02	214	0	0	1	extreme
12	75201163	75201389	MACS_peak_4578	423.66	226	0	1	0	extreme
12	75390885	75391277	MACS_peak_4579	626.35	392	1	0	0	extreme
12	88939536	88939768	MACS_peak_4749	230.05	232	0	0	0	extreme
12	90978254	90978455	MACS_peak_4761	1377.21	201	0	1	0	extreme
12	91234997	91235304	MACS_peak_4762	158.81	307	0	0	0	extreme
12	93399264	93399572	MACS_peak_4776	307.98	308	0	1	0	extreme
12	93569592	93569860	MACS_peak_4778	603.02	268	1	0	1	extreme
12	94764300	94764587	MACS_peak_4787	601.95	287	0	0	0	extreme
12	95024059	95024330	MACS_peak_4788	460.22	271	1	0	0	extreme
12	95534444	95534709	MACS_peak_4791	464.09	265	0	1	0	extreme
12	95820168	95820500	MACS_peak_4795	620.49	332	0	0	2	extreme
12	95926419	95926788	MACS_peak_4796	109	369	0	1	0	extreme
12	100058526	100058846	MACS_peak_4838	431.58	320	0	1	0	extreme
12	101264141	101264470	MACS_peak_4846	50.49	329	0	0	0	extreme
12	101413585	101413942	MACS_peak_4848	113.94	357	0	0	0	extreme
12	101670119	101670301	MACS_peak_4853	729.14	182	0	1	0	extreme
12	101759510	101759735	MACS_peak_4854	784.07	225	0	1	0	extreme
12	101999414	101999626	MACS_peak_4856	758.25	212	0	1	0	extreme
12	103870546	103870779	MACS_peak_4883	532.66	233	0	0	1	extreme
12	104057726	104057974	MACS_peak_4884	485.56	248	0	1	0	extreme
12	105779344	105779808	MACS_peak_4902	52.57	464	0	0	0	extreme
12	107048403	107048661	MACS_peak_4909	1005.37	258	0	1	0	extreme
12	107676199	107676515	MACS_peak_4916	1478.55	316	0	0	0	extreme
12	107720177	107720438	MACS_peak_4917	430.8	261	0	0	0	extreme
12	108755317	108755538	MACS_peak_4922	300.83	221	0	0	0	extreme
12	108761364	108761741	MACS_peak_4923	349.84	377	0	0	0	extreme
12	109002072	109002384	MACS_peak_4927	180.46	312	0	1	0	extreme
12	109428037	109428361	MACS_peak_4929	729.82	324	0	1	0	extreme
12	109432860	109433050	MACS_peak_4931	767.82	190	0	1	0	extreme
12	109845337	109845603	MACS_peak_4932	463.44	266	0	0	0	extreme
12	109880439	109880697	MACS_peak_4933	727.26	258	0	0	0	extreme
12	110224390	110224751	MACS_peak_4934	410.92	361	0	0	0	extreme
12	110577164	110577299	MACS_peak_4937	1924.49	135	0	1	0	extreme
12	110866474	110866804	MACS_peak_4938	166.45	330	0	1	0	extreme
12	111274955	111275155	MACS_peak_4942	645.81	200	0	1	0	extreme
12	111831182	111831615	MACS_peak_4945	55.46	433	0	0	0	extreme
12	111939449	111939686	MACS_peak_4946	375.48	237	0	1	0	extreme
12	111945301	111945589	MACS_peak_4947	378.95	288	0	1	0	extreme
12	112622021	112622293	MACS_peak_4952	50.71	272	0	1	0	extreme
12	112628569	112628711	MACS_peak_4954	527.36	142	0	1	0	extreme
12	113098454	113098734	MACS_peak_4959	454.58	280	1	0	0	extreme
12	116617804	116617938	MACS_peak_4975	1212.73	134	0	0	0	extreme
12	117212612	117212852	MACS_peak_4976	936.57	240	1	0	0	extreme
12	117763062	117763370	MACS_peak_4979	158.81	308	0	1	0	extreme
12	118078926	118079072	MACS_peak_4980	1103.27	146	0	1	0	extreme
12	118128728	118128964	MACS_peak_4981	235.3	236	0	1	0	extreme
12	118181605	118181986	MACS_peak_4982	346.86	381	0	1	0	extreme
12	118201827	118202128	MACS_peak_4983	1386.14	301	0	1	0	extreme
12	119938145	119938374	MACS_peak_4999	695.57	229	0	0	0	extreme
12	120201291	120201461	MACS_peak_5000	777.13	170	1	0	1	extreme
12	120430464	120430796	MACS_peak_5003	350.2	332	0	0	0	extreme
12	120647003	120647264	MACS_peak_5006	724.45	261	0	1	0	extreme
12	120926805	120927080	MACS_peak_5009	488.85	275	0	0	0	extreme
12	121060576	121060915	MACS_peak_5011	896.47	339	0	0	0	extreme
12	121061854	121062163	MACS_peak_5012	683.61	309	0	0	0	extreme
12	121794872	121795125	MACS_peak_5018	470.06	253	0	1	0	extreme
12	121862540	121862717	MACS_peak_5019	939.42	177	0	1	0	extreme
12	122054373	122054610	MACS_peak_5020	793.98	237	0	1	0	extreme
12	122131093	122131310	MACS_peak_5021	580.62	217	0	1	0	extreme
12	122578936	122579306	MACS_peak_5025	103.45	370	0	1	0	extreme
12	122710294	122710457	MACS_peak_5027	987.39	163	1	0	1	extreme
12	122793571	122793926	MACS_peak_5028	413.79	355	0	1	0	extreme
12	123365765	123365995	MACS_peak_5031	532.66	230	0	0	1	extreme
12	124022516	124022659	MACS_peak_5036	667.47	143	0	2	0	extreme
12	124906789	124907132	MACS_peak_5043	1051.86	343	1	0	0	extreme
12	125183193	125183438	MACS_peak_5044	501.16	245	1	0	0	extreme
12	128492800	128493146	MACS_peak_5074	92	346	0	1	0	extreme
12	129040574	129040920	MACS_peak_5075	131.32	346	0	0	0	extreme
12	130818987	130819247	MACS_peak_5088	467.38	260	0	1	0	extreme
12	131503168	131503504	MACS_peak_5089	162.94	336	0	0	0	extreme
12	131588359	131588826	MACS_peak_5091	169.67	467	0	0	0	extreme
12	132962075	132962441	MACS_peak_21897	408.57	366	0	0	0	extreme
13	19612863	19613135	MACS_peak_5104	116.19	272	0	0	0	extreme
13	19927176	19927557	MACS_peak_5107	1092.16	381	0	0	0	extreme
13	20163481	20163745	MACS_peak_5108	998.2	264	0	0	0	extreme
13	20229046	20229255	MACS_peak_5110	318.29	209	0	1	0	extreme
13	21134879	21135127	MACS_peak_5114	350.87	248	0	0	0	extreme
13	21251516	21251763	MACS_peak_5115	204.19	247	0	0	0	extreme
13	21279874	21280112	MACS_peak_5116	116.87	238	0	0	1	extreme
13	21477096	21477280	MACS_peak_5117	729.14	184	0	0	0	extreme
13	22868631	22868931	MACS_peak_5134	2338.57	300	0	0	0	extreme
13	24737658	24738049	MACS_peak_5142	603.02	391	0	0	1	extreme
13	24994893	24995129	MACS_peak_5143	972.07	236	0	0	0	extreme
13	25823174	25823353	MACS_peak_5145	531.2	179	0	1	0	extreme
13	26112876	26113161	MACS_peak_5150	765.03	285	0	0	1	extreme
13	26361679	26361818	MACS_peak_5151	911.62	139	0	1	0	extreme
13	26946980	26947273	MACS_peak_5154	488.85	293	0	0	0	extreme
13	27198666	27198948	MACS_peak_5155	453.35	282	0	0	1	extreme
13	27339308	27339627	MACS_peak_5156	361.66	319	0	0	0	extreme
13	27998002	27998207	MACS_peak_5162	629.38	205	0	0	0	extreme
13	28679661	28679892	MACS_peak_5166	532.66	231	0	0	0	extreme
13	29642765	29643194	MACS_peak_5170	78.83	429	0	0	0	extreme
13	30246185	30246554	MACS_peak_5176	249.05	369	0	1	0	extreme
13	30948378	30948754	MACS_peak_5177	165.72	376	0	1	0	extreme
13	30993772	30994125	MACS_peak_5178	295.66	353	0	0	0	extreme
13	31307800	31308168	MACS_peak_5180	116.5	368	0	1	0	extreme
13	32145439	32145751	MACS_peak_5182	229.83	312	0	1	0	extreme
13	32564608	32565032	MACS_peak_5184	1069.92	424	0	0	0	extreme
13	32581166	32581508	MACS_peak_5185	672.97	342	0	0	0	extreme
13	33077754	33078016	MACS_peak_5190	395.02	262	0	0	0	extreme
13	33372336	33372554	MACS_peak_5192	729.14	218	0	0	1	extreme
13	33723936	33724223	MACS_peak_5194	573.07	287	0	0	0	extreme
13	36736180	36736411	MACS_peak_5212	532.66	231	0	0	0	extreme
13	37069098	37069319	MACS_peak_5213	564.54	221	0	0	0	extreme
13	37154334	37154722	MACS_peak_5215	96.37	388	0	0	0	extreme
13	37608824	37609040	MACS_peak_5216	817.99	216	0	0	0	extreme
13	38328972	38329241	MACS_peak_5226	992.36	269	0	0	0	extreme
13	38582244	38582519	MACS_peak_5227	457.69	275	0	0	0	extreme
13	39004761	39005171	MACS_peak_5231	59.86	410	0	0	0	extreme
13	39612113	39612381	MACS_peak_5232	993.52	268	0	0	0	extreme
13	40361957	40362332	MACS_peak_5239	101.09	375	0	0	1	extreme
13	40830348	40830722	MACS_peak_5243	56.65	374	0	0	1	extreme
13	40865336	40865739	MACS_peak_5245	104.85	403	0	0	1	extreme
13	41196706	41196966	MACS_peak_5247	725.38	260	0	0	1	extreme
13	41400910	41401236	MACS_peak_5251	799.5	326	0	0	0	extreme
13	42030958	42031331	MACS_peak_5252	66.19	373	0	0	0	extreme
13	42426807	42427153	MACS_peak_5255	56.42	346	0	0	1	extreme
13	42429888	42430281	MACS_peak_5256	137.25	393	0	0	1	extreme
13	44169764	44170005	MACS_peak_5270	645.81	241	0	0	1	extreme
13	45047231	45047682	MACS_peak_5272	592.81	451	0	0	1	extreme
13	45309515	45309730	MACS_peak_5273	596.79	215	0	0	0	extreme
13	45393963	45394308	MACS_peak_5274	535.04	345	1	0	0	extreme
13	45879803	45880159	MACS_peak_5281	528.58	356	0	0	0	extreme
13	46126629	46126896	MACS_peak_5282	854.69	267	1	0	0	extreme
13	46721162	46721469	MACS_peak_5290	603.02	307	0	1	0	extreme
13	46831639	46831914	MACS_peak_5291	611.86	275	1	0	0	extreme
13	47717799	47718109	MACS_peak_5304	149.97	310	0	0	0	extreme
13	48095107	48095341	MACS_peak_5313	623.55	234	0	0	0	extreme
13	49483508	49483650	MACS_peak_5318	847.53	142	0	1	0	extreme
13	49846969	49847335	MACS_peak_5319	408.57	366	0	0	0	extreme
13	50100938	50101145	MACS_peak_5320	780.06	207	0	0	2	extreme
13	50504895	50505261	MACS_peak_5323	134.3	366	0	0	1	extreme
13	51074840	51075243	MACS_peak_5326	233.98	403	0	0	1	extreme
13	51514148	51514414	MACS_peak_5328	122.54	266	0	0	1	extreme
13	51845176	51845409	MACS_peak_5331	972.07	233	0	0	0	extreme
13	52055961	52056310	MACS_peak_5332	76.25	349	0	1	0	extreme
13	52269848	52270203	MACS_peak_5336	128.53	355	0	0	2	extreme
13	52591874	52592231	MACS_peak_5337	229.9	357	0	0	0	extreme
13	57411199	57411541	MACS_peak_5359	164.26	342	0	0	0	extreme
13	58024396	58024547	MACS_peak_5360	630.94	151	0	0	0	extreme
13	59030216	59030641	MACS_peak_5370	169.55	425	0	0	0	extreme
13	60335662	60335986	MACS_peak_5377	429.45	324	0	0	0	extreme
13	72696639	72696878	MACS_peak_5449	516.86	239	0	0	0	extreme
13	75278069	75278429	MACS_peak_5469	97.28	360	0	0	0	extreme
13	75695811	75696126	MACS_peak_5470	808.97	315	0	1	1	extreme
13	76903658	76903912	MACS_peak_5478	596.79	254	0	0	0	extreme
13	77478399	77478683	MACS_peak_5479	452.13	284	0	0	0	extreme
13	78496500	78496697	MACS_peak_5486	662.31	197	0	0	1	extreme
13	79236528	79236751	MACS_peak_5487	144.63	223	0	0	0	extreme
13	94374325	94374569	MACS_peak_5571	93.41	244	0	1	0	extreme
13	95002629	95002857	MACS_peak_5572	198.86	228	0	0	0	extreme
13	95380845	95380977	MACS_peak_5575	1116.4	132	0	0	0	extreme
13	96075970	96076265	MACS_peak_5577	445.58	295	0	0	0	extreme
13	97734589	97734847	MACS_peak_5583	89.53	258	0	0	0	extreme
13	98033393	98033603	MACS_peak_5584	473.4	210	0	0	0	extreme
13	98058900	98059356	MACS_peak_5585	702.21	456	0	0	0	extreme
13	98605924	98606293	MACS_peak_5587	765.37	369	0	0	0	extreme
13	98683205	98683567	MACS_peak_5588	312.33	362	1	0	0	extreme
13	101155975	101156178	MACS_peak_5595	629.38	203	0	1	0	extreme
13	102526934	102527284	MACS_peak_5601	61.44	350	0	0	0	extreme
13	103883066	103883392	MACS_peak_5602	428.39	326	0	0	0	extreme
13	106218375	106218826	MACS_peak_5613	96.97	451	0	0	0	extreme
13	106781401	106781818	MACS_peak_5614	77.64	417	0	0	0	extreme
13	108176689	108176907	MACS_peak_5626	580.62	218	0	0	0	extreme
13	108322241	108322585	MACS_peak_5627	419.18	344	0	0	0	extreme
13	110111834	110112191	MACS_peak_5642	55.2	357	0	0	0	extreme
13	110944369	110944597	MACS_peak_5643	1171.45	228	0	0	0	extreme
13	112409264	112409613	MACS_peak_5647	62.38	349	0	1	0	extreme
13	114218849	114219179	MACS_peak_5653	93.4	330	0	1	0	extreme
13	114339939	114340140	MACS_peak_5654	989.9	201	0	0	0	extreme
13	18211683	18211905	MACS_peak_21744	564.54	222	0	0	1	extreme
14	18225786	18225996	MACS_peak_5655	88.25	210	0	0	0	extreme
14	20238112	20238567	MACS_peak_5706	441.6	455	1	0	0	extreme
14	20606400	20606593	MACS_peak_5707	678.9	193	0	2	1	extreme
14	20609338	20609692	MACS_peak_5708	414.27	354	0	2	0	extreme
14	20873733	20873967	MACS_peak_5711	532.66	234	0	0	0	extreme
14	21067877	21068028	MACS_peak_5712	630.94	151	1	1	0	extreme
14	21068397	21068698	MACS_peak_5713	560.03	301	1	1	0	extreme
14	21188915	21189333	MACS_peak_5717	149.97	418	0	0	0	extreme
14	21641209	21641401	MACS_peak_5719	2354.81	192	0	0	0	extreme
14	22557093	22557462	MACS_peak_5738	521.76	369	0	0	1	extreme
14	22653111	22653466	MACS_peak_5739	1606.87	355	0	0	0	extreme
14	22657939	22658249	MACS_peak_5740	439.97	310	0	0	0	extreme
14	22872617	22872829	MACS_peak_5741	763.02	212	1	0	0	extreme
14	22953680	22954016	MACS_peak_5742	311.01	336	0	2	1	extreme
14	22994753	22994963	MACS_peak_5745	596.67	210	0	1	1	extreme
14	23317446	23317717	MACS_peak_5749	460.22	271	1	1	0	extreme
14	23562895	23563159	MACS_peak_5750	464.74	264	1	0	1	extreme
14	23899264	23899417	MACS_peak_5752	621.55	153	0	0	0	extreme
14	24279675	24279912	MACS_peak_5758	662.31	237	0	0	0	extreme
14	24450712	24451009	MACS_peak_5762	127.5	297	0	0	0	extreme
14	24489823	24490196	MACS_peak_5763	50.92	373	0	0	0	extreme
14	24522558	24522773	MACS_peak_5764	433.22	215	0	0	0	extreme
14	24584757	24585107	MACS_peak_5765	84.4	350	0	0	0	extreme
14	24678934	24679246	MACS_peak_5766	1226.35	312	0	0	0	extreme
14	26393992	26394340	MACS_peak_5793	760.25	348	0	0	0	extreme
14	26688671	26688965	MACS_peak_5794	83.45	294	0	0	1	extreme
14	30562227	30562554	MACS_peak_5829	258.94	327	1	0	1	extreme
14	31082028	31082333	MACS_peak_5836	686.76	305	0	1	0	extreme
14	31277901	31278156	MACS_peak_5838	264.71	255	0	0	1	extreme
14	34349730	34350109	MACS_peak_5866	1017.46	379	0	1	0	extreme
14	34672708	34672907	MACS_peak_5867	645.81	199	0	0	0	extreme
14	35215138	35215333	MACS_peak_5868	848.95	195	0	2	0	extreme
14	35229563	35229911	MACS_peak_5869	596.75	348	0	2	0	extreme
14	35437652	35437784	MACS_peak_5871	977.06	132	0	0	0	extreme
14	36556873	36557122	MACS_peak_5880	1043.77	249	0	0	1	extreme
14	39091727	39091928	MACS_peak_5919	1354.48	201	0	1	0	extreme
14	39262875	39263277	MACS_peak_5920	171.46	402	0	1	0	extreme
14	44913711	44913949	MACS_peak_5979	729.92	238	0	0	0	extreme
14	45268594	45268859	MACS_peak_5980	450.75	265	0	0	0	extreme
14	49536472	49536685	MACS_peak_6044	607.68	213	0	0	0	extreme
14	49865482	49865685	MACS_peak_6049	1080.52	203	0	0	0	extreme
14	49912581	49912808	MACS_peak_6050	435.26	227	0	0	0	extreme
14	50619647	50619896	MACS_peak_6055	397.9	249	0	1	0	extreme
14	50714540	50714748	MACS_peak_6056	770.35	208	0	0	0	extreme
14	51219937	51220201	MACS_peak_6062	319.23	264	0	0	0	extreme
14	51838479	51838737	MACS_peak_6069	468.72	258	0	1	0	extreme
14	52015599	52015898	MACS_peak_6070	443.26	299	0	1	0	extreme
14	52529774	52530035	MACS_peak_6078	410.97	261	0	1	0	extreme
14	52807743	52807998	MACS_peak_6080	456.71	255	0	0	2	extreme
14	54372598	54372809	MACS_peak_6099	368.39	211	0	0	0	extreme
14	54489059	54489287	MACS_peak_6101	548.55	228	0	0	0	extreme
14	54564037	54564338	MACS_peak_6102	689.95	301	1	0	0	extreme
14	54903077	54903457	MACS_peak_6105	402.16	380	0	0	0	extreme
14	55242515	55242814	MACS_peak_6111	959.43	299	0	0	0	extreme
14	55438082	55438364	MACS_peak_6116	523.12	282	0	1	0	extreme
14	57183006	57183356	MACS_peak_6139	955.64	350	0	0	0	extreme
14	57340843	57341252	MACS_peak_6144	51.32	409	0	0	0	extreme
14	57454737	57454875	MACS_peak_6145	704.53	138	0	0	0	extreme
14	58166479	58166731	MACS_peak_6153	746.04	252	0	1	0	extreme
14	58501172	58501487	MACS_peak_6155	884.12	315	0	1	0	extreme
14	59055513	59055792	MACS_peak_6159	1551.79	279	0	0	0	extreme
14	59507384	59507620	MACS_peak_6160	516.86	236	1	0	1	extreme
14	60079810	60080083	MACS_peak_6171	376.45	273	0	0	1	extreme
14	60424423	60424796	MACS_peak_6177	100.22	373	0	1	0	extreme
14	61708070	61708364	MACS_peak_6190	99.82	294	0	1	0	extreme
14	61837711	61837950	MACS_peak_6191	642.42	239	0	1	0	extreme
14	63308837	63309003	MACS_peak_6212	1043.77	166	1	0	0	extreme
14	63563015	63563389	MACS_peak_6215	449.15	374	0	0	0	extreme
14	64303470	64303792	MACS_peak_6218	673.67	322	0	1	0	extreme
14	65222385	65222681	MACS_peak_6225	445	296	0	0	0	extreme
14	67213442	67213759	MACS_peak_6243	79.58	317	0	1	0	extreme
14	67584129	67584422	MACS_peak_6244	446.75	293	1	1	0	extreme
14	67837027	67837371	MACS_peak_6245	374.96	344	0	1	0	extreme
14	68582526	68582906	MACS_peak_6250	127.5	380	0	1	0	extreme
14	69248107	69248513	MACS_peak_6253	617.94	406	0	0	1	extreme
14	70270809	70270946	MACS_peak_6264	813.46	137	0	0	0	extreme
14	70568008	70568200	MACS_peak_6266	651.85	192	0	0	0	extreme
14	70714106	70714278	MACS_peak_6267	797.18	172	0	0	0	extreme
14	70817706	70817941	MACS_peak_6268	1134.69	235	0	0	0	extreme
14	72912849	72913050	MACS_peak_6295	612.81	201	0	0	0	extreme
14	73777632	73777813	MACS_peak_6304	860.3	181	0	1	0	extreme
14	73836532	73836674	MACS_peak_6305	868.02	142	0	0	0	extreme
14	74257490	74257840	MACS_peak_6311	416.22	350	0	1	0	extreme
14	74362310	74362647	MACS_peak_6312	539.88	337	0	0	0	extreme
14	74913920	74914262	MACS_peak_6317	536.84	342	0	1	0	extreme
14	75296252	75296474	MACS_peak_6319	394.77	222	0	0	1	extreme
14	75488857	75489106	MACS_peak_6321	485.56	249	0	0	0	extreme
14	76633703	76633872	MACS_peak_6328	814.37	169	0	0	1	extreme
14	76886279	76886464	MACS_peak_6329	712.32	185	0	0	0	extreme
14	76913672	76913995	MACS_peak_6330	416.74	323	0	0	0	extreme
14	77070759	77070984	MACS_peak_6331	895.4	225	0	0	2	extreme
14	77168206	77168418	MACS_peak_6332	526.96	212	0	2	0	extreme
14	77269597	77269912	MACS_peak_6333	721.05	315	1	0	0	extreme
14	77862220	77862538	MACS_peak_6336	551.85	318	0	1	0	extreme
14	88189466	88189682	MACS_peak_6417	580.62	216	0	1	0	extreme
14	88796765	88797203	MACS_peak_6423	1498.01	438	0	0	0	extreme
14	89020686	89020896	MACS_peak_6424	597.38	210	0	0	1	extreme
14	89915259	89915673	MACS_peak_6428	1986.91	414	0	1	1	extreme
14	90057641	90057940	MACS_peak_6429	229.83	299	1	0	0	extreme
14	90235470	90235693	MACS_peak_6432	712.32	223	0	0	0	extreme
14	90289350	90289625	MACS_peak_6433	496.66	275	0	1	0	extreme
14	91431123	91431484	MACS_peak_6443	124.37	361	0	0	0	extreme
14	91556482	91556837	MACS_peak_6444	356.34	355	0	0	0	extreme
14	91562941	91563348	MACS_peak_6445	152.66	407	0	0	0	extreme
14	92382713	92383010	MACS_peak_6448	565.98	297	0	1	0	extreme
14	92783887	92784134	MACS_peak_6453	485.56	247	0	0	0	extreme
14	93072608	93072740	MACS_peak_6454	1083.63	132	0	1	0	extreme
14	93112869	93113102	MACS_peak_6455	429.38	233	0	1	0	extreme
14	93465027	93465428	MACS_peak_6458	950.42	401	0	1	0	extreme
14	94036530	94036749	MACS_peak_6462	580.62	219	0	1	0	extreme
14	94259658	94259921	MACS_peak_6463	380.3	263	0	1	0	extreme
14	94486399	94486586	MACS_peak_6466	901.33	187	1	0	0	extreme
14	95099133	95099348	MACS_peak_6467	596.79	215	0	1	0	extreme
14	95994334	95994611	MACS_peak_6471	580.42	277	0	0	0	extreme
14	96297017	96297308	MACS_peak_6472	1173.86	291	0	1	0	extreme
14	99393207	99393354	MACS_peak_6482	972.07	147	1	0	0	extreme
14	99628914	99629161	MACS_peak_6483	629.38	247	0	0	0	extreme
14	100181619	100181941	MACS_peak_6486	127.5	322	0	0	0	extreme
14	101628495	101628711	MACS_peak_6496	1264.23	216	0	0	0	extreme
14	101961143	101961440	MACS_peak_6498	825.22	297	1	0	0	extreme
14	102524466	102524720	MACS_peak_6501	470.06	254	0	0	0	extreme
14	103273069	103273218	MACS_peak_6508	458.32	149	0	0	0	extreme
14	103613619	103613828	MACS_peak_6510	596.67	209	0	2	0	extreme
14	103808462	103808683	MACS_peak_6511	564.54	221	0	1	0	extreme
14	103893390	103893652	MACS_peak_6512	859.93	262	0	0	0	extreme
14	103980690	103981094	MACS_peak_6513	693.28	404	0	1	0	extreme
14	104640029	104640271	MACS_peak_6521	645.81	242	0	0	0	extreme
14	104896739	104897173	MACS_peak_6522	534.92	434	0	0	0	extreme
14	105090523	105090751	MACS_peak_6524	548.55	228	0	0	0	extreme
14	105480944	105481109	MACS_peak_6526	1061.85	165	0	0	0	extreme
14	105557215	105557524	MACS_peak_6527	1204.12	309	0	0	0	extreme
14	106873076	106873340	MACS_peak_6551	464.09	264	0	0	0	extreme
15	19795148	19795530	MACS_peak_6552	68.69	382	0	0	0	extreme
15	22609675	22609921	MACS_peak_6606	796.85	246	0	0	1	extreme
15	23128948	23129162	MACS_peak_6610	1061.17	214	1	0	0	extreme
15	24767362	24767765	MACS_peak_6629	720	403	0	0	0	extreme
15	25479077	25479212	MACS_peak_6631	1666.76	135	0	0	0	extreme
15	27852853	27853233	MACS_peak_6638	105.38	380	0	1	0	extreme
15	28704170	28704334	MACS_peak_6647	1113.8	164	1	0	0	extreme
15	29414513	29414811	MACS_peak_6649	62.47	298	0	1	0	extreme
15	29668058	29668362	MACS_peak_6651	687.55	304	0	0	0	extreme
15	30859263	30859580	MACS_peak_6672	552.5	317	0	0	0	extreme
15	31237915	31238050	MACS_peak_6674	1666.76	135	0	0	0	extreme
15	31867965	31868225	MACS_peak_6675	1002.97	260	0	1	0	extreme
15	33964127	33964395	MACS_peak_6694	699.35	268	1	1	0	extreme
15	34708397	34708724	MACS_peak_6696	427.87	327	0	0	0	extreme
15	34814317	34814449	MACS_peak_6697	1396.21	132	0	0	0	extreme
15	35078520	35078769	MACS_peak_6698	827.31	249	0	0	0	extreme
15	39756975	39757330	MACS_peak_6733	413.79	355	0	1	0	extreme
15	40045039	40045472	MACS_peak_6734	721.49	433	0	0	1	extreme
15	40077722	40077876	MACS_peak_6735	1365.09	154	0	0	1	extreme
15	40904071	40904267	MACS_peak_6740	1025.76	196	0	0	0	extreme
15	41560288	41560426	MACS_peak_6743	1320.51	138	1	0	0	extreme
15	41989588	41989780	MACS_peak_6744	1061.85	192	0	1	1	extreme
15	42137770	42138024	MACS_peak_6746	596.79	254	1	0	0	extreme
15	42765926	42766131	MACS_peak_6749	113.48	205	0	1	0	extreme
15	43204375	43204678	MACS_peak_6752	819.69	303	0	1	1	extreme
15	43289751	43290037	MACS_peak_6753	123.55	286	0	1	0	extreme
15	44255812	44256236	MACS_peak_6757	54.41	424	0	0	0	extreme
15	44853407	44853777	MACS_peak_6763	351.78	370	0	0	1	extreme
15	45054550	45054911	MACS_peak_6768	71.38	361	0	1	1	extreme
15	45268526	45268983	MACS_peak_6769	75.01	457	0	1	1	extreme
15	45457901	45458265	MACS_peak_6772	524.01	364	0	0	1	extreme
15	45618332	45618703	MACS_peak_6773	520.09	371	0	1	0	extreme
15	47279104	47279489	MACS_peak_6784	126.25	385	0	1	0	extreme
15	48357957	48358337	MACS_peak_6785	402.16	380	0	0	0	extreme
15	48861879	48862170	MACS_peak_6788	570.2	291	0	1	0	extreme
15	50316109	50316454	MACS_peak_6804	649.93	345	0	1	0	extreme
15	51585220	51585438	MACS_peak_6836	130.39	218	0	1	0	extreme
15	52476222	52476584	MACS_peak_6847	145.88	362	0	1	0	extreme
15	52780616	52780910	MACS_peak_6848	828.03	294	0	1	0	extreme
15	55108854	55109157	MACS_peak_6870	688.35	303	0	0	0	extreme
15	55217652	55217971	MACS_peak_6871	439.33	319	0	1	0	extreme
15	56461863	56462015	MACS_peak_6884	817.2	152	0	1	0	extreme
15	58347358	58347585	MACS_peak_6895	177.34	227	0	1	0	extreme
15	63487289	63487588	MACS_peak_6907	488.85	299	0	0	0	extreme
15	63945194	63945564	MACS_peak_6915	1161.6	370	0	1	0	extreme
15	65101688	65101956	MACS_peak_6921	462.14	268	0	1	0	extreme
15	65304286	65304635	MACS_peak_6923	654.27	349	0	0	0	extreme
15	65517691	65517958	MACS_peak_6924	913.96	267	0	0	0	extreme
15	66252281	66252576	MACS_peak_6928	445.58	295	0	1	0	extreme
15	66712687	66712820	MACS_peak_6932	1098.16	133	0	1	0	extreme
15	68252999	68253234	MACS_peak_6938	972.07	235	0	1	0	extreme
15	68383540	68383765	MACS_peak_6939	548.55	225	0	1	0	extreme
15	68674141	68674358	MACS_peak_6945	580.62	217	0	1	0	extreme
15	69265398	69265687	MACS_peak_6948	699.78	289	0	1	0	extreme
15	69575990	69576378	MACS_peak_6949	628.81	388	0	0	1	extreme
15	70663089	70663365	MACS_peak_6954	142.05	276	0	1	0	extreme
15	72670607	72670945	MACS_peak_6978	1269.98	338	0	0	0	extreme
15	73062963	73063184	MACS_peak_6979	482.68	221	0	1	0	extreme
15	74382444	74382660	MACS_peak_6997	746.04	216	0	0	1	extreme
15	74769003	74769390	MACS_peak_7002	511.42	387	0	0	0	extreme
15	74835292	74835634	MACS_peak_7003	420.18	342	1	0	0	extreme
15	74950373	74950647	MACS_peak_7006	932.94	274	1	0	0	extreme
15	75250040	75250329	MACS_peak_7008	770.52	289	0	0	0	extreme
15	75299345	75299508	MACS_peak_7012	822.5	163	0	0	0	extreme
15	76057444	76057748	MACS_peak_7016	440.4	304	1	1	0	extreme
15	77262996	77263343	MACS_peak_7029	76.91	347	0	1	0	extreme
15	77618441	77618610	MACS_peak_7030	3108.84	169	0	1	0	extreme
15	77917457	77917767	MACS_peak_7034	312.33	310	0	0	2	extreme
15	78422891	78423128	MACS_peak_7035	814.37	237	0	0	0	extreme
15	78606336	78606598	MACS_peak_7037	402.25	262	0	1	0	extreme
15	78736211	78736566	MACS_peak_7039	301.94	355	0	0	1	extreme
15	79769219	79769434	MACS_peak_7049	746.04	215	0	0	0	extreme
15	80455749	80456091	MACS_peak_7051	659.14	342	0	1	0	extreme
15	82108527	82108800	MACS_peak_7069	388.02	273	0	0	0	extreme
15	82530869	82531066	MACS_peak_7077	641.55	197	0	0	0	extreme
15	82530869	82531066	MACS_peak_7087	641.55	197	0	0	0	extreme
15	82743321	82743543	MACS_peak_7088	614.29	222	0	0	0	extreme
15	82789213	82789472	MACS_peak_7089	506.92	259	0	1	0	extreme
15	82884135	82884612	MACS_peak_7090	56.89	477	0	1	0	extreme
15	83073896	83074116	MACS_peak_7091	400.18	220	0	0	2	extreme
15	84587938	84588265	MACS_peak_7106	427.87	327	0	0	0	extreme
15	84845638	84845884	MACS_peak_7107	629.38	246	0	1	0	extreme
15	88940672	88941152	MACS_peak_7132	101.68	480	0	0	0	extreme
15	89206726	89207134	MACS_peak_7136	1214.08	408	1	0	0	extreme
15	89416403	89416650	MACS_peak_7137	763.02	247	0	0	0	extreme
15	89565702	89565914	MACS_peak_7144	1146.55	212	0	0	1	extreme
15	89842206	89842427	MACS_peak_7145	549.18	221	0	2	0	extreme
15	90320009	90320292	MACS_peak_7151	575.98	283	0	0	0	extreme
15	90581247	90581505	MACS_peak_7153	380.3	258	0	1	0	extreme
15	90693730	90693992	MACS_peak_7155	1002.15	262	0	0	1	extreme
15	90886068	90886486	MACS_peak_7156	495.64	418	1	0	0	extreme
15	90956591	90956788	MACS_peak_7157	806.85	197	1	0	0	extreme
15	91092937	91093288	MACS_peak_7159	56.38	351	0	0	0	extreme
15	98904483	98904737	MACS_peak_7232	470.06	254	0	1	0	extreme
15	100349732	100349958	MACS_peak_7243	548.55	226	0	0	0	extreme
15	101300157	101300617	MACS_peak_7254	588.1	460	1	0	2	extreme
15	101402629	101402956	MACS_peak_7255	102.4	327	0	1	0	extreme
15	101979444	101979817	MACS_peak_7271	2333.78	373	0	0	0	extreme
16	18644	19042	MACS_peak_7273	272.05	398	0	0	1	extreme
16	22681	22994	MACS_peak_7274	399.72	313	0	0	1	extreme
16	386633	386855	MACS_peak_7276	867.76	222	0	1	1	extreme
16	743339	743651	MACS_peak_7279	539.85	312	0	0	0	extreme
16	1249536	1249869	MACS_peak_7281	789.4	333	0	0	0	extreme
16	1812693	1812941	MACS_peak_7282	485.56	248	0	1	0	extreme
16	1929680	1929985	MACS_peak_7284	439.84	305	0	0	0	extreme
16	2639184	2639374	MACS_peak_7286	695.57	190	0	0	1	extreme
16	2670196	2670463	MACS_peak_7288	740.61	267	0	0	1	extreme
16	2795120	2795373	MACS_peak_7289	746.04	253	1	0	0	extreme
16	2874834	2875176	MACS_peak_7291	659.14	342	0	0	0	extreme
16	2961838	2962162	MACS_peak_7293	672.17	324	1	0	0	extreme
16	2983730	2983954	MACS_peak_7294	564.54	224	1	0	0	extreme
16	3074597	3074746	MACS_peak_7295	1964.25	149	0	1	0	extreme
16	3166014	3166268	MACS_peak_7296	601.15	254	0	0	0	extreme
16	4045404	4045733	MACS_peak_7298	349.84	329	0	1	0	extreme
16	8660981	8661245	MACS_peak_7321	658.98	264	0	0	0	extreme
16	8873627	8874013	MACS_peak_7322	1815.39	386	0	0	0	extreme
16	9139075	9139318	MACS_peak_7324	936.57	243	0	0	0	extreme
16	10477568	10477928	MACS_peak_7339	56.38	360	0	1	0	extreme
16	10971445	10971748	MACS_peak_7341	440.97	303	0	1	0	extreme
16	11737748	11738100	MACS_peak_7349	371.07	352	0	1	0	extreme
16	11921996	11922175	MACS_peak_7350	531.2	179	0	0	0	extreme
16	13740023	13740265	MACS_peak_7360	645.81	242	0	0	1	extreme
16	14386998	14387372	MACS_peak_7362	222.62	374	0	0	0	extreme
16	14897251	14897636	MACS_peak_7365	1722.91	385	0	0	0	extreme
16	14995106	14995545	MACS_peak_7367	185.07	439	0	1	0	extreme
16	15114682	15114961	MACS_peak_7368	137.17	279	0	1	2	extreme
16	15223479	15223857	MACS_peak_7370	603.02	378	0	0	0	extreme
16	15427652	15427855	MACS_peak_7371	705.57	203	0	1	0	extreme
16	15655862	15656216	MACS_peak_7372	180.31	354	0	1	0	extreme
16	15821746	15822111	MACS_peak_7374	439.1	365	0	1	0	extreme
16	16127799	16128112	MACS_peak_7375	488.85	313	0	1	0	extreme
16	18759981	18760261	MACS_peak_7395	915.13	280	0	0	0	extreme
16	18825774	18826163	MACS_peak_7396	86.37	389	0	1	0	extreme
16	19086545	19086772	MACS_peak_7398	695.57	227	0	0	0	extreme
16	19601289	19601634	MACS_peak_7405	657.04	345	0	1	0	extreme
16	20653531	20653883	MACS_peak_7412	124.75	352	0	2	0	extreme
16	20743262	20743606	MACS_peak_7413	405.97	344	0	1	0	extreme
16	20774795	20775051	MACS_peak_7414	729.14	256	0	1	0	extreme
16	20998699	20998875	MACS_peak_7415	526.96	176	0	1	0	extreme
16	21554908	21555199	MACS_peak_7418	447.93	291	0	0	0	extreme
16	21849352	21849580	MACS_peak_7425	167.15	228	0	1	0	extreme
16	22001022	22001351	MACS_peak_7426	426.82	329	0	0	0	extreme
16	22099073	22099325	MACS_peak_7429	470.06	252	0	1	0	extreme
16	23253070	23253368	MACS_peak_7440	1243.82	298	0	0	0	extreme
16	24010558	24010744	MACS_peak_7446	1098.16	186	0	1	0	extreme
16	24499265	24499477	MACS_peak_7449	596.79	212	0	0	0	extreme
16	24906395	24906616	MACS_peak_7455	561.48	221	0	1	0	extreme
16	25233802	25234013	MACS_peak_7457	596.79	211	1	0	0	extreme
16	27234957	27235213	MACS_peak_7465	580.75	256	0	1	0	extreme
16	28070721	28071008	MACS_peak_7470	450.32	287	0	0	0	extreme
16	28750291	28750510	MACS_peak_7482	854.34	219	1	0	1	extreme
16	28852131	28852537	MACS_peak_7483	864.57	406	0	1	0	extreme
16	28852593	28852928	MACS_peak_7484	664.12	335	0	1	0	extreme
16	29094728	29095095	MACS_peak_7485	361.23	367	0	0	3	extreme
16	29752627	29752964	MACS_peak_7496	229.83	337	0	0	0	extreme
16	29848600	29848843	MACS_peak_7498	487.14	243	0	0	0	extreme
16	30032250	30032490	MACS_peak_7500	502.51	240	0	1	0	extreme
16	30210401	30210729	MACS_peak_7502	285.42	328	0	0	0	extreme
16	30449838	30450066	MACS_peak_7504	677.53	228	0	0	0	extreme
16	30499919	30500168	MACS_peak_7505	388.7	249	0	1	0	extreme
16	30598242	30598502	MACS_peak_7506	353.78	260	1	0	1	extreme
16	30865612	30865918	MACS_peak_7508	611.86	306	0	1	0	extreme
16	30985027	30985214	MACS_peak_7509	712.32	187	2	0	1	extreme
16	31281913	31282233	MACS_peak_7511	76.3	320	0	1	0	extreme
16	31342179	31342539	MACS_peak_7513	54.35	360	0	0	0	extreme
16	31443068	31443380	MACS_peak_7514	1084.56	312	0	0	0	extreme
16	31477932	31478178	MACS_peak_7516	629.38	246	0	0	0	extreme
16	31696931	31697298	MACS_peak_7517	486.96	367	0	0	0	extreme
16	46556967	46557344	MACS_peak_7640	272.05	377	0	0	1	extreme
16	46644716	46644983	MACS_peak_7643	337	267	0	0	0	extreme
16	46782529	46782758	MACS_peak_7644	870.15	229	0	1	0	extreme
16	46947883	46948094	MACS_peak_7647	596.79	211	0	0	0	extreme
16	47913432	47913900	MACS_peak_7652	102.26	468	0	0	0	extreme
16	48019991	48020181	MACS_peak_7653	98.82	190	0	0	0	extreme
16	48473589	48473964	MACS_peak_7655	120.92	375	0	0	0	extreme
16	48769207	48769506	MACS_peak_7656	60.26	299	0	0	0	extreme
16	49232111	49232397	MACS_peak_7661	142.05	286	0	0	0	extreme
16	50255997	50256229	MACS_peak_7662	678.9	232	0	1	0	extreme
16	50667398	50667751	MACS_peak_7663	414.75	353	1	0	1	extreme
16	51250764	51251096	MACS_peak_7664	93.4	332	0	0	1	extreme
16	53401819	53402141	MACS_peak_7669	80.32	322	0	0	0	extreme
16	53510490	53510844	MACS_peak_7670	414.27	354	0	0	0	extreme
16	53539939	53540300	MACS_peak_7671	158.81	361	0	0	0	extreme
16	54047602	54047959	MACS_peak_7673	141.65	357	0	1	1	extreme
16	54106491	54106972	MACS_peak_7674	935.65	481	0	1	0	extreme
16	54702578	54702924	MACS_peak_7675	142.05	346	0	0	0	extreme
16	54920033	54920303	MACS_peak_7676	488.85	270	0	0	1	extreme
16	55599999	55600406	MACS_peak_7677	111.2	407	0	0	0	extreme
16	56157499	56157921	MACS_peak_7680	87.62	422	0	0	1	extreme
16	56533929	56534063	MACS_peak_7682	1098.16	134	0	0	0	extreme
16	56702111	56702485	MACS_peak_7683	637.63	374	0	0	0	extreme
16	57600338	57600720	MACS_peak_7687	632.55	382	0	0	0	extreme
16	57775515	57775816	MACS_peak_7688	563.21	301	0	1	0	extreme
16	58089680	58089977	MACS_peak_7690	256.17	297	0	0	0	extreme
16	58780459	58780679	MACS_peak_7691	162.72	220	0	0	1	extreme
16	66357510	66357858	MACS_peak_7738	912.29	348	0	0	0	extreme
16	66483806	66484033	MACS_peak_7739	1007.8	227	0	2	0	extreme
16	66765756	66766089	MACS_peak_7740	210.52	333	0	1	0	extreme
16	67273118	67273407	MACS_peak_7742	722.05	289	1	0	0	extreme
16	67340937	67341190	MACS_peak_7743	460.03	253	0	1	0	extreme
16	67510926	67511192	MACS_peak_7744	288.97	266	0	0	0	extreme
16	67521556	67521776	MACS_peak_7745	564.54	220	1	0	1	extreme
16	67816101	67816244	MACS_peak_7746	463.04	143	0	1	0	extreme
16	68111204	68111416	MACS_peak_7749	561.02	212	0	1	1	extreme
16	68116337	68116607	MACS_peak_7750	851.59	270	0	1	1	extreme
16	68800399	68800634	MACS_peak_7752	465.7	235	0	1	0	extreme
16	69246426	69246647	MACS_peak_7756	127.99	221	0	1	0	extreme
16	69533923	69534150	MACS_peak_7760	769.45	227	0	0	0	extreme
16	70165112	70165395	MACS_peak_7762	1056.06	283	0	0	1	extreme
16	70816548	70816820	MACS_peak_7765	651.79	272	0	1	0	extreme
16	70948451	70948896	MACS_peak_7768	99	445	0	1	0	extreme
16	71306644	71307004	MACS_peak_7769	141.68	360	0	0	0	extreme
16	71514495	71514866	MACS_peak_7773	721.05	371	0	1	1	extreme
16	71695740	71696084	MACS_peak_7774	380.7	344	0	1	0	extreme
16	72241874	72242126	MACS_peak_7778	1026.72	252	0	0	0	extreme
16	74238290	74238577	MACS_peak_7798	450.32	287	0	0	1	extreme
16	74309826	74310150	MACS_peak_7799	385.12	324	0	0	1	extreme
16	74454563	74454800	MACS_peak_7802	447.77	237	0	1	0	extreme
16	74706716	74706951	MACS_peak_7804	847.1	235	0	0	0	extreme
16	74813192	74813562	MACS_peak_7805	764.63	370	0	0	0	extreme
16	75487706	75488024	MACS_peak_7811	476.21	318	0	1	1	extreme
16	77171833	77172062	MACS_peak_7834	848.95	229	0	0	0	extreme
16	77505939	77506219	MACS_peak_7835	243.49	280	0	0	0	extreme
16	80526534	80526813	MACS_peak_7858	821.16	279	0	0	1	extreme
16	80644927	80645295	MACS_peak_7859	81.45	368	0	1	0	extreme
16	80728630	80728960	MACS_peak_7860	51.92	330	0	1	0	extreme
16	83887185	83887458	MACS_peak_7895	458.95	273	0	0	0	extreme
16	83953941	83954330	MACS_peak_7896	750.87	389	0	1	0	extreme
16	84156680	84156877	MACS_peak_7897	927.92	197	0	1	0	extreme
16	84186925	84187222	MACS_peak_7898	825.22	297	1	0	0	extreme
16	84511453	84511624	MACS_peak_7903	1007.8	171	0	1	0	extreme
16	84672365	84672579	MACS_peak_7904	1264.23	214	0	0	0	extreme
16	84848940	84849120	MACS_peak_7909	746.04	180	0	1	1	extreme
16	85759886	85760214	MACS_peak_7915	755.36	328	0	0	0	extreme
16	86265059	86265411	MACS_peak_7924	65.32	352	0	0	1	extreme
16	86678888	86679363	MACS_peak_7927	112.76	475	0	0	0	extreme
16	87316899	87317076	MACS_peak_7932	763.02	177	0	2	0	extreme
16	87653333	87653719	MACS_peak_7936	1011.16	386	0	1	0	extreme
16	87769241	87769516	MACS_peak_7937	1066.87	275	0	0	0	extreme
16	88559126	88559408	MACS_peak_7946	523.12	282	0	0	0	extreme
16	88743902	88744071	MACS_peak_7947	1025.76	169	0	1	1	extreme
16	88748034	88748245	MACS_peak_7948	1301.7	211	0	1	0	extreme
16	88816069	88816247	MACS_peak_7949	763.02	178	1	0	0	extreme
16	89106290	89106527	MACS_peak_7950	406.23	237	0	1	0	extreme
16	89186573	89186862	MACS_peak_7951	449.12	289	0	1	0	extreme
16	89565528	89565911	MACS_peak_7954	400.82	383	0	0	0	extreme
16	89752636	89752869	MACS_peak_7956	387.94	233	0	1	0	extreme
16	89860871	89861114	MACS_peak_7958	780.06	243	0	1	0	extreme
16	89945675	89945931	MACS_peak_7959	406.81	256	1	0	0	extreme
16	90201826	90202145	MACS_peak_7969	565.3	319	0	0	1	extreme
17	272219	272599	MACS_peak_7971	96.97	380	0	1	0	extreme
17	931769	932095	MACS_peak_7979	201.59	326	0	1	0	extreme
17	1310417	1310729	MACS_peak_7981	195.62	312	0	0	0	extreme
17	1311186	1311557	MACS_peak_7982	185.39	371	0	0	0	extreme
17	3148715	3148999	MACS_peak_7986	92.05	284	0	0	1	extreme
17	3456678	3457059	MACS_peak_7992	56.91	381	0	1	0	extreme
17	4404606	4404892	MACS_peak_7996	523.68	286	0	0	0	extreme
17	4565531	4565792	MACS_peak_7997	592.77	261	0	0	0	extreme
17	4654837	4655216	MACS_peak_7998	358.59	379	0	0	0	extreme
17	5841335	5841692	MACS_peak_8001	648.81	357	0	1	1	extreme
17	6293463	6293596	MACS_peak_8005	1098.16	133	0	0	0	extreme
17	6805584	6806064	MACS_peak_8006	63.03	480	0	1	0	extreme
17	7004837	7005079	MACS_peak_8010	645.81	242	0	1	2	extreme
17	7126336	7126585	MACS_peak_8011	413.37	249	0	0	0	extreme
17	7743535	7743937	MACS_peak_8012	908.25	402	0	1	0	extreme
17	7749204	7749435	MACS_peak_8013	2221.29	231	0	1	0	extreme
17	7972494	7972666	MACS_peak_8015	1453.47	172	0	0	0	extreme
17	8383211	8383587	MACS_peak_8019	403.97	376	0	0	0	extreme
17	8693984	8694194	MACS_peak_8020	613.04	210	0	0	0	extreme
17	8998088	8998393	MACS_peak_8023	439.84	305	0	0	0	extreme
17	10616605	10616906	MACS_peak_8035	829.25	301	0	0	2	extreme
17	10995979	10996261	MACS_peak_8038	312.33	282	0	0	0	extreme
17	11935879	11936192	MACS_peak_8043	555.13	313	0	1	0	extreme
17	12453181	12453620	MACS_peak_8048	71.93	439	0	0	0	extreme
17	13114508	13114824	MACS_peak_8051	433.75	316	0	0	0	extreme
17	13812263	13812457	MACS_peak_8055	819.6	194	0	0	1	extreme
17	15156123	15156384	MACS_peak_8058	466.72	261	0	0	0	extreme
17	15358932	15359400	MACS_peak_8060	122.63	468	0	0	0	extreme
17	15689745	15690066	MACS_peak_8063	229.83	321	0	0	0	extreme
17	15826602	15826918	MACS_peak_8064	619.83	316	0	0	0	extreme
17	16584208	16584481	MACS_peak_8065	713.56	273	0	0	0	extreme
17	16591134	16591312	MACS_peak_8067	831.12	178	0	0	0	extreme
17	16689925	16690236	MACS_peak_8068	1587.42	311	2	0	0	extreme
17	17001802	17002047	MACS_peak_8069	501.16	245	0	0	0	extreme
17	17356139	17356418	MACS_peak_8070	980.98	279	0	0	0	extreme
17	17388133	17388435	MACS_peak_8071	441.54	302	0	0	0	extreme
17	17619231	17619374	MACS_peak_8072	472.3	143	0	0	0	extreme
17	17641876	17642106	MACS_peak_8073	532.66	230	0	0	0	extreme
17	18563579	18563889	MACS_peak_8075	437.04	310	0	0	1	extreme
17	18689934	18690188	MACS_peak_8077	135.93	254	0	0	0	extreme
17	18816782	18817098	MACS_peak_8078	1815.75	316	0	0	0	extreme
17	19032413	19032665	MACS_peak_8079	883.81	252	0	1	1	extreme
17	19202273	19202639	MACS_peak_8088	345.92	366	0	0	0	extreme
17	20092192	20092324	MACS_peak_8090	1116.4	132	0	1	0	extreme
17	20992988	20993306	MACS_peak_8099	1102.85	318	0	0	1	extreme
17	21108104	21108343	MACS_peak_8102	368.72	239	0	0	0	extreme
17	21442594	21442736	MACS_peak_8104	684.56	142	0	1	0	extreme
17	28302434	28302576	MACS_peak_8137	1511.8	142	0	0	1	extreme
17	29198958	29199184	MACS_peak_8144	423.66	226	0	0	0	extreme
17	29899087	29899559	MACS_peak_8148	62.95	472	0	1	0	extreme
17	30023122	30023449	MACS_peak_8150	89.02	327	0	1	0	extreme
17	30359246	30359634	MACS_peak_8151	1143.6	388	0	0	0	extreme
17	30644561	30644710	MACS_peak_8152	1208.41	149	0	0	1	extreme
17	32135657	32135891	MACS_peak_8155	1039.87	234	0	0	0	extreme
17	32641096	32641440	MACS_peak_8156	103.03	344	0	1	1	extreme
17	34197429	34197672	MACS_peak_8163	501.16	243	0	0	0	extreme
17	35200242	35200563	MACS_peak_8164	69	321	0	0	0	extreme
17	35398576	35399000	MACS_peak_8166	128.99	424	0	0	0	extreme
17	35461470	35461755	MACS_peak_8167	574.52	285	1	0	0	extreme
17	35947154	35947356	MACS_peak_8168	966.16	202	0	0	0	extreme
17	36165924	36166301	MACS_peak_8169	623.32	377	1	0	1	extreme
17	36229689	36229999	MACS_peak_8170	2156.68	310	0	0	0	extreme
17	36377740	36378152	MACS_peak_8173	1267.71	412	1	0	0	extreme
17	37373534	37373857	MACS_peak_8175	548.63	323	1	1	0	extreme
17	37934749	37935161	MACS_peak_8176	765.67	412	0	1	0	extreme
17	38288367	38288585	MACS_peak_8180	742.08	218	0	0	0	extreme
17	38983179	38983507	MACS_peak_8182	1815.39	328	0	0	0	extreme
17	39207024	39207253	MACS_peak_8183	848.95	229	1	0	0	extreme
17	40377745	40377894	MACS_peak_8186	1222.2	149	0	0	0	extreme
17	41496793	41496992	MACS_peak_8195	831.63	199	1	0	0	extreme
17	41662723	41662958	MACS_peak_8196	516.86	235	0	0	0	extreme
17	41738098	41738303	MACS_peak_8198	629.38	205	0	0	0	extreme
17	42322818	42323081	MACS_peak_8202	837.49	263	0	1	0	extreme
17	42540589	42540829	MACS_peak_8204	960.62	240	1	0	1	extreme
17	42721082	42721265	MACS_peak_8205	666.39	183	0	1	0	extreme
17	43766451	43766759	MACS_peak_8211	1089.02	308	1	0	0	extreme
17	43887048	43887180	MACS_peak_8212	1116.4	132	0	1	0	extreme
17	43937567	43937882	MACS_peak_8213	380.3	315	1	0	0	extreme
17	44239218	44239545	MACS_peak_8214	155.69	327	0	0	0	extreme
17	44727758	44727899	MACS_peak_8215	1569.18	141	0	1	0	extreme
17	45135317	45135562	MACS_peak_8216	501.16	245	1	0	0	extreme
17	45738447	45738812	MACS_peak_8217	523.45	365	0	1	0	extreme
17	46002563	46002781	MACS_peak_8220	580.62	218	1	1	0	extreme
17	46237538	46237904	MACS_peak_8221	114.74	366	0	0	0	extreme
17	47698866	47699182	MACS_peak_8233	694.51	316	0	0	0	extreme
17	47761507	47761668	MACS_peak_8234	512.62	161	0	0	0	extreme
17	47843056	47843450	MACS_peak_8237	625.13	394	1	0	0	extreme
17	48005776	48005938	MACS_peak_8239	944.23	162	0	0	0	extreme
17	48036859	48037192	MACS_peak_8242	542.34	333	0	1	0	extreme
17	48492466	48492760	MACS_peak_8254	691.92	294	0	0	0	extreme
17	48636391	48636765	MACS_peak_8257	404.88	374	0	0	1	extreme
17	48814381	48814656	MACS_peak_8261	424.27	275	0	1	0	extreme
17	48878268	48878564	MACS_peak_8262	380.3	296	0	0	1	extreme
17	48879048	48879426	MACS_peak_8263	754.53	378	0	0	1	extreme
17	49227529	49227773	MACS_peak_8270	780.06	244	1	0	0	extreme
17	49395036	49395421	MACS_peak_8273	880.99	385	0	0	1	extreme
17	49570016	49570328	MACS_peak_8278	811.61	312	0	0	2	extreme
17	49695536	49695841	MACS_peak_8279	953.25	305	0	0	0	extreme
17	49779816	49780032	MACS_peak_8282	900.67	216	0	1	0	extreme
17	50398478	50398672	MACS_peak_8288	652.22	194	0	0	0	extreme
17	50501084	50501338	MACS_peak_8290	470.06	254	0	0	0	extreme
17	50783123	50783492	MACS_peak_8291	542.19	369	0	0	1	extreme
17	50956830	50957243	MACS_peak_8293	613.85	413	0	0	0	extreme
17	51298881	51299156	MACS_peak_8297	577.45	275	0	0	0	extreme
17	54891340	54891615	MACS_peak_8336	693.11	275	0	0	0	extreme
17	56780144	56780546	MACS_peak_8376	1100.96	402	0	0	0	extreme
17	56960993	56961316	MACS_peak_8377	1168.96	323	0	0	0	extreme
17	57005054	57005456	MACS_peak_8378	601.83	402	0	1	0	extreme
17	57243158	57243399	MACS_peak_8380	2098.37	241	0	0	0	extreme
17	57999420	57999851	MACS_peak_8391	707.16	431	1	1	0	extreme
17	58172576	58172926	MACS_peak_8394	713.3	350	0	0	0	extreme
17	58249680	58249878	MACS_peak_8395	831.63	198	0	1	0	extreme
17	58317393	58317686	MACS_peak_8397	696.46	293	0	1	0	extreme
17	58447539	58447774	MACS_peak_8401	762.02	235	0	1	0	extreme
17	58739760	58740107	MACS_peak_8411	276.87	347	0	0	0	extreme
17	58960761	58961072	MACS_peak_8422	326.84	311	0	1	0	extreme
17	59165883	59166164	MACS_peak_8437	237.01	281	0	1	0	extreme
17	59310907	59311297	MACS_peak_8438	860.35	390	0	0	0	extreme
17	59558920	59559272	MACS_peak_8445	1025.67	352	0	0	0	extreme
17	59713679	59713811	MACS_peak_8449	797.63	132	0	1	0	extreme
17	60008457	60008786	MACS_peak_8474	1445.95	329	0	0	2	extreme
17	60047834	60048283	MACS_peak_8477	339.26	449	0	0	0	extreme
17	60142878	60143295	MACS_peak_8484	2705.16	417	0	0	0	extreme
17	60435927	60436314	MACS_peak_8512	2993.34	387	0	0	0	extreme
17	60589329	60589666	MACS_peak_8522	203.19	337	0	0	0	extreme
17	63425314	63425715	MACS_peak_8735	1554.8	401	0	1	1	extreme
17	63497967	63498300	MACS_peak_8736	542.34	333	0	2	0	extreme
17	63612274	63612663	MACS_peak_8737	1336.42	389	0	0	0	extreme
17	63866142	63866401	MACS_peak_8741	1804.99	259	0	0	0	extreme
17	64963842	64964048	MACS_peak_8778	486.85	206	0	0	0	extreme
17	66906724	66907187	MACS_peak_8817	807.88	463	0	0	0	extreme
17	67272535	67272936	MACS_peak_8820	349.84	401	0	0	1	extreme
17	67779063	67779275	MACS_peak_8832	1228.02	212	0	0	0	extreme
17	68205310	68205577	MACS_peak_8844	1328.19	267	0	0	0	extreme
17	72560280	72560514	MACS_peak_8908	532.66	234	0	0	1	extreme
17	74019544	74019970	MACS_peak_8912	606.43	426	0	0	0	extreme
17	74368376	74368660	MACS_peak_8913	704	284	1	0	0	extreme
17	74533182	74533405	MACS_peak_8914	513.05	223	0	0	0	extreme
17	75426318	75426631	MACS_peak_8920	453.55	313	0	0	0	extreme
17	75589107	75589347	MACS_peak_8923	502.51	240	1	0	0	extreme
17	75749772	75750250	MACS_peak_8931	684.54	478	1	1	0	extreme
17	76681313	76681590	MACS_peak_8938	1125.73	277	0	1	0	extreme
17	76935711	76935974	MACS_peak_8939	591.18	263	0	1	0	extreme
17	78084973	78085302	MACS_peak_8945	796.97	329	0	1	0	extreme
17	78250923	78251290	MACS_peak_8946	766.87	367	0	0	2	extreme
17	78289703	78290050	MACS_peak_8947	380.3	347	0	0	0	extreme
17	78479929	78480150	MACS_peak_8949	1441.15	221	0	1	0	extreme
17	78971353	78971527	MACS_peak_8951	1415.25	174	1	0	0	extreme
17	79065271	79065447	MACS_peak_8953	743.63	176	0	0	0	extreme
17	79401162	79401411	MACS_peak_8954	485.56	249	0	1	0	extreme
17	79741957	79742202	MACS_peak_8955	780.06	245	0	1	0	extreme
17	80307659	80307979	MACS_peak_8959	439.97	320	0	1	0	extreme
17	80467122	80467256	MACS_peak_8960	1666.76	134	1	0	0	extreme
17	81101820	81102026	MACS_peak_8965	1153.04	206	0	1	0	extreme
17	81484282	81484627	MACS_peak_8967	418.68	345	0	0	0	extreme
17	81675927	81676165	MACS_peak_8968	468.86	238	0	0	0	extreme
17	81821830	81822006	MACS_peak_8969	763.02	176	1	0	0	extreme
17	83228954	83229360	MACS_peak_8978	1054.11	406	0	0	1	extreme
18	39507	39802	MACS_peak_8988	108.87	295	0	0	0	extreme
18	286445	286736	MACS_peak_8992	919.95	291	0	0	0	extreme
18	624124	624308	MACS_peak_8994	918.92	184	0	1	0	extreme
18	2251801	2252095	MACS_peak_9008	62.38	294	0	0	1	extreme
18	3323000	3323211	MACS_peak_9012	543.04	211	0	0	1	extreme
18	5280974	5281379	MACS_peak_9020	147.82	405	0	0	0	extreme
18	5333776	5334233	MACS_peak_9022	70.09	457	0	0	0	extreme
18	8480567	8480855	MACS_peak_9033	833.73	288	0	0	0	extreme
18	8654543	8654810	MACS_peak_9034	406.81	267	0	0	0	extreme
18	9444029	9444251	MACS_peak_9035	712.32	222	0	0	0	extreme
18	9978927	9979247	MACS_peak_9038	120.16	320	0	0	0	extreme
18	10652954	10653260	MACS_peak_9039	104.15	306	0	0	0	extreme
18	11761695	11761906	MACS_peak_9044	763.02	211	0	1	0	extreme
18	12135614	12135999	MACS_peak_9045	122.09	385	0	0	0	extreme
18	12203112	12203478	MACS_peak_9048	58.9	366	0	0	1	extreme
18	12391675	12391931	MACS_peak_9051	729.14	256	0	0	0	extreme
18	13795201	13795457	MACS_peak_9055	79.5	256	0	0	0	extreme
18	14003774	14004178	MACS_peak_9059	72.89	404	0	0	0	extreme
18	14395601	14395837	MACS_peak_9060	1036.74	236	0	0	0	extreme
18	15404853	15405230	MACS_peak_9075	69.92	377	0	0	0	extreme
18	23083213	23083352	MACS_peak_9096	902.92	139	0	0	0	extreme
18	24488996	24489222	MACS_peak_9102	548.55	226	0	0	0	extreme
18	25906447	25906580	MACS_peak_9107	1396.21	133	0	0	0	extreme
18	26393353	26393489	MACS_peak_9108	413.07	136	0	0	0	extreme
18	31001466	31001677	MACS_peak_9142	591.86	211	0	1	0	extreme
18	32231239	32231600	MACS_peak_9144	63.13	361	0	1	0	extreme
18	35143863	35144252	MACS_peak_9162	467.82	389	0	0	0	extreme
18	35765106	35765547	MACS_peak_9164	94.4	441	0	0	0	extreme
18	36553062	36553384	MACS_peak_9171	58.06	322	0	1	0	extreme
18	41780021	41780412	MACS_peak_9199	98.53	391	0	0	0	extreme
18	42542377	42542702	MACS_peak_9200	96.54	325	0	0	1	extreme
18	45839350	45839746	MACS_peak_9217	506.71	396	0	1	0	extreme
18	45974858	45975065	MACS_peak_9219	423.24	207	0	0	0	extreme
18	47205000	47205255	MACS_peak_9224	470.06	255	1	0	0	extreme
18	47684699	47685057	MACS_peak_9230	903.5	358	0	0	0	extreme
18	48651980	48652298	MACS_peak_9232	142.05	318	0	1	0	extreme
18	48983265	48983398	MACS_peak_9234	1396.21	133	0	0	0	extreme
18	49720129	49720504	MACS_peak_9241	88.77	375	0	0	0	extreme
18	51360475	51360840	MACS_peak_9246	178.37	365	0	0	1	extreme
18	53512440	53512761	MACS_peak_9255	89.2	321	0	1	1	extreme
18	54346042	54346385	MACS_peak_9256	329.23	343	0	1	0	extreme
18	54559142	54559299	MACS_peak_9258	883.81	157	0	0	0	extreme
18	56530804	56531154	MACS_peak_9266	104.52	350	0	0	0	extreme
18	57264703	57265076	MACS_peak_9270	71.35	373	0	0	0	extreme
18	59115721	59116184	MACS_peak_9274	181.92	463	0	0	0	extreme
18	59117675	59117988	MACS_peak_9275	69	313	0	0	0	extreme
18	59996413	59996718	MACS_peak_9276	439.84	305	0	0	0	extreme
18	61716643	61717054	MACS_peak_9288	64.17	411	0	0	1	extreme
18	63063499	63063840	MACS_peak_9297	733.8	341	0	0	0	extreme
18	63864566	63864861	MACS_peak_9298	75.96	295	0	0	0	extreme
18	68227225	68227662	MACS_peak_9318	58.14	437	0	0	0	extreme
18	68856948	68857427	MACS_peak_9319	996.54	479	0	1	0	extreme
18	69712277	69712418	MACS_peak_9325	543.1	141	0	1	1	extreme
18	70460811	70461175	MACS_peak_9326	380.3	364	0	0	0	extreme
18	73842775	73843251	MACS_peak_9335	1066.34	476	0	0	0	extreme
18	74196496	74196824	MACS_peak_9336	427.34	328	0	0	0	extreme
18	75592835	75593052	MACS_peak_9338	901.33	217	0	0	0	extreme
18	76763114	76763260	MACS_peak_9341	1084.72	146	0	0	0	extreme
18	77545413	77545805	MACS_peak_9342	508.79	392	0	0	1	extreme
18	78875615	78875812	MACS_peak_9345	662.31	197	0	0	0	extreme
19	116032	116353	MACS_peak_9350	143.16	321	0	1	0	extreme
19	267440	267630	MACS_peak_9360	695.57	190	0	0	0	extreme
19	1448438	1448669	MACS_peak_9362	414.64	231	1	0	0	extreme
19	1795821	1796024	MACS_peak_9363	629.38	203	0	1	0	extreme
19	2872260	2872581	MACS_peak_9365	756.52	321	0	0	0	extreme
19	2950951	2951235	MACS_peak_9366	438.82	284	0	0	0	extreme
19	3987879	3988062	MACS_peak_9369	1477.14	183	0	0	0	extreme
19	4139799	4140122	MACS_peak_9370	385.64	323	0	0	0	extreme
19	4167608	4167812	MACS_peak_9371	562.91	204	0	1	0	extreme
19	4208737	4209093	MACS_peak_9372	413.31	356	0	1	0	extreme
19	4463874	4464102	MACS_peak_9374	463.07	228	0	0	1	extreme
19	4558490	4558738	MACS_peak_9375	613.04	248	0	1	0	extreme
19	5084363	5084614	MACS_peak_9376	746.04	251	0	1	0	extreme
19	5873031	5873374	MACS_peak_9377	419.68	343	0	1	0	extreme
19	6354195	6354516	MACS_peak_9378	368	321	0	0	1	extreme
19	6488776	6489055	MACS_peak_9379	441.88	279	0	0	0	extreme
19	7062771	7063177	MACS_peak_9384	617.94	406	0	0	0	extreme
19	7547709	7547854	MACS_peak_9385	768.94	145	0	1	0	extreme
19	8058348	8058681	MACS_peak_9386	424.75	333	0	1	0	extreme
19	8268521	8268768	MACS_peak_9388	335.73	247	0	0	0	extreme
19	8580741	8581033	MACS_peak_9389	402.82	292	1	0	0	extreme
19	8820607	8820871	MACS_peak_9390	603.02	264	0	1	0	extreme
19	9401232	9401614	MACS_peak_9391	170.04	382	0	0	1	extreme
19	9435520	9435819	MACS_peak_9392	564.59	299	0	0	0	extreme
19	10099569	10099952	MACS_peak_9394	180.64	383	0	1	0	extreme
19	10269475	10269696	MACS_peak_9395	820.41	221	1	0	1	extreme
19	10297598	10297730	MACS_peak_9396	932.35	132	0	0	0	extreme
19	10510193	10510408	MACS_peak_9400	596.79	215	1	0	0	extreme
19	10676095	10676391	MACS_peak_9403	476.21	296	0	1	0	extreme
19	10936761	10936993	MACS_peak_9404	633.59	232	0	0	0	extreme
19	11203959	11204133	MACS_peak_9405	780.06	174	1	0	1	extreme
19	11293782	11293992	MACS_peak_9406	760.34	210	1	0	0	extreme
19	11700192	11700428	MACS_peak_9407	662.31	236	0	0	0	extreme
19	11954888	11955116	MACS_peak_9409	304.09	228	0	1	0	extreme
19	12493695	12494040	MACS_peak_9411	84.4	345	0	2	0	extreme
19	12532287	12532664	MACS_peak_9412	340	377	0	3	1	extreme
19	12711818	12712261	MACS_peak_9414	1539.37	443	0	1	0	extreme
19	12717027	12717293	MACS_peak_9415	452.25	266	0	1	0	extreme
19	12885395	12885740	MACS_peak_9417	418.68	345	1	0	0	extreme
19	13206842	13206977	MACS_peak_9418	925.76	135	1	0	0	extreme
19	13299827	13300059	MACS_peak_9420	532.66	232	0	1	0	extreme
19	13832127	13832264	MACS_peak_9421	1309.25	137	0	0	1	extreme
19	13903223	13903435	MACS_peak_9424	593.6	212	1	1	0	extreme
19	14067116	14067549	MACS_peak_9425	579.39	433	0	0	0	extreme
19	14196077	14196404	MACS_peak_9426	427.87	327	0	1	0	extreme
19	15150506	15150707	MACS_peak_9431	628.77	201	0	0	0	extreme
19	16182628	16183097	MACS_peak_9439	454.75	469	1	0	0	extreme
19	16714749	16714999	MACS_peak_9440	482.84	250	0	0	0	extreme
19	16771662	16771851	MACS_peak_9442	1079.97	189	0	1	0	extreme
19	17052568	17052737	MACS_peak_9443	814.37	169	1	0	1	extreme
19	17067522	17067729	MACS_peak_9444	941.49	207	0	1	0	extreme
19	17407915	17408168	MACS_peak_9445	263.44	253	1	0	1	extreme
19	17775425	17775676	MACS_peak_9446	485.56	251	0	1	0	extreme
19	17870275	17870520	MACS_peak_9447	573.39	245	1	0	0	extreme
19	18349595	18349834	MACS_peak_9452	777.13	239	0	1	0	extreme
19	18847226	18847522	MACS_peak_9453	445	296	0	1	0	extreme
19	19139665	19139947	MACS_peak_9454	576.71	282	0	0	0	extreme
19	19366920	19367138	MACS_peak_9456	862.64	218	0	0	0	extreme
19	19737141	19737281	MACS_peak_9459	1025.76	140	0	0	0	extreme
19	20229785	20230134	MACS_peak_9464	62.38	349	0	0	1	extreme
19	20893220	20893552	MACS_peak_9468	202.06	332	0	0	0	extreme
19	21078096	21078318	MACS_peak_9470	488.66	222	1	0	0	extreme
19	21872257	21872433	MACS_peak_9473	1627.6	176	0	0	0	extreme
19	22001793	22002017	MACS_peak_9474	398.38	224	0	1	0	extreme
19	23265439	23265744	MACS_peak_9476	201.59	305	0	1	2	extreme
19	23289353	23289672	MACS_peak_9478	229.83	319	0	0	0	extreme
19	23430800	23431114	MACS_peak_9480	100.87	314	0	0	0	extreme
19	24014315	24014633	MACS_peak_9482	252.15	318	0	0	0	extreme
19	29084326	29084560	MACS_peak_9531	532.66	234	0	0	0	extreme
19	29230885	29231272	MACS_peak_9532	114.96	387	0	0	0	extreme
19	29597370	29597554	MACS_peak_9537	918.92	184	0	0	0	extreme
19	30188672	30188924	MACS_peak_9539	97.84	252	0	0	0	extreme
19	32570292	32570648	MACS_peak_9551	673.97	356	0	0	0	extreme
19	33302507	33302854	MACS_peak_9552	417.69	347	1	0	0	extreme
19	33406936	33407178	MACS_peak_9553	936.57	242	0	1	0	extreme
19	34078541	34078931	MACS_peak_9555	89.02	390	0	0	0	extreme
19	34336934	34337118	MACS_peak_9556	1320.51	184	0	1	0	extreme
19	34501484	34501831	MACS_peak_9557	417.69	347	0	1	0	extreme
19	34616180	34616611	MACS_peak_9558	114.31	431	0	1	0	extreme
19	34701839	34702212	MACS_peak_9559	66.19	373	0	0	0	extreme
19	34861723	34862103	MACS_peak_9560	55.09	380	0	0	0	extreme
19	35510351	35510660	MACS_peak_9561	437.6	309	0	1	0	extreme
19	35572642	35573028	MACS_peak_9562	439.97	386	0	0	1	extreme
19	35597189	35597330	MACS_peak_9563	354.32	141	0	0	0	extreme
19	36378771	36379021	MACS_peak_9564	485.56	250	1	1	0	extreme
19	36736399	36736678	MACS_peak_9565	281.19	279	0	1	0	extreme
19	37288757	37289093	MACS_peak_9568	81.77	336	0	0	0	extreme
19	37293872	37294144	MACS_peak_9569	103.79	272	0	0	0	extreme
19	37722113	37722375	MACS_peak_9570	1536.61	262	0	0	0	extreme
19	38243880	38244075	MACS_peak_9575	1402.54	195	1	0	0	extreme
19	38884097	38884399	MACS_peak_9577	311.23	302	0	1	0	extreme
19	39000281	39000534	MACS_peak_9579	596.79	253	0	1	0	extreme
19	39627766	39628106	MACS_peak_9581	276.21	340	0	0	0	extreme
19	39766792	39767029	MACS_peak_9582	1509.93	237	0	0	0	extreme
19	40099779	40100248	MACS_peak_9585	101.68	469	0	0	0	extreme
19	40662814	40663233	MACS_peak_9586	982.96	419	1	0	0	extreme
19	40819747	40820052	MACS_peak_9587	953.25	305	0	1	1	extreme
19	41154068	41154293	MACS_peak_9594	515.03	225	0	0	0	extreme
19	41449412	41449703	MACS_peak_9595	447.93	291	0	0	0	extreme
19	41821204	41821522	MACS_peak_9599	527.85	318	0	0	0	extreme
19	42081640	42081912	MACS_peak_9600	584.2	272	1	0	0	extreme
19	42438440	42438698	MACS_peak_9601	687.21	258	0	1	1	extreme
19	43207295	43207678	MACS_peak_9610	400.82	383	1	0	0	extreme
19	43745317	43745587	MACS_peak_9613	585.73	270	0	1	0	extreme
19	43865920	43866352	MACS_peak_9614	71.2	432	0	0	0	extreme
19	43946447	43946702	MACS_peak_9615	349.08	255	1	0	0	extreme
19	44409225	44409677	MACS_peak_9618	694.93	452	0	0	1	extreme
19	44459007	44459315	MACS_peak_9620	400.54	308	0	0	0	extreme
19	44800396	44800741	MACS_peak_9624	348.48	345	0	0	0	extreme
19	45131073	45131266	MACS_peak_9626	678.9	193	0	2	0	extreme
19	45558503	45558819	MACS_peak_9631	1221.51	316	0	1	0	extreme
19	45607376	45607551	MACS_peak_9632	972.07	175	1	0	0	extreme
19	45681594	45681797	MACS_peak_9634	629.38	203	0	1	0	extreme
19	45799075	45799337	MACS_peak_9635	723.53	262	1	0	0	extreme
19	46247224	46247389	MACS_peak_9638	1036.76	165	0	0	0	extreme
19	46395602	46395957	MACS_peak_9639	1210.46	355	0	0	0	extreme
19	46638604	46638783	MACS_peak_9643	746.04	179	1	0	1	extreme
19	46753808	46754084	MACS_peak_9645	581.17	276	0	1	0	extreme
19	47033894	47034105	MACS_peak_9649	165.48	211	0	1	0	extreme
19	47230536	47230806	MACS_peak_9650	460.86	270	0	1	0	extreme
19	47247504	47247784	MACS_peak_9651	640.85	280	0	0	0	extreme
19	47305305	47305609	MACS_peak_9652	797.47	304	0	1	0	extreme
19	47788863	47789089	MACS_peak_9654	848.95	226	0	0	0	extreme
19	47957896	47958220	MACS_peak_9695	135.29	324	0	0	0	extreme
19	48424163	48424518	MACS_peak_9699	186.49	355	0	1	0	extreme
19	48584320	48584652	MACS_peak_9700	489.66	332	0	1	0	extreme
19	48876892	48877262	MACS_peak_9701	611.86	370	2	0	0	extreme
19	49208871	49209170	MACS_peak_9705	426.58	299	0	1	0	extreme
19	49937634	49937919	MACS_peak_9707	380.3	285	0	1	0	extreme
19	50088807	50089082	MACS_peak_9708	275.68	275	0	0	0	extreme
19	50486952	50487211	MACS_peak_9740	594.37	259	0	1	1	extreme
19	50604729	50604948	MACS_peak_9741	1139.8	219	0	0	0	extreme
19	50783663	50783887	MACS_peak_9744	537.61	224	0	1	0	extreme
19	51094837	51095031	MACS_peak_9746	1245.57	194	1	0	0	extreme
19	51259415	51259647	MACS_peak_9748	1320.51	232	0	1	1	extreme
19	51398105	51398480	MACS_peak_9749	360.38	375	0	0	2	extreme
19	51471303	51471508	MACS_peak_9750	628.07	205	0	0	0	extreme
19	51618791	51618923	MACS_peak_9751	826.38	132	0	2	0	extreme
19	52237821	52238124	MACS_peak_9755	688.35	303	0	0	0	extreme
19	53227231	53227587	MACS_peak_9757	96.97	356	0	0	0	extreme
19	53360618	53360902	MACS_peak_9758	229.83	284	0	0	0	extreme
19	53587401	53587725	MACS_peak_9759	299.64	324	0	0	0	extreme
19	53793059	53793390	MACS_peak_9760	458.88	331	1	0	0	extreme
19	54325219	54325470	MACS_peak_9762	1025.49	251	0	0	1	extreme
19	54674092	54674271	MACS_peak_9764	746.04	179	0	0	0	extreme
19	55029362	55029508	MACS_peak_9767	847.1	146	0	1	2	extreme
19	55418152	55418510	MACS_peak_9768	386.06	358	0	0	0	extreme
19	55653647	55654038	MACS_peak_9770	1006.73	391	1	0	0	extreme
19	55736894	55737123	MACS_peak_9771	522.21	229	0	1	0	extreme
19	56333594	56333911	MACS_peak_9772	915.23	317	0	1	1	extreme
19	56609535	56609873	MACS_peak_9774	422.19	338	0	1	0	extreme
19	57005448	57005734	MACS_peak_9775	153.62	286	0	0	0	extreme
19	58310850	58311182	MACS_peak_9776	978.69	332	0	3	1	extreme
19	58436647	58436798	MACS_peak_9777	577.33	151	1	0	0	extreme
19	58606364	58606640	MACS_peak_9780	274.43	276	0	0	0	extreme
20	1744109	1744531	MACS_peak_11674	115.17	422	0	0	0	extreme
20	1797261	1797402	MACS_peak_11675	1001.34	141	0	0	0	extreme
20	2646989	2647157	MACS_peak_11677	1025.76	168	0	0	0	extreme
20	4386686	4386983	MACS_peak_11686	125.63	297	0	0	0	extreme
20	5276783	5277134	MACS_peak_11687	89.02	351	0	0	0	extreme
20	5515097	5515564	MACS_peak_11690	60	467	0	0	0	extreme
20	7936561	7936765	MACS_peak_11698	797.18	204	0	1	0	extreme
20	10155023	10155334	MACS_peak_11715	436.49	311	0	0	1	extreme
20	11274171	11274399	MACS_peak_11716	677.53	228	0	0	1	extreme
20	13206099	13206399	MACS_peak_11732	442.68	300	0	0	0	extreme
20	16634772	16635074	MACS_peak_11755	689.14	302	0	0	0	extreme
20	16821493	16821880	MACS_peak_11758	1010.27	387	0	0	0	extreme
20	17504897	17505265	MACS_peak_11765	521.76	368	0	1	0	extreme
20	17996056	17996460	MACS_peak_11766	785.42	404	0	1	0	extreme
20	18247341	18247691	MACS_peak_11767	57.24	350	0	0	0	extreme
20	18632264	18632570	MACS_peak_11770	559.8	306	0	2	0	extreme
20	19853805	19854213	MACS_peak_11785	80.5	408	0	1	0	extreme
20	21253826	21254175	MACS_peak_11795	189.47	349	0	0	0	extreme
20	21451897	21452030	MACS_peak_11797	1291.76	133	0	0	0	extreme
20	22990856	22991148	MACS_peak_11813	84.26	292	0	0	0	extreme
20	23306751	23307163	MACS_peak_11814	76.47	412	0	0	0	extreme
20	23428531	23428903	MACS_peak_11815	58.75	372	0	0	0	extreme
20	23996206	23996630	MACS_peak_11822	978.89	424	0	0	0	extreme
20	24931142	24931350	MACS_peak_11827	791.62	208	0	0	0	extreme
20	25110193	25110488	MACS_peak_11828	250.57	295	0	0	0	extreme
20	25428973	25429112	MACS_peak_11832	741.54	139	0	1	0	extreme
20	25716601	25716925	MACS_peak_11833	175.91	324	0	0	1	extreme
20	31577833	31578198	MACS_peak_11871	201.59	365	0	0	0	extreme
20	31612919	31613335	MACS_peak_11872	896.57	416	0	0	0	extreme
20	31628038	31628336	MACS_peak_11873	114.74	298	0	0	0	extreme
20	31951876	31952331	MACS_peak_11875	590.7	455	0	0	0	extreme
20	32054271	32054623	MACS_peak_11876	142.05	352	1	0	0	extreme
20	32178374	32178611	MACS_peak_11877	945.13	237	0	0	0	extreme
20	32674366	32674657	MACS_peak_11879	570.2	291	0	1	0	extreme
20	32902560	32902795	MACS_peak_11881	814.37	235	0	1	0	extreme
20	33262662	33262916	MACS_peak_11882	883.81	254	0	0	0	extreme
20	33792229	33792427	MACS_peak_11883	662.31	198	0	0	1	extreme
20	34228045	34228256	MACS_peak_11884	519.65	211	0	1	0	extreme
20	34312695	34313017	MACS_peak_11887	549.27	322	0	0	0	extreme
20	35154619	35154985	MACS_peak_11889	114.74	366	0	0	0	extreme
20	35208447	35208696	MACS_peak_11890	596.67	249	0	2	0	extreme
20	35511871	35512125	MACS_peak_11891	470.06	254	0	1	0	extreme
20	35686859	35687064	MACS_peak_11892	514.2	205	0	1	0	extreme
20	35763642	35764047	MACS_peak_11894	469.55	405	0	0	0	extreme
20	36134686	36134980	MACS_peak_11897	695.63	294	0	1	0	extreme
20	36488090	36488335	MACS_peak_11898	363.13	245	0	1	0	extreme
20	36884739	36885137	MACS_peak_11899	678.21	398	0	1	0	extreme
20	37965283	37965560	MACS_peak_11903	467.94	277	0	0	0	extreme
20	38079975	38080146	MACS_peak_11904	1007.8	171	0	1	0	extreme
20	38123935	38124362	MACS_peak_11905	725.31	427	1	1	0	extreme
20	38435304	38435591	MACS_peak_11906	573.07	287	0	0	0	extreme
20	38462902	38463239	MACS_peak_11907	600.41	337	0	0	0	extreme
20	39469952	39470298	MACS_peak_11911	72.05	346	0	0	0	extreme
20	41340004	41340311	MACS_peak_11928	946.44	307	1	0	0	extreme
20	44491065	44491205	MACS_peak_11966	310.64	140	0	1	0	extreme
20	44609939	44610384	MACS_peak_11967	836.26	445	0	1	0	extreme
20	45362870	45363080	MACS_peak_11972	607.01	210	2	0	0	extreme
20	45771257	45771488	MACS_peak_11979	678.9	231	0	1	0	extreme
20	45820264	45820445	MACS_peak_11981	746.04	181	1	0	0	extreme
20	45820971	45821119	MACS_peak_11982	1208.41	148	1	0	0	extreme
20	45969730	45970052	MACS_peak_11983	430.51	322	0	1	0	extreme
20	46562566	46562804	MACS_peak_11984	662.31	238	1	0	0	extreme
20	48745499	48745823	MACS_peak_12069	257.04	324	0	1	0	extreme
20	49333876	49334241	MACS_peak_12074	1236.43	365	0	1	1	extreme
20	49786766	49786992	MACS_peak_12079	1845.39	226	0	0	0	extreme
20	49928689	49929018	MACS_peak_12082	1978.65	329	0	0	0	extreme
20	50071339	50071667	MACS_peak_12086	1317.25	328	0	0	0	extreme
20	50832267	50832535	MACS_peak_12125	380.3	268	0	1	0	extreme
20	50981531	50981780	MACS_peak_12127	1637.3	249	0	0	0	extreme
20	52031161	52031296	MACS_peak_12142	1468.78	135	0	0	0	extreme
20	56318859	56319164	MACS_peak_12357	748.12	305	0	0	0	extreme
20	57381770	57382050	MACS_peak_12398	2736.2	280	0	0	0	extreme
20	57597022	57597243	MACS_peak_12404	1198.86	221	0	0	0	extreme
20	57622532	57622834	MACS_peak_12405	1140.2	302	0	0	0	extreme
20	58304136	58304459	MACS_peak_12415	781.89	323	0	0	1	extreme
20	58807776	58807989	MACS_peak_12421	593.82	213	0	0	0	extreme
20	58913493	58913837	MACS_peak_12425	265.34	344	0	0	0	extreme
20	59081963	59082377	MACS_peak_12427	1056.71	414	0	0	0	extreme
20	59856495	59856854	MACS_peak_12443	87.62	359	0	0	0	extreme
20	59948996	59949456	MACS_peak_12444	1932.82	460	0	0	0	extreme
20	61896295	61896543	MACS_peak_12467	485.56	248	0	1	0	extreme
20	62668561	62668808	MACS_peak_12475	485.56	247	0	1	0	extreme
20	62822737	62823105	MACS_peak_12478	1444.83	368	0	1	0	extreme
20	63009141	63009379	MACS_peak_12482	516.86	238	1	0	0	extreme
20	63183428	63183649	MACS_peak_12485	1226.97	221	0	0	0	extreme
20	63309551	63309772	MACS_peak_12486	883.81	221	0	1	0	extreme
20	63515241	63515394	MACS_peak_12488	885.16	153	0	0	0	extreme
20	64057793	64058047	MACS_peak_12492	470.06	254	0	1	0	extreme
20	64102080	64102331	MACS_peak_12493	746.04	251	2	0	0	extreme
20	64117584	64117959	MACS_peak_12494	404.42	375	0	1	0	extreme
21	8560176	8560322	MACS_peak_12495	551.28	146	0	0	0	extreme
21	14259692	14259962	MACS_peak_12599	585.73	270	0	0	1	extreme
21	14403704	14404106	MACS_peak_12600	487.83	402	0	0	0	extreme
21	14941710	14941869	MACS_peak_12608	886.06	159	0	0	2	extreme
21	15826056	15826411	MACS_peak_12609	529.16	355	0	1	0	extreme
21	17381145	17381528	MACS_peak_12631	54.22	383	0	0	0	extreme
21	17726193	17726460	MACS_peak_12632	462.79	267	0	0	0	extreme
21	25061356	25061491	MACS_peak_12656	1079.97	135	0	0	1	extreme
21	25708553	25708821	MACS_peak_12658	462.14	268	0	1	0	extreme
21	25801547	25801858	MACS_peak_12659	812.5	311	0	0	0	extreme
21	28681793	28682133	MACS_peak_12674	84.91	340	0	0	0	extreme
21	29090007	29090279	MACS_peak_12675	828.18	272	0	1	0	extreme
21	31507071	31507226	MACS_peak_12689	501.14	155	0	1	0	extreme
21	32225791	32226091	MACS_peak_12691	83.55	300	0	0	0	extreme
21	32771808	32772042	MACS_peak_12694	548.99	234	0	0	0	extreme
21	33204358	33204591	MACS_peak_12695	299.43	233	0	0	0	extreme
21	33361377	33361574	MACS_peak_12696	1025.76	197	0	0	0	extreme
21	34201046	34201186	MACS_peak_12699	1663.42	140	0	0	1	extreme
21	35840317	35840570	MACS_peak_12712	470.06	253	0	1	0	extreme
21	36123066	36123413	MACS_peak_12713	380.3	347	0	0	1	extreme
21	36209788	36209983	MACS_peak_12714	821	195	0	1	0	extreme
21	36685973	36686133	MACS_peak_12718	341.74	160	0	0	0	extreme
21	37776789	37777157	MACS_peak_12720	56.38	368	0	1	0	extreme
21	39175224	39175619	MACS_peak_12731	1136.83	395	1	0	0	extreme
21	39518347	39518704	MACS_peak_12734	1175.17	357	0	0	0	extreme
21	41347749	41347956	MACS_peak_12753	831.12	207	0	1	0	extreme
21	41778293	41778505	MACS_peak_12754	763.02	212	0	0	0	extreme
21	42258622	42258995	MACS_peak_12761	405.33	373	0	1	0	extreme
21	43315185	43315396	MACS_peak_12763	543.04	211	0	0	0	extreme
21	43646696	43647133	MACS_peak_12764	600.34	437	0	1	0	extreme
21	43810767	43811022	MACS_peak_12766	596.79	255	0	0	1	extreme
21	44305004	44305243	MACS_peak_12769	645.81	239	0	0	0	extreme
21	44479787	44480119	MACS_peak_12771	635.33	332	0	0	0	extreme
21	45137117	45137502	MACS_peak_12774	753.71	385	0	1	0	extreme
21	45140297	45140747	MACS_peak_12776	832.82	450	0	1	0	extreme
21	45973708	45973894	MACS_peak_12782	858.56	186	0	0	0	extreme
21	46020959	46021304	MACS_peak_12783	188.18	345	0	0	0	extreme
21	46639921	46640168	MACS_peak_12786	412.67	247	0	0	0	extreme
21	46698297	46698592	MACS_peak_12788	220.43	295	0	0	0	extreme
22	17039427	17039668	MACS_peak_12817	396.1	241	0	0	1	extreme
22	17227529	17227788	MACS_peak_12818	354.43	259	0	1	0	extreme
22	18940352	18940661	MACS_peak_12834	375.24	309	0	1	1	extreme
22	20157082	20157255	MACS_peak_12838	780.06	173	0	0	0	extreme
22	20336881	20337215	MACS_peak_12840	129.98	334	0	0	0	extreme
22	18346106	18346367	MACS_peak_12842	380.3	261	0	0	0	extreme
22	21119915	21120094	MACS_peak_12854	892.15	179	0	0	2	extreme
22	21310211	21310441	MACS_peak_12859	254.88	230	0	0	1	extreme
22	22877007	22877356	MACS_peak_12876	101.19	349	0	0	0	extreme
22	23433377	23433557	MACS_peak_12879	936.57	180	0	0	0	extreme
22	23666680	23667089	MACS_peak_12882	169.69	409	0	0	3	extreme
22	24259623	24259889	MACS_peak_12886	572.81	266	0	0	1	extreme
22	24650846	24651168	MACS_peak_12888	673.67	322	0	0	2	extreme
22	24850374	24850596	MACS_peak_12893	549.18	222	0	1	0	extreme
22	25867936	25868094	MACS_peak_12896	883.81	158	0	1	0	extreme
22	26679086	26679307	MACS_peak_12897	729.14	221	0	0	1	extreme
22	28664344	28664616	MACS_peak_12907	58.24	272	0	1	0	extreme
22	28781236	28781553	MACS_peak_12909	180.31	317	0	1	0	extreme
22	29040762	29040984	MACS_peak_12911	883.81	222	0	1	0	extreme
22	29470463	29470753	MACS_peak_12913	570.92	290	0	0	1	extreme
22	29851683	29852034	MACS_peak_12915	345.59	351	0	0	0	extreme
22	30088900	30089245	MACS_peak_12916	1049.85	345	0	1	0	extreme
22	32984159	32984481	MACS_peak_12922	430.51	322	0	1	0	extreme
22	34877209	34877440	MACS_peak_12938	340.1	231	0	0	0	extreme
22	35550436	35550588	MACS_peak_12939	1434.33	152	0	1	0	extreme
22	36730792	36731086	MACS_peak_12940	564.39	294	0	0	0	extreme
22	36757660	36757875	MACS_peak_12941	596.79	215	1	0	0	extreme
22	37201214	37201349	MACS_peak_12942	1054.55	135	1	0	0	extreme
22	38384978	38385365	MACS_peak_12943	74.22	387	0	1	1	extreme
22	38385778	38386134	MACS_peak_12944	151.65	356	0	1	1	extreme
22	39982634	39982877	MACS_peak_12948	210.25	243	0	0	0	extreme
22	42820199	42820501	MACS_peak_12953	441.54	302	0	1	0	extreme
22	43904569	43904861	MACS_peak_12954	1383.87	292	0	0	0	extreme
22	44735925	44736121	MACS_peak_12955	662.31	196	0	2	0	extreme
22	48467216	48467465	MACS_peak_12956	525.98	249	0	0	0	extreme
22	49764579	49764766	MACS_peak_12960	508.73	187	0	0	0	extreme
22	10536862	10537232	MACS_peak_21842	520.65	370	0	0	0	extreme
X	588641	589082	MACS_peak_22015	388.99	441	0	0	0	extreme
X	1258666	1258958	MACS_peak_22017	272.05	292	0	0	0	extreme
X	1581313	1581526	MACS_peak_22018	596.79	213	0	0	0	extreme
X	1704308	1704588	MACS_peak_22019	67.19	280	0	0	0	extreme
X	6327768	6327908	MACS_peak_22028	1001.34	140	0	0	0	extreme
X	8364788	8365129	MACS_peak_22031	420.68	341	0	0	0	extreme
X	9564917	9565147	MACS_peak_22040	218	230	0	1	0	extreme
X	12362869	12363203	MACS_peak_22060	71.12	334	0	1	0	extreme
X	12901535	12901946	MACS_peak_22061	860.78	411	0	0	0	extreme
X	13682877	13683255	MACS_peak_22062	55.51	378	0	0	0	extreme
X	13927278	13927541	MACS_peak_22063	591.18	263	0	1	0	extreme
X	16499447	16499795	MACS_peak_22080	75.42	348	0	0	0	extreme
X	23089295	23089544	MACS_peak_22117	471.88	249	0	0	1	extreme
X	23761761	23761981	MACS_peak_22118	259.39	220	0	1	0	extreme
X	23997714	23997863	MACS_peak_22119	340.32	149	0	1	0	extreme
X	40543859	40544260	MACS_peak_22179	868.4	401	0	0	0	extreme
X	40769863	40770187	MACS_peak_22180	180.31	324	0	0	0	extreme
X	41566996	41567374	MACS_peak_22181	87.81	378	0	1	0	extreme
X	41648905	41649227	MACS_peak_22183	93.4	322	0	1	0	extreme
X	41812805	41813189	MACS_peak_22184	69.92	384	0	1	0	extreme
X	44026586	44026958	MACS_peak_22193	327.36	372	0	0	0	extreme
X	45334454	45334927	MACS_peak_22195	1192.27	473	0	0	0	extreme
X	46413862	46414211	MACS_peak_22202	68.62	349	0	0	0	extreme
X	46975706	46976010	MACS_peak_22203	201.59	304	0	1	0	extreme
X	47312363	47312713	MACS_peak_22205	416.22	350	0	0	0	extreme
X	47714518	47714839	MACS_peak_22206	164.27	321	0	0	1	extreme
X	48205670	48205972	MACS_peak_22208	439.67	302	0	0	0	extreme
X	49338407	49338613	MACS_peak_22209	303.03	206	1	1	0	extreme
X	53147581	53147835	MACS_peak_22236	75.51	254	0	1	0	extreme
X	53595901	53596136	MACS_peak_22237	662.31	235	0	1	0	extreme
X	54734473	54734733	MACS_peak_22243	136.58	260	0	0	0	extreme
X	54909285	54909629	MACS_peak_22244	51.34	344	0	0	0	extreme
X	56585891	56586193	MACS_peak_22254	209.45	302	0	0	0	extreme
X	57299360	57299800	MACS_peak_22258	82.78	440	0	1	0	extreme
X	65457802	65458186	MACS_peak_22327	68.83	384	0	1	0	extreme
X	69986015	69986439	MACS_peak_22365	54.85	424	0	1	0	extreme
X	70517877	70518164	MACS_peak_22367	50.92	287	0	0	0	extreme
X	71071467	71071826	MACS_peak_22374	772.93	359	0	1	0	extreme
X	71652503	71652881	MACS_peak_22376	410.28	378	0	0	0	extreme
X	71999099	71999343	MACS_peak_22381	629.38	244	0	1	0	extreme
X	77473878	77474222	MACS_peak_22412	63.29	344	0	0	0	extreme
X	78403234	78403674	MACS_peak_22416	51.65	440	0	0	0	extreme
X	78552883	78553301	MACS_peak_22418	137.06	418	0	0	0	extreme
X	78855558	78855925	MACS_peak_22419	96.97	367	0	0	0	extreme
X	81033955	81034275	MACS_peak_22434	56.38	320	0	0	0	extreme
X	81673767	81674130	MACS_peak_22436	386.88	363	0	0	0	extreme
X	100768778	100769009	MACS_peak_22535	604.83	231	0	0	0	extreme
X	101538442	101538678	MACS_peak_22538	305.44	236	0	0	1	extreme
X	101596080	101596425	MACS_peak_22539	535.04	345	0	0	0	extreme
X	101605500	101605735	MACS_peak_22540	516.86	235	0	0	0	extreme
X	101712998	101713265	MACS_peak_22541	89.02	267	0	0	0	extreme
X	102608910	102609131	MACS_peak_22558	911.62	221	0	0	2	extreme
X	103176470	103176734	MACS_peak_22560	464.74	264	0	0	0	extreme
X	103343145	103343408	MACS_peak_22561	465.4	263	0	0	0	extreme
X	103774128	103774355	MACS_peak_22562	548.55	227	1	0	0	extreme
X	106470159	106470585	MACS_peak_22592	57.41	426	0	0	0	extreme
X	119516318	119516570	MACS_peak_22718	463.76	252	0	0	0	extreme
X	119966038	119966373	MACS_peak_22719	50.43	335	0	0	1	extreme
X	128526950	128527401	MACS_peak_22781	1353.73	451	0	0	1	extreme
X	129601239	129601458	MACS_peak_22786	1226.97	219	0	0	0	extreme
X	129637572	129637800	MACS_peak_22788	848.95	228	0	0	0	extreme
X	130028119	130028483	MACS_peak_22789	644.14	364	0	1	0	extreme
X	130160435	130160691	MACS_peak_22791	449.95	256	0	1	0	extreme
X	130568315	130568664	MACS_peak_22792	62.01	349	0	0	0	extreme
X	134780918	134781216	MACS_peak_22830	443.84	298	0	1	0	extreme
X	135206364	135206695	MACS_peak_22832	265.34	331	0	0	1	extreme
X	147411672	147412051	MACS_peak_22903	51.95	379	0	0	0	extreme
X	148049470	148049795	MACS_peak_22905	671.43	325	0	0	0	extreme
X	149493608	149493919	MACS_peak_22910	436.49	311	0	2	0	extreme
X	150138079	150138461	MACS_peak_22912	50.92	382	0	0	1	extreme
X	151027528	151027747	MACS_peak_22915	580.62	219	0	0	0	extreme
X	151373511	151373914	MACS_peak_22919	896.63	403	0	0	0	extreme
X	151449574	151450028	MACS_peak_22920	478.76	454	0	0	0	extreme
X	152817187	152817540	MACS_peak_22934	530.32	353	0	0	0	extreme
X	152935281	152935485	MACS_peak_22935	612.68	204	0	1	0	extreme
X	153212252	153212513	MACS_peak_22937	466.72	261	0	0	0	extreme
X	153554858	153555071	MACS_peak_22938	596.79	213	0	1	0	extreme
X	153947348	153947697	MACS_peak_22939	416.71	349	1	0	0	extreme
X	153978562	153978801	MACS_peak_22940	191.05	239	0	1	0	extreme
X	154361029	154361186	MACS_peak_22948	196.82	157	0	1	0	extreme
X	154629083	154629265	MACS_peak_22951	936.57	182	0	0	0	extreme
X	154845932	154846338	MACS_peak_22952	78.38	406	0	1	0	extreme
X	156028458	156028889	MACS_peak_22967	263.36	431	0	0	0	extreme
