chr	start	end	id	score	size	phits	ghits	ohits
1	3621301	3621482	MACS_peak_47	1569.18	181	1	0	0
1	3849254	3849393	MACS_peak_50	1043.77	139	0	1	0
1	7808412	7808703	MACS_peak_66	312.33	291	0	1	0
1	7967141	7967350	MACS_peak_67	780.06	209	0	1	0
1	8561116	8561391	MACS_peak_70	1128.24	275	0	1	0
1	11086620	11086991	MACS_peak_81	228.35	371	0	1	0
1	11642461	11642648	MACS_peak_83	901.33	187	0	1	1
1	11954303	11954502	MACS_peak_84	809.56	199	0	1	0
1	21694568	21694710	MACS_peak_127	384.6	142	0	1	0
1	21701360	21701500	MACS_peak_128	1136.75	140	0	1	0
1	24390073	24390417	MACS_peak_134	784.68	344	0	1	0
1	24635290	24635555	MACS_peak_136	464.09	265	1	0	0
1	26878026	26878314	MACS_peak_154	700.62	288	1	0	0
1	32109480	32109695	MACS_peak_180	799.34	215	1	0	0
1	32215701	32216058	MACS_peak_181	399.64	357	1	1	0
1	36149559	36149840	MACS_peak_199	453.96	281	0	1	0
1	37970423	37970740	MACS_peak_204	76.3	317	0	1	0
1	37971799	37972153	MACS_peak_205	175.85	354	0	1	0
1	39853286	39853582	MACS_peak_210	445	296	0	1	0
1	45512650	45512867	MACS_peak_241	901.33	217	1	1	0
1	46693899	46694325	MACS_peak_251	202.06	426	0	1	0
1	50684255	50684388	MACS_peak_291	1396.21	133	0	1	0
1	50864358	50864796	MACS_peak_292	54.03	438	0	1	0
1	50929492	50929774	MACS_peak_293	453.35	282	0	1	0
1	51769102	51769394	MACS_peak_299	447.34	292	0	1	0
1	52389841	52390056	MACS_peak_300	596.79	215	0	1	0
1	52891920	52892301	MACS_peak_304	290.35	381	1	1	0
1	53854906	53855078	MACS_peak_306	1358.7	172	1	0	0
1	53959706	53959945	MACS_peak_307	620.13	239	0	1	0
1	70239596	70239850	MACS_peak_395	596.79	254	0	1	0
1	70311529	70311821	MACS_peak_396	1835.72	292	0	1	0
1	74228846	74229154	MACS_peak_415	380.3	308	0	2	0
1	74500408	74500743	MACS_peak_416	84.4	335	0	3	0
1	75782828	75783195	MACS_peak_432	150.31	367	1	1	0
1	77899165	77899478	MACS_peak_443	103.45	313	0	1	0
1	77900841	77901162	MACS_peak_444	214.38	321	0	1	0
1	84141168	84141498	MACS_peak_490	426.3	330	0	1	0
1	84230950	84231171	MACS_peak_491	132.92	221	0	1	0
1	84234349	84234710	MACS_peak_492	102.84	361	0	1	0
1	88736708	88736954	MACS_peak_519	485.56	246	0	1	0
1	91001012	91001361	MACS_peak_525	57.54	349	0	1	0
1	91002416	91002765	MACS_peak_526	125.87	349	0	1	0
1	108746332	108746612	MACS_peak_690	454.58	280	1	0	0
1	109027860	109028091	MACS_peak_693	678.9	231	0	1	0
1	109263610	109263986	MACS_peak_695	760.2	376	0	1	0
1	109490456	109490929	MACS_peak_696	581.45	473	1	1	0
1	109499995	109500233	MACS_peak_697	954.29	238	1	1	0
1	109546307	109546618	MACS_peak_698	1085.67	311	1	1	0
1	109980685	109980904	MACS_peak_702	580.62	219	1	0	0
1	113070881	113071224	MACS_peak_729	89.02	343	1	0	1
1	113905131	113905326	MACS_peak_746	447.48	195	1	0	0
1	113949258	113949470	MACS_peak_747	856.48	212	0	1	0
1	114428154	114428526	MACS_peak_756	1656.19	372	0	1	0
1	114431606	114431846	MACS_peak_757	589.16	240	0	1	0
1	114468513	114468879	MACS_peak_758	369.28	366	0	1	1
1	114471441	114471645	MACS_peak_759	552.85	204	0	1	0
1	114489037	114489430	MACS_peak_760	655.79	393	0	1	0
1	114570367	114570602	MACS_peak_763	366.7	235	1	0	0
1	114758093	114758320	MACS_peak_768	665.93	227	0	1	0
1	114765218	114765351	MACS_peak_769	820.94	133	1	0	0
1	116531261	116531590	MACS_peak_796	801.89	329	0	1	0
1	116570337	116570571	MACS_peak_797	814.37	234	1	1	0
1	116574451	116574841	MACS_peak_798	1418.79	390	1	0	0
1	116581209	116581341	MACS_peak_799	1116.4	132	0	1	0
1	116764050	116764398	MACS_peak_803	417.2	348	0	1	0
1	117055323	117055660	MACS_peak_805	662.69	337	1	0	1
1	117402383	117402597	MACS_peak_808	1098.16	214	0	1	0
1	117512765	117513012	MACS_peak_809	629.38	247	0	1	0
1	144969519	144969868	MACS_peak_905	55.54	349	0	1	0
1	144966973	144967271	MACS_peak_906	53.71	298	0	1	0
1	146138077	146138542	MACS_peak_942	1241.95	465	0	2	0
1	145661079	145661321	MACS_peak_949	111.29	242	0	1	0
1	145617453	145617688	MACS_peak_950	421.83	235	0	1	0
1	148120454	148120925	MACS_peak_953	702.27	471	0	1	0
1	146966420	146966794	MACS_peak_957	1254.58	374	0	1	0
1	146960077	146960449	MACS_peak_961	439.14	372	0	1	0
1	146966420	146966730	MACS_peak_962	1362.1	310	0	1	0
1	146972611	146973030	MACS_peak_963	857.26	419	0	1	0
1	146990071	146990264	MACS_peak_964	108.52	193	0	1	0
1	147930027	147930459	MACS_peak_981	388.99	432	1	0	0
1	147937862	147938082	MACS_peak_982	566.9	220	0	1	0
1	147983453	147983811	MACS_peak_984	61.23	358	0	1	0
1	148120454	148120743	MACS_peak_986	813.61	289	0	1	0
1	148126714	148127069	MACS_peak_987	187.57	355	0	1	0
1	150068289	150068520	MACS_peak_1030	744.89	231	1	0	0
1	150072958	150073235	MACS_peak_1031	566.95	277	0	1	0
1	150092629	150092854	MACS_peak_1032	615.31	225	0	1	0
1	150114982	150115293	MACS_peak_1033	627.75	311	0	1	0
1	150452559	150452915	MACS_peak_1038	343.22	356	0	1	0
1	150501201	150501421	MACS_peak_1039	360.97	220	0	1	0
1	150621444	150621908	MACS_peak_1042	554.79	464	0	1	0
1	150922516	150922895	MACS_peak_1046	695.87	379	1	0	0
1	151155925	151156288	MACS_peak_1050	1180.37	363	3	0	0
1	151196176	151196572	MACS_peak_1051	1028.03	396	1	0	0
1	151251743	151252043	MACS_peak_1052	989.86	300	1	0	0
1	153355511	153355802	MACS_peak_1084	447.93	291	1	0	0
1	153797347	153797624	MACS_peak_1089	456.44	277	0	1	1
1	153847650	153847851	MACS_peak_1090	554.96	201	0	1	0
1	153904050	153904318	MACS_peak_1091	547.83	268	0	1	0
1	153946630	153946833	MACS_peak_1092	629.38	203	1	0	0
1	154479894	154480078	MACS_peak_1095	918.92	184	0	1	0
1	154534278	154534628	MACS_peak_1096	403.01	350	0	1	0
1	155061573	155061910	MACS_peak_1099	790.35	337	2	1	0
1	155086122	155086335	MACS_peak_1100	596.79	213	0	2	0
1	155250744	155251024	MACS_peak_1103	454.58	280	1	0	0
1	155277250	155277512	MACS_peak_1104	656.83	262	1	1	0
1	155494335	155494575	MACS_peak_1105	770.24	240	0	1	0
1	155837509	155837675	MACS_peak_1108	795.29	166	0	1	0
1	156066270	156066588	MACS_peak_1110	498.48	318	0	1	0
1	156192255	156192473	MACS_peak_1113	363.4	218	1	0	0
1	156317526	156317853	MACS_peak_1114	637.34	327	0	1	0
1	156319683	156319956	MACS_peak_1115	446.99	273	0	1	0
1	156719742	156719877	MACS_peak_1119	1630.94	135	1	0	0
1	158954683	158954987	MACS_peak_1140	56.74	304	0	1	0
1	162065812	162065946	MACS_peak_1172	1359.65	134	1	0	0
1	162230228	162230484	MACS_peak_1173	470.06	256	0	1	0
1	163262418	163262818	MACS_peak_1181	134.77	400	1	1	1
1	163315876	163316215	MACS_peak_1182	538.66	339	0	2	1
1	173973967	173974317	MACS_peak_1266	478.89	350	0	1	0
1	182784642	182784853	MACS_peak_1368	1116.4	211	1	0	0
1	193183105	193183424	MACS_peak_1469	811.38	319	1	1	0
1	197526815	197527134	MACS_peak_1508	880.59	319	0	1	0
1	197615148	197615422	MACS_peak_1509	488.85	274	0	1	0
1	197619104	197619365	MACS_peak_1510	860.98	261	0	1	0
1	197709846	197710272	MACS_peak_1512	60.03	426	0	1	0
1	197713679	197713993	MACS_peak_1513	369.05	314	0	1	0
1	197739627	197739834	MACS_peak_1514	756.91	207	0	1	0
1	203830819	203831066	MACS_peak_1593	160.74	247	0	2	0
1	203861180	203861615	MACS_peak_1594	1877.72	435	1	0	0
1	206233274	206233613	MACS_peak_1633	495.28	339	0	1	0
1	206331636	206331945	MACS_peak_1637	56.98	309	0	1	0
1	206384890	206385231	MACS_peak_1638	264.38	341	0	1	0
1	206911150	206911469	MACS_peak_1649	1658.62	319	0	1	0
1	207041299	207041607	MACS_peak_1650	178.37	308	1	1	0
1	207049985	207050191	MACS_peak_1651	573.39	206	0	2	0
1	207077865	207078127	MACS_peak_1652	1292.87	262	0	1	0
1	212070652	212070996	MACS_peak_1677	419.18	344	0	1	0
1	217557302	217557514	MACS_peak_1710	450.48	212	0	1	0
1	217694633	217694973	MACS_peak_1711	65.49	340	0	1	0
1	217747268	217747610	MACS_peak_1712	925.78	342	0	1	0
1	217811587	217811827	MACS_peak_1713	440.38	240	0	1	0
1	219990991	219991297	MACS_peak_1738	439.28	306	0	1	0
1	220123913	220124249	MACS_peak_1739	644.82	336	0	1	0
1	220154720	220155101	MACS_peak_1740	312.33	381	0	1	0
1	220189788	220190085	MACS_peak_1741	444.41	297	0	1	0
1	220218684	220218946	MACS_peak_1742	1040.74	262	0	1	0
1	220775256	220775582	MACS_peak_1744	1209.66	326	0	1	0
1	224427704	224427898	MACS_peak_1776	678.9	194	0	1	0
1	228393492	228393763	MACS_peak_1794	584.96	271	1	0	0
1	229453313	229453536	MACS_peak_1818	1208.41	223	0	1	0
1	236598011	236598247	MACS_peak_1841	516.86	236	0	1	0
1	247576535	247576814	MACS_peak_1889	578.93	279	0	1	1
2	6897181	6897463	MACS_peak_9874	592.88	282	0	1	0
2	10668515	10668783	MACS_peak_9892	853.65	268	0	1	0
2	10835347	10835564	MACS_peak_9893	564.92	217	0	1	0
2	11446781	11447029	MACS_peak_9899	485.56	248	1	0	0
2	25397875	25398226	MACS_peak_10003	774.9	351	0	1	0
2	25606819	25607129	MACS_peak_10004	437.04	310	0	1	0
2	25616658	25616960	MACS_peak_10005	265.34	302	0	1	0
2	25625541	25625678	MACS_peak_10006	1420.82	137	0	1	0
2	27621518	27621823	MACS_peak_10017	439.84	305	1	1	1
2	27683559	27683869	MACS_peak_10018	682.83	310	0	1	0
2	27945659	27945958	MACS_peak_10019	506.92	299	0	2	0
2	28026651	28026989	MACS_peak_10020	967.61	338	0	1	0
2	28214323	28214633	MACS_peak_10021	813.39	310	0	1	0
2	31933313	31933457	MACS_peak_10050	769.86	144	0	2	0
2	31969498	31969692	MACS_peak_10051	632.58	194	0	2	0
2	39055333	39055609	MACS_peak_10111	1422.18	276	0	1	0
2	39059394	39059674	MACS_peak_10112	361.13	280	0	1	0
2	58174860	58175302	MACS_peak_10237	125.99	442	0	1	0
2	58176540	58176908	MACS_peak_10238	50	368	0	1	0
2	58202136	58202371	MACS_peak_10239	972.07	235	0	1	0
2	58217283	58217556	MACS_peak_10240	458.95	273	0	1	0
2	63861682	63861980	MACS_peak_10283	565.28	298	0	1	0
2	63888765	63889128	MACS_peak_10284	644.81	363	1	1	0
2	63928666	63928906	MACS_peak_10285	223.38	240	0	1	0
2	70977403	70977715	MACS_peak_10340	435.94	312	1	1	0
2	73033300	73033492	MACS_peak_10357	866.35	192	0	1	0
2	74392041	74392376	MACS_peak_10373	423.72	335	1	0	1
2	97112228	97112655	MACS_peak_10618	1677.51	427	1	0	0
2	97171060	97171424	MACS_peak_10619	61.7	364	0	1	0
2	97229411	97229618	MACS_peak_10620	170.73	207	0	1	0
2	98594839	98595286	MACS_peak_10631	75.42	447	1	0	0
2	101012705	101012938	MACS_peak_10641	712.11	233	0	2	0
2	101016277	101016530	MACS_peak_10642	83.72	253	0	2	0
2	102311765	102312101	MACS_peak_10651	663.41	336	2	0	0
2	102325829	102326293	MACS_peak_10652	222.1	464	0	2	0
2	102327833	102328151	MACS_peak_10653	50.5	318	0	2	0
2	102753618	102753953	MACS_peak_10657	664.12	335	0	1	0
2	109546134	109546401	MACS_peak_10708	854.69	267	1	0	0
2	111619517	111619737	MACS_peak_10743	564.54	220	0	1	2
2	111813254	111813675	MACS_peak_10744	649.49	421	0	1	0
2	111850726	111851128	MACS_peak_10745	1178.01	402	0	1	0
2	117926086	117926403	MACS_peak_10812	57.81	317	0	1	1
2	117967856	117968057	MACS_peak_10813	645.81	201	0	1	0
2	118003400	118003582	MACS_peak_10814	687.62	182	0	1	1
2	130155893	130156280	MACS_peak_10875	511.42	387	1	0	0
2	130360505	130360858	MACS_peak_10877	651.52	353	1	0	0
2	131492341	131492566	MACS_peak_10880	548.55	225	0	1	0
2	135138900	135139074	MACS_peak_10918	1208.41	174	1	1	0
2	135294236	135294486	MACS_peak_10919	82.05	250	0	1	0
2	135407909	135408220	MACS_peak_10920	51.07	311	0	1	0
2	135424889	135425207	MACS_peak_10921	940.27	318	0	1	0
2	135515691	135515886	MACS_peak_10922	352.92	195	0	1	0
2	135685652	135686003	MACS_peak_10923	415.73	351	0	1	0
2	147937744	147938114	MACS_peak_10993	640.22	370	0	1	0
2	148780375	148780613	MACS_peak_11001	502.51	238	0	1	0
2	149035305	149035602	MACS_peak_11006	373.73	297	1	0	0
2	151798797	151798963	MACS_peak_11024	762.11	166	1	1	0
2	158188745	158188922	MACS_peak_11078	972.07	177	0	1	1
2	158264816	158265040	MACS_peak_11079	712.32	224	0	1	0
2	158283509	158283895	MACS_peak_11080	131.14	386	0	1	0
2	158424239	158424419	MACS_peak_11081	446.02	180	0	1	1
2	162297975	162298273	MACS_peak_11109	692.37	298	0	1	0
2	169611586	169611855	MACS_peak_11169	603.02	269	0	1	0
2	171705548	171705876	MACS_peak_11181	669.21	328	0	1	0
2	171706221	171706517	MACS_peak_11182	693.99	296	0	1	0
2	171940922	171941262	MACS_peak_11183	407.96	340	0	2	0
2	171970495	171970649	MACS_peak_11184	740.33	154	0	2	0
2	174354315	174354754	MACS_peak_11209	1229.91	439	0	1	0
2	174380433	174380671	MACS_peak_11210	516.86	238	0	1	0
2	176127102	176127314	MACS_peak_11223	758.25	212	2	0	1
2	181573061	181573371	MACS_peak_11264	437.04	310	0	1	0
2	181664613	181664973	MACS_peak_11265	84.06	360	0	1	0
2	188976610	188976981	MACS_peak_11325	639.57	371	1	0	0
2	188983368	188983712	MACS_peak_11326	482.41	344	0	1	0
2	189027043	189027327	MACS_peak_11327	52.27	284	1	0	0
2	189466700	189467008	MACS_peak_11331	558.46	308	0	1	0
2	189660919	189661395	MACS_peak_11332	815.52	476	1	0	0
2	196298136	196298475	MACS_peak_11391	351.43	339	0	1	0
2	196337465	196337767	MACS_peak_11392	441.54	302	0	1	0
2	196521691	196521983	MACS_peak_11393	147.15	292	0	1	0
2	196526783	196527100	MACS_peak_11394	102.96	317	0	1	0
2	200856812	200857007	MACS_peak_11431	485.3	195	1	0	0
2	202262175	202262548	MACS_peak_11437	103.45	373	1	0	0
2	202279031	202279363	MACS_peak_11438	425.26	332	0	1	0
2	203294840	203294980	MACS_peak_11444	275.54	140	0	1	0
2	219171214	219171490	MACS_peak_11564	984.35	276	1	0	0
2	223970379	223970573	MACS_peak_11588	848.95	194	1	0	0
2	233380541	233380786	MACS_peak_11634	629.38	245	0	1	0
2	236084991	236085345	MACS_peak_11642	159.56	354	0	1	0
2	239357782	239358107	MACS_peak_11656	603.02	325	0	1	0
2	239909877	239910132	MACS_peak_11658	1853.13	255	0	1	0
3	5165297	5165484	MACS_peak_13016	712.32	187	0	1	1
3	9424869	9425077	MACS_peak_13047	931.22	208	0	1	0
3	15202651	15202999	MACS_peak_13098	647.33	348	1	0	1
3	15220335	15220603	MACS_peak_13099	450.74	268	0	1	0
3	15401428	15401560	MACS_peak_13102	977.06	132	0	1	0
3	15405465	15405788	MACS_peak_13103	548.63	323	0	1	0
3	15731841	15731980	MACS_peak_13104	701.67	139	0	1	0
3	15812318	15812631	MACS_peak_13105	1667.82	313	0	1	0
3	15815727	15816014	MACS_peak_13106	1258.14	287	0	1	0
3	16268136	16268342	MACS_peak_13112	1477.15	206	1	0	0
3	25648043	25648451	MACS_peak_13213	518.48	408	0	1	0
3	25760859	25760998	MACS_peak_13214	652.22	139	0	1	0
3	27205040	27205477	MACS_peak_13227	123	437	0	1	0
3	27279324	27279512	MACS_peak_13228	883.81	188	0	1	0
3	27312149	27312378	MACS_peak_13229	548.55	229	0	1	0
3	27373371	27373622	MACS_peak_13230	883.81	251	1	0	0
3	27439566	27439790	MACS_peak_13231	549.18	224	0	1	0
3	28317438	28317706	MACS_peak_13239	853.65	268	1	1	0
3	28328496	28328887	MACS_peak_13240	406.81	391	0	1	0
3	31724736	31724989	MACS_peak_13261	470.06	253	0	1	0
3	32279515	32279878	MACS_peak_13265	64.31	363	0	1	0
3	32537971	32538171	MACS_peak_13267	983.72	200	0	1	0
3	32733534	32733947	MACS_peak_13269	613.85	413	0	1	1
3	33285310	33285583	MACS_peak_13270	103.45	273	0	1	0
3	33309051	33309336	MACS_peak_13271	451.52	285	0	1	0
3	33511646	33512026	MACS_peak_13273	61.75	380	0	1	0
3	33867012	33867309	MACS_peak_13276	693.18	297	0	1	0
3	41203033	41203252	MACS_peak_13331	1061.85	219	0	1	0
3	42788114	42788304	MACS_peak_13339	695.57	190	1	1	1
3	42848109	42848330	MACS_peak_13340	227.89	221	0	3	2
3	42921999	42922378	MACS_peak_13342	66.96	379	0	2	0
3	43488876	43489181	MACS_peak_13344	104.57	305	0	1	0
3	43503042	43503458	MACS_peak_13345	732.46	416	0	1	0
3	43638589	43638822	MACS_peak_13346	532.66	233	0	1	0
3	43681010	43681261	MACS_peak_13347	234.8	251	0	1	0
3	43730387	43730519	MACS_peak_13348	1116.4	132	0	1	0
3	45705391	45705645	MACS_peak_13352	883.81	254	0	1	0
3	45929113	45929333	MACS_peak_13353	564.54	220	0	1	0
3	46372595	46372837	MACS_peak_13355	645.81	242	1	0	1
3	46783255	46783628	MACS_peak_13356	81.56	373	0	2	0
3	46923566	46923740	MACS_peak_13358	780.06	174	1	0	0
3	47421161	47421360	MACS_peak_13359	645.81	199	0	1	0
3	47468405	47468736	MACS_peak_13360	67.49	331	0	1	0
3	47990087	47990264	MACS_peak_13361	763.02	177	0	1	0
3	48436000	48436297	MACS_peak_13363	1101.6	297	2	0	0
3	48952636	48952896	MACS_peak_13364	593.56	260	0	1	0
3	49010260	49010440	MACS_peak_13365	583.31	180	1	0	0
3	49464593	49464938	MACS_peak_13366	312.33	345	1	0	0
3	49839300	49839493	MACS_peak_13368	866.35	193	0	1	0
3	50226146	50226362	MACS_peak_13370	528	216	1	0	0
3	50246253	50246462	MACS_peak_13371	606	209	0	1	0
3	50616010	50616214	MACS_peak_13372	1358.26	204	1	0	0
3	57824406	57824676	MACS_peak_13412	546.29	270	0	1	0
3	57885662	57885999	MACS_peak_13413	293.19	337	0	1	0
3	58510529	58510669	MACS_peak_13414	1025.76	140	0	1	0
3	58565328	58565538	MACS_peak_13415	624.46	210	1	0	0
3	63842271	63842536	MACS_peak_13483	465.8	265	0	2	0
3	63851526	63851752	MACS_peak_13484	826.97	226	0	1	0
3	63961798	63962131	MACS_peak_13486	424.75	333	0	2	0
3	63992983	63993307	MACS_peak_13487	174.17	324	0	2	0
3	64014510	64014781	MACS_peak_13489	1307.61	271	1	0	1
3	64016046	64016307	MACS_peak_13490	161.92	261	0	1	0
3	64021992	64022277	MACS_peak_13491	331.88	285	0	1	0
3	66138615	66138994	MACS_peak_13553	515.71	379	0	1	0
3	66236233	66236538	MACS_peak_13554	686.76	305	0	1	0
3	69061914	69062099	MACS_peak_13568	901.33	185	0	1	0
3	72748233	72748367	MACS_peak_13590	1098.16	134	1	0	0
3	100283226	100283387	MACS_peak_13830	866.35	161	0	1	0
3	108205618	108206067	MACS_peak_13896	959.23	449	0	1	0
3	108674538	108674770	MACS_peak_13902	537.4	232	0	1	0
3	108686062	108686276	MACS_peak_13903	596.79	214	0	1	0
3	111338008	111338372	MACS_peak_13927	1031.37	364	0	1	0
3	112189397	112189772	MACS_peak_13931	56.38	375	0	1	0
3	112205275	112205495	MACS_peak_13932	175.39	220	0	1	0
3	112225255	112225630	MACS_peak_13933	404.42	375	0	1	0
3	113736501	113736833	MACS_peak_13945	425.26	332	0	1	0
3	119821012	119821467	MACS_peak_13988	1288.68	455	1	0	0
3	119891862	119892243	MACS_peak_13989	514.63	381	0	1	0
3	119954066	119954363	MACS_peak_13990	534.92	297	0	1	0
3	120723544	120723940	MACS_peak_13999	54.13	396	0	1	0
3	120736203	120736511	MACS_peak_14000	143.12	308	0	1	0
3	123258711	123259179	MACS_peak_14022	469.45	468	0	1	0
3	123262527	123262819	MACS_peak_14023	829.92	292	0	1	0
3	123652374	123652762	MACS_peak_14028	510.89	388	0	1	0
3	123852444	123852706	MACS_peak_14029	114.74	262	0	1	0
3	125268868	125269083	MACS_peak_14039	896.52	215	0	1	0
3	128753278	128753479	MACS_peak_14071	478.76	201	0	1	0
3	130699740	130700085	MACS_peak_14084	418.68	345	0	1	0
3	130723059	130723196	MACS_peak_14085	896.34	137	0	1	0
3	131057393	131057861	MACS_peak_14087	51.51	468	0	1	1
3	131333541	131333855	MACS_peak_14089	70.49	314	0	1	1
3	131473534	131473944	MACS_peak_14092	615.59	410	0	1	0
3	131486002	131486248	MACS_peak_14093	93.49	246	0	1	0
3	132469892	132470355	MACS_peak_14104	148.8	463	0	1	0
3	132485994	132486210	MACS_peak_14105	746.04	216	0	1	0
3	132657758	132657892	MACS_peak_14106	916.48	134	1	2	0
3	138524131	138524416	MACS_peak_14172	58.29	285	0	1	0
3	138545067	138545413	MACS_peak_14173	434.11	346	0	1	0
3	139145086	139145447	MACS_peak_14178	52.12	361	0	1	0
3	139333714	139334101	MACS_peak_14179	79.31	387	0	1	0
3	139381667	139381928	MACS_peak_14180	592.77	261	0	1	0
3	148861296	148861626	MACS_peak_14261	928.77	330	1	0	1
3	150616285	150616645	MACS_peak_14285	96.97	360	0	1	0
3	151116988	151117346	MACS_peak_14289	402.61	358	0	1	0
3	151168367	151168649	MACS_peak_14290	450.7	282	0	1	0
3	151218856	151219002	MACS_peak_14291	914.4	146	0	2	0
3	151247113	151247549	MACS_peak_14292	69.92	436	0	2	0
3	151290685	151291008	MACS_peak_14293	548.63	323	1	1	0
3	151426018	151426484	MACS_peak_14295	1317.25	466	1	1	0
3	155438520	155438892	MACS_peak_14339	72.11	372	0	1	0
3	155537099	155537237	MACS_peak_14340	1025.3	138	0	1	0
3	155544855	155545290	MACS_peak_14341	68.1	435	0	1	0
3	155701918	155702177	MACS_peak_14342	603.02	259	0	1	0
3	161099590	161099937	MACS_peak_14407	913.18	347	0	1	0
3	161120940	161121127	MACS_peak_14408	437.67	187	0	1	0
3	161220482	161220724	MACS_peak_14409	611.55	242	0	1	0
3	170860031	170860408	MACS_peak_14519	889.09	377	1	0	1
3	179382175	179382598	MACS_peak_14583	105.65	423	0	1	0
3	179558799	179559221	MACS_peak_14584	2214.43	422	1	0	0
3	179619807	179620013	MACS_peak_14585	185.79	206	0	1	0
3	179750797	179751063	MACS_peak_14586	463.44	266	0	1	0
3	179797488	179797850	MACS_peak_14588	410.45	362	1	0	0
3	179811591	179811878	MACS_peak_14589	417.57	287	0	1	0
3	179929150	179929556	MACS_peak_14590	864.57	406	0	1	0
3	180707403	180707625	MACS_peak_14602	831.64	222	0	1	0
3	180802825	180803170	MACS_peak_14603	418.68	345	0	1	1
3	180964294	180964667	MACS_peak_14604	405.33	373	0	1	0
3	184162333	184162577	MACS_peak_14623	501.16	244	0	1	0
3	184174585	184174872	MACS_peak_14624	682.8	287	1	0	0
3	185629095	185629336	MACS_peak_14637	588.69	241	0	1	0
3	189967339	189967509	MACS_peak_14678	719.86	170	0	1	0
3	193606729	193607000	MACS_peak_14705	77.03	271	0	1	0
3	195424277	195424416	MACS_peak_14715	685.04	139	0	1	0
3	196068125	196068313	MACS_peak_14724	883.81	188	0	1	0
3	196684932	196685149	MACS_peak_14727	1276.33	217	0	1	0
3	196759397	196759540	MACS_peak_14728	689.56	143	0	1	0
3	196898558	196898990	MACS_peak_14730	934.75	432	0	1	0
3	197807107	197807239	MACS_peak_14737	950.58	132	0	1	0
4	926644	926844	MACS_peak_14754	645.81	200	0	1	0
4	2230389	2230709	MACS_peak_14759	438.69	320	1	1	0
4	5727256	5727486	MACS_peak_14780	96.34	230	0	1	0
4	15649903	15650287	MACS_peak_14880	513.02	384	0	1	0
4	17631946	17632189	MACS_peak_14889	210.25	243	1	1	0
4	37940103	37940395	MACS_peak_14988	89.02	292	0	1	0
4	37975577	37975826	MACS_peak_14989	744.66	249	0	1	0
4	38077623	38077756	MACS_peak_14991	1098.16	133	0	1	0
4	39619322	39619546	MACS_peak_14996	1025.76	224	0	1	0
4	39930211	39930351	MACS_peak_14997	603.93	140	0	1	0
4	39976507	39976698	MACS_peak_14998	695.57	191	0	1	0
4	41958589	41958972	MACS_peak_15007	613.41	383	0	1	0
4	47564449	47564714	MACS_peak_15034	1141.07	265	0	1	0
4	48003518	48003869	MACS_peak_15036	779.13	351	0	2	0
4	53407833	53408209	MACS_peak_15091	131.65	376	0	2	0
4	53432806	53433181	MACS_peak_15092	391.26	375	0	2	0
4	54234336	54234595	MACS_peak_15099	726.32	259	0	2	0
4	55343010	55343155	MACS_peak_15103	1142.17	145	1	0	0
4	55400116	55400555	MACS_peak_15104	406.81	439	1	0	0
4	55510635	55510768	MACS_peak_15105	1396.21	133	0	1	0
4	56424917	56425149	MACS_peak_15110	532.66	232	0	1	1
4	70688051	70688429	MACS_peak_15199	403.06	378	1	0	0
4	70918826	70919203	MACS_peak_15200	75.69	377	0	1	0
4	71016656	71016919	MACS_peak_15201	138.55	263	0	2	0
4	82739345	82739647	MACS_peak_15285	820.61	302	0	1	0
4	82785365	82785558	MACS_peak_15286	678.9	193	0	1	0
4	82898243	82898579	MACS_peak_15287	423.21	336	1	1	1
4	83055036	83055238	MACS_peak_15289	500.39	202	0	1	0
4	84760691	84760936	MACS_peak_15300	124.01	245	0	1	0
4	84761795	84762248	MACS_peak_15301	71.7	453	0	1	0
4	100421450	100421785	MACS_peak_15407	541.11	335	0	1	0
4	100473454	100473646	MACS_peak_15408	1023.52	192	0	1	0
4	100528867	100529246	MACS_peak_15409	159.55	379	0	1	0
4	100645645	100645906	MACS_peak_15410	1001.77	261	0	1	0
4	100717981	100718273	MACS_peak_15411	54.15	292	0	1	0
4	100806576	100806909	MACS_peak_15412	424.75	333	0	1	0
4	103187810	103188125	MACS_peak_15426	72.01	315	0	1	0
4	105730412	105730800	MACS_peak_15441	89.02	388	0	2	0
4	105863554	105863858	MACS_peak_15442	108.34	304	0	1	0
4	105865118	105865547	MACS_peak_15443	68.83	429	0	1	0
4	109826823	109827041	MACS_peak_15460	580.62	218	1	0	0
4	122999907	123000237	MACS_peak_15541	55.53	330	0	1	0
4	123017245	123017456	MACS_peak_15542	365.38	211	0	1	0
4	123096096	123096330	MACS_peak_15543	532.66	234	0	1	0
4	123117395	123117600	MACS_peak_15544	896.36	205	0	1	0
4	123196446	123196654	MACS_peak_15545	1320.51	208	0	1	0
4	140360108	140360378	MACS_peak_15617	460.86	270	0	1	1
4	140523798	140524032	MACS_peak_15619	385.26	234	1	0	0
4	145009917	145010205	MACS_peak_15645	96.57	288	0	2	0
4	145609813	145610209	MACS_peak_15647	506.71	396	0	1	0
4	146814704	146814857	MACS_peak_15655	506.18	153	0	1	0
4	146893184	146893652	MACS_peak_15656	147.58	468	0	1	0
4	146916572	146917001	MACS_peak_15657	974.86	429	0	1	0
4	156968469	156968873	MACS_peak_15708	619.12	404	0	1	0
4	168445800	168446087	MACS_peak_15774	82.13	287	0	1	0
4	168870267	168870532	MACS_peak_15775	464.09	265	0	2	0
4	174305804	174306148	MACS_peak_15806	657.74	344	0	1	0
4	174319067	174319490	MACS_peak_15807	1382.4	423	0	1	0
5	5467435	5467694	MACS_peak_15882	578.34	259	0	1	0
5	7868113	7868381	MACS_peak_15893	853.65	268	0	2	0
5	16456292	16456517	MACS_peak_15936	866.35	225	1	0	0
5	36917542	36917851	MACS_peak_16078	64.39	309	0	1	0
5	36944566	36944935	MACS_peak_16079	640.87	369	0	1	0
5	36973212	36973494	MACS_peak_16080	265.34	282	0	1	0
5	37005998	37006346	MACS_peak_16081	417.2	348	0	1	0
5	37332060	37332196	MACS_peak_16083	1435.06	136	0	1	0
5	37412968	37413279	MACS_peak_16084	1350.42	311	0	1	0
5	43105712	43106037	MACS_peak_16128	800.34	325	0	1	0
5	53004807	53005027	MACS_peak_16224	625.11	220	0	1	0
5	55105956	55106380	MACS_peak_16239	579.03	424	1	0	0
5	55292431	55292607	MACS_peak_16240	972.07	176	0	1	1
5	55344346	55344774	MACS_peak_16241	975.66	428	0	1	0
5	57195973	57196114	MACS_peak_16251	345.1	141	0	1	0
5	60649377	60649638	MACS_peak_16274	576.74	261	0	1	0
5	60667882	60668355	MACS_peak_16275	697.34	473	0	1	0
5	62443855	62444149	MACS_peak_16284	446.16	294	0	2	0
5	62460540	62460845	MACS_peak_16285	439.84	305	0	2	0
5	64958815	64959069	MACS_peak_16301	470.06	254	0	1	0
5	66018364	66018774	MACS_peak_16306	953.02	410	0	1	0
5	66040728	66040860	MACS_peak_16307	1116.4	132	0	1	0
5	66050761	66050913	MACS_peak_16308	548.25	152	0	1	0
5	66060780	66061159	MACS_peak_16309	87.49	379	0	1	0
5	69373593	69373806	MACS_peak_16335	602.31	213	1	0	0
5	77752163	77752389	MACS_peak_16423	400.49	226	0	1	0
5	77809519	77809822	MACS_peak_16424	89.02	303	0	1	0
5	94226518	94226928	MACS_peak_16550	189.51	410	0	1	0
5	94737961	94738170	MACS_peak_16551	771.58	209	0	2	0
5	112873088	112873220	MACS_peak_16689	977.06	132	1	1	0
5	112996106	112996309	MACS_peak_16690	989.9	203	0	1	0
5	115831231	115831526	MACS_peak_16708	694.81	295	1	0	0
5	115839080	115839347	MACS_peak_16709	718.95	267	1	1	0
5	115888122	115888358	MACS_peak_16710	516.86	236	0	1	0
5	119062947	119063310	MACS_peak_16732	407.35	363	0	1	1
5	123545654	123545876	MACS_peak_16759	712.32	222	0	1	0
5	123611130	123611593	MACS_peak_16760	1777.03	463	0	1	0
5	131381314	131381637	MACS_peak_16811	312.33	323	0	1	0
5	131515955	131516170	MACS_peak_16812	630.08	215	0	2	0
5	131589578	131589874	MACS_peak_16813	445	296	0	2	0
5	131732334	131732574	MACS_peak_16814	198.25	240	0	2	0
5	131734761	131735222	MACS_peak_16815	55.51	461	0	2	0
5	131778363	131778710	MACS_peak_16816	94.4	347	0	2	0
5	133025364	133025721	MACS_peak_16825	265.34	357	0	1	0
5	133105993	133106245	MACS_peak_16826	460.18	252	0	1	0
5	136174210	136174408	MACS_peak_16843	662.31	198	0	1	0
5	138195435	138195739	MACS_peak_16859	561.16	304	0	1	0
5	138352355	138352710	MACS_peak_16860	650.16	355	1	0	0
5	138411122	138411447	MACS_peak_16861	1065.38	325	0	1	0
5	138464014	138464374	MACS_peak_16863	526.28	360	1	0	0
5	139548085	139548290	MACS_peak_16871	481.25	205	0	1	0
5	139582556	139582755	MACS_peak_16872	740.33	199	0	1	0
5	139610437	139610759	MACS_peak_16873	424.26	322	0	1	0
5	140997231	140997444	MACS_peak_16881	596.79	213	0	15	0
5	141198901	141199112	MACS_peak_16884	596.79	211	1	0	2
5	141326006	141326367	MACS_peak_16885	397.74	361	1	0	0
5	141330328	141330501	MACS_peak_16886	723.41	173	1	0	0
5	141349805	141350117	MACS_peak_16887	555.79	312	1	3	0
5	141512414	141512631	MACS_peak_16888	746.04	217	1	22	0
5	146130554	146130787	MACS_peak_16922	538.37	233	0	1	0
5	149269044	149269348	MACS_peak_16946	440.4	304	1	0	2
5	149317250	149317480	MACS_peak_16947	532.66	230	0	1	0
5	150484246	150484381	MACS_peak_16953	944.23	135	1	0	1
5	150737303	150737493	MACS_peak_16955	568.54	190	0	1	0
5	150747507	150747988	MACS_peak_16956	72.76	481	0	1	0
5	154180221	154180418	MACS_peak_16989	831.63	197	0	1	0
5	154935769	154936063	MACS_peak_16995	265.34	294	0	1	0
5	154945776	154945951	MACS_peak_16996	972.07	175	1	0	0
5	154953354	154953492	MACS_peak_16997	1148.16	138	0	1	0
5	154967497	154967760	MACS_peak_16998	722.6	263	0	1	0
5	157085373	157085711	MACS_peak_17017	141.66	338	1	0	0
5	157096045	157096366	MACS_peak_17018	312.33	321	0	1	0
5	157816728	157817032	MACS_peak_17021	561.16	304	0	1	0
5	157829086	157829422	MACS_peak_17022	384.23	336	0	1	0
5	160021899	160022247	MACS_peak_17031	888.36	348	0	1	0
5	163456483	163456703	MACS_peak_17058	564.54	220	1	1	0
5	169821286	169821564	MACS_peak_17083	113.31	278	0	1	0
5	169824056	169824386	MACS_peak_17084	63.46	330	0	1	0
5	171912167	171912555	MACS_peak_17097	628.81	388	0	1	0
5	171956095	171956364	MACS_peak_17098	461.5	269	0	1	0
5	172002372	172002715	MACS_peak_17099	380.3	343	0	1	0
5	172207814	172208067	MACS_peak_17102	596.79	253	1	0	0
5	176448109	176448342	MACS_peak_17130	416.25	233	1	0	0
5	177185660	177186105	MACS_peak_17136	1091.75	445	0	1	0
5	177455418	177455800	MACS_peak_17138	401.26	382	1	1	0
5	178130278	178130561	MACS_peak_17146	474.02	283	1	0	0
5	179106627	179107044	MACS_peak_17148	144.59	417	1	0	0
5	179763153	179763517	MACS_peak_17151	1594.76	364	0	1	0
6	482770	483106	MACS_peak_17182	113.69	336	1	0	0
6	494938	495141	MACS_peak_17183	540.33	203	0	1	0
6	605782	606012	MACS_peak_17185	189.46	230	0	1	0
6	617510	617727	MACS_peak_17186	580.62	217	0	1	0
6	624902	625195	MACS_peak_17187	696.46	293	0	1	0
6	2952621	2952979	MACS_peak_17207	648.14	358	1	0	0
6	5143725	5144003	MACS_peak_17217	455.81	278	0	1	0
6	5269054	5269347	MACS_peak_17218	140.77	293	0	1	0
6	5379707	5379965	MACS_peak_17219	468.72	258	0	1	0
6	5398526	5398759	MACS_peak_17220	532.66	233	0	1	0
6	5402239	5402704	MACS_peak_17221	701.99	465	0	1	0
6	5422408	5422606	MACS_peak_17222	831.63	198	0	1	0
6	5471057	5471235	MACS_peak_17223	659.6	178	0	1	0
6	5527988	5528214	MACS_peak_17224	1025.76	226	0	1	0
6	7275976	7276189	MACS_peak_17236	451.43	213	0	1	0
6	7947095	7947450	MACS_peak_17238	189.55	355	0	1	0
6	10813040	10813328	MACS_peak_17255	229.83	288	0	3	0
6	11575546	11575876	MACS_peak_17262	796.13	330	0	1	0
6	31772914	31773134	MACS_peak_17382	413.13	220	1	1	0
6	31795913	31796140	MACS_peak_17383	548.55	227	1	0	0
6	31989450	31989679	MACS_peak_17384	635.07	229	0	1	0
6	32022188	32022417	MACS_peak_17385	635.07	229	0	1	0
6	33391173	33391547	MACS_peak_17392	1022.03	374	1	0	0
6	34843438	34843817	MACS_peak_17396	682.47	379	0	1	0
6	35279407	35279577	MACS_peak_17398	729.92	170	0	1	1
6	35342308	35342498	MACS_peak_17400	474.18	190	1	0	0
6	35415304	35415674	MACS_peak_17401	380.3	370	0	1	0
6	36123904	36124120	MACS_peak_17407	944.23	216	1	0	0
6	41921337	41921581	MACS_peak_17436	525.6	244	1	0	0
6	42580892	42581024	MACS_peak_17437	797.63	132	0	1	0
6	42845075	42845245	MACS_peak_17439	1268.27	170	0	1	0
6	44151964	44152271	MACS_peak_17443	438.71	307	0	1	0
6	44418907	44419235	MACS_peak_17445	75.01	328	0	1	0
6	46142257	46142476	MACS_peak_17454	580.62	219	0	1	0
6	52263839	52264023	MACS_peak_17504	729.14	184	1	0	0
6	53093928	53094234	MACS_peak_17506	816.97	306	0	1	0
6	75262751	75262939	MACS_peak_17671	695.57	188	0	1	0
6	75266596	75267033	MACS_peak_17672	486.55	437	0	1	0
6	75658881	75659103	MACS_peak_17673	555.12	222	0	1	0
6	75660217	75660401	MACS_peak_17674	729.14	184	0	1	0
6	75687619	75687893	MACS_peak_17675	233.74	274	0	1	0
6	75747205	75747342	MACS_peak_17676	914.41	137	1	0	0
6	75855124	75855303	MACS_peak_17677	954.29	179	0	1	0
6	75902888	75903199	MACS_peak_17678	75.63	311	0	1	0
6	75924396	75924859	MACS_peak_17679	1207.96	463	1	0	0
6	75934994	75935226	MACS_peak_17680	514.21	232	0	1	0
6	82178176	82178430	MACS_peak_17732	1171.45	254	0	1	0
6	84179348	84179682	MACS_peak_17744	60.1	334	0	1	0
6	85536014	85536238	MACS_peak_17761	413.13	224	0	1	0
6	85537128	85537381	MACS_peak_17762	1025.76	253	0	1	0
6	87443077	87443335	MACS_peak_17781	595.17	258	0	2	0
6	87673043	87673183	MACS_peak_17782	431.68	140	1	0	0
6	88899531	88899887	MACS_peak_17792	413.31	356	0	1	0
6	88948921	88949193	MACS_peak_17793	166.08	272	0	1	0
6	89729540	89729700	MACS_peak_17798	1098.16	160	0	1	0
6	89796315	89796677	MACS_peak_17799	216.96	362	0	1	0
6	98866667	98866986	MACS_peak_17841	73.94	319	1	0	0
6	99434987	99435265	MACS_peak_17848	579.67	278	1	0	0
6	99451566	99451932	MACS_peak_17849	61.12	366	0	1	0
6	100524005	100524231	MACS_peak_17861	695.57	226	0	1	0
6	100585966	100586271	MACS_peak_17862	222.27	305	0	1	0
6	100608556	100608796	MACS_peak_17863	516.86	240	0	1	0
6	100657820	100658003	MACS_peak_17864	843.77	183	0	1	0
6	100664267	100664593	MACS_peak_17865	546.72	326	0	1	0
6	100678126	100678386	MACS_peak_17866	862.05	260	0	1	0
6	104771309	104771618	MACS_peak_17890	1230.02	309	0	1	0
6	107887092	107887484	MACS_peak_17900	67.84	392	0	1	0
6	108388274	108388607	MACS_peak_17902	86.65	333	0	1	0
6	108515764	108516085	MACS_peak_17903	116.18	321	0	1	0
6	109538435	109538711	MACS_peak_17906	50.69	276	0	1	0
6	109595878	109596147	MACS_peak_17907	183.15	269	0	1	0
6	109598884	109599300	MACS_peak_17908	72.76	416	0	1	0
6	109649949	109650342	MACS_peak_17909	94.57	393	0	1	0
6	109705196	109705464	MACS_peak_17910	587.27	268	0	1	0
6	110145199	110145487	MACS_peak_17915	58.9	288	0	1	0
6	110806226	110806392	MACS_peak_17918	869.22	166	0	1	0
6	110991281	110991440	MACS_peak_17920	781.6	159	0	1	0
6	111300460	111300721	MACS_peak_17922	724.45	261	1	0	0
6	112095457	112095756	MACS_peak_17925	312.33	299	0	1	0
6	112163376	112163658	MACS_peak_17926	453.35	282	0	1	1
6	113936185	113936404	MACS_peak_17937	1785.17	219	1	0	0
6	113994913	113995190	MACS_peak_17938	983.22	277	0	1	1
6	125114213	125114590	MACS_peak_18009	1433.99	377	1	0	0
6	125153560	125153789	MACS_peak_18010	695.57	229	0	1	0
6	125974362	125974719	MACS_peak_18015	1458.45	357	0	1	0
6	130282339	130282541	MACS_peak_18042	814.37	202	0	1	0
6	130308145	130308508	MACS_peak_18043	644.81	363	0	1	0
6	130322762	130322993	MACS_peak_18044	678.9	231	0	1	0
6	130348727	130348924	MACS_peak_18045	122.27	197	0	1	0
6	142146938	142147234	MACS_peak_18128	445	296	1	0	0
6	142188450	142188622	MACS_peak_18129	690.17	172	0	1	0
6	145503236	145503549	MACS_peak_18141	67.1	313	0	1	0
6	145666286	145666685	MACS_peak_18142	68.17	399	0	1	0
6	145679846	145680116	MACS_peak_18143	758.81	270	0	1	0
6	145704255	145704490	MACS_peak_18144	1201.14	235	0	1	0
6	149680632	149680764	MACS_peak_18159	1116.4	132	0	1	0
6	149723852	149724121	MACS_peak_18160	842.54	269	1	0	0
6	151363978	151364257	MACS_peak_18167	312.33	279	1	0	0
6	151406047	151406400	MACS_peak_18168	651.52	353	1	0	0
6	151568650	151568910	MACS_peak_18169	406.81	260	0	1	0
6	154805389	154805659	MACS_peak_18192	697.55	270	0	1	0
6	157045983	157046201	MACS_peak_18200	580.62	218	0	1	0
6	157993706	157993935	MACS_peak_18202	712.57	229	0	1	0
6	158444142	158444357	MACS_peak_18204	681.39	215	0	1	0
6	158972563	158972814	MACS_peak_18207	613.04	251	1	0	0
6	160100627	160100895	MACS_peak_18210	2187.09	268	0	1	0
6	167045907	167046178	MACS_peak_18232	584.96	271	0	1	1
6	169644935	169645133	MACS_peak_18241	451.06	198	0	2	0
6	170575144	170575523	MACS_peak_18245	634.44	379	1	0	0
7	873315	873606	MACS_peak_18262	447.93	291	1	1	0
7	944080	944486	MACS_peak_18263	485.8	406	0	2	0
7	1135857	1136239	MACS_peak_18264	401.26	382	0	1	0
7	1996063	1996381	MACS_peak_18274	432.66	318	0	1	0
7	2247250	2247478	MACS_peak_18275	848.95	228	1	1	0
7	2364908	2365161	MACS_peak_18277	409.01	253	0	1	0
7	2367720	2367866	MACS_peak_18278	1170.45	146	0	1	0
7	2578880	2579059	MACS_peak_18279	898.14	179	0	1	0
7	2748427	2748757	MACS_peak_18281	78.78	330	0	2	0
7	5486976	5487240	MACS_peak_18305	464.74	264	0	1	0
7	5494654	5494906	MACS_peak_18306	746.04	252	0	1	0
7	5665459	5665694	MACS_peak_18308	440.38	235	0	1	1
7	5704499	5704730	MACS_peak_18309	678.9	231	0	1	0
7	5747681	5747881	MACS_peak_18310	1075.85	200	0	1	0
7	5997256	5997542	MACS_peak_18312	357.56	286	0	1	0
7	6007521	6007768	MACS_peak_18313	482.84	247	1	1	0
7	6149472	6149619	MACS_peak_18314	972.07	147	0	1	0
7	6435640	6435918	MACS_peak_18318	627.32	278	0	1	0
7	6455211	6455352	MACS_peak_18319	816.83	141	0	2	0
7	7424409	7424640	MACS_peak_18333	989.9	231	0	1	0
7	7595386	7595854	MACS_peak_18334	784.97	468	0	1	0
7	7678394	7678854	MACS_peak_18335	978.69	460	0	2	1
7	7680595	7680985	MACS_peak_18337	567.67	390	0	2	1
7	17803878	17804097	MACS_peak_18409	580.62	219	0	1	0
7	23185023	23185363	MACS_peak_18444	660.56	340	1	0	0
7	26198187	26198551	MACS_peak_18468	409.51	364	1	1	0
7	27143716	27144005	MACS_peak_18473	449.12	289	2	1	2
7	27150844	27151115	MACS_peak_18474	850.57	271	1	1	3
7	27743674	27743819	MACS_peak_18477	1265.84	145	1	0	0
7	30625403	30625685	MACS_peak_18488	576.71	282	0	1	0
7	32490812	32491268	MACS_peak_18512	477.87	456	1	1	0
7	32579261	32579648	MACS_peak_18513	1198.74	387	0	1	0
7	33170357	33170574	MACS_peak_18522	154.43	217	0	1	0
7	33228110	33228386	MACS_peak_18523	429.01	276	0	1	0
7	33243369	33243643	MACS_peak_18524	1275.79	274	0	1	0
7	33379381	33379583	MACS_peak_18525	611.83	202	0	1	0
7	33411006	33411142	MACS_peak_18526	1586.65	136	0	1	0
7	33459590	33459941	MACS_peak_18527	415.73	351	0	1	0
7	33519730	33520008	MACS_peak_18528	335.61	278	0	1	0
7	44469008	44469256	MACS_peak_18593	763.02	248	0	1	0
7	64334046	64334403	MACS_peak_18785	219.12	357	0	1	0
7	64697061	64697414	MACS_peak_18786	63.13	353	0	1	0
7	66950211	66950343	MACS_peak_18802	1028.85	132	0	1	0
7	67000765	67000996	MACS_peak_18803	532.66	231	0	1	0
7	67040836	67041254	MACS_peak_18804	495.64	418	0	1	0
7	67176765	67176941	MACS_peak_18805	763.02	176	0	1	0
7	72168341	72168586	MACS_peak_18818	487.14	245	0	1	0
7	72915100	72915338	MACS_peak_18823	481.5	238	0	1	0
7	73463148	73463482	MACS_peak_18825	488.44	334	0	1	0
7	74067748	74068114	MACS_peak_18829	296.93	366	0	1	0
7	75452459	75452741	MACS_peak_18839	639.14	282	0	1	0
7	75467505	75467669	MACS_peak_18840	785.52	164	0	1	0
7	75866439	75866770	MACS_peak_18845	543.58	331	0	1	0
7	75931231	75931457	MACS_peak_18846	548.55	226	0	1	0
7	77759316	77759664	MACS_peak_18861	533.26	348	0	1	0
7	77815263	77815535	MACS_peak_18862	695.76	272	0	1	0
7	80453798	80454064	MACS_peak_18878	719.85	266	1	1	0
7	80576083	80576329	MACS_peak_18879	448.91	246	0	1	0
7	80659559	80659776	MACS_peak_18880	746.04	217	0	1	0
7	80667325	80667668	MACS_peak_18881	751.13	343	0	1	0
7	87178386	87178627	MACS_peak_18942	501.16	241	0	1	0
7	90412988	90413261	MACS_peak_18968	583.44	273	0	1	1
7	90427857	90428194	MACS_peak_18969	486.61	337	0	1	1
7	91756801	91757119	MACS_peak_18982	372.13	318	0	1	0
7	91761925	91762250	MACS_peak_18983	62.38	325	0	1	0
7	91792474	91792669	MACS_peak_18984	124.81	195	0	1	0
7	91830141	91830398	MACS_peak_18985	709.49	257	0	1	0
7	91876744	91877054	MACS_peak_18986	557.12	310	0	1	0
7	92217651	92217931	MACS_peak_18990	707.43	280	0	2	0
7	92447186	92447500	MACS_peak_18992	603.02	314	1	0	1
7	92449875	92450080	MACS_peak_18993	972.07	205	1	0	0
7	94395497	94395767	MACS_peak_19014	716.24	270	1	0	0
7	96631932	96632273	MACS_peak_19034	194.53	341	0	1	0
7	96678366	96678642	MACS_peak_19035	557.06	276	0	1	0
7	96704015	96704256	MACS_peak_19036	646.51	241	0	1	0
7	98106497	98106820	MACS_peak_19053	1356.87	323	1	0	0
7	98145696	98146014	MACS_peak_19054	551.85	318	0	1	0
7	99365579	99365850	MACS_peak_19065	460.22	271	0	2	0
7	99415594	99416012	MACS_peak_19066	731.14	418	2	1	0
7	99913154	99913422	MACS_peak_19070	718.04	268	0	1	0
7	100081830	100082142	MACS_peak_19074	790.3	312	0	1	0
7	100217123	100217417	MACS_peak_19076	645.79	294	1	2	0
7	100217896	100218289	MACS_peak_19077	747.46	393	1	2	0
7	100469270	100469638	MACS_peak_19080	363.56	368	0	1	0
7	101309870	101310071	MACS_peak_19086	777.44	201	1	0	1
7	102390833	102391126	MACS_peak_19096	673.02	293	0	1	0
7	102537191	102537452	MACS_peak_19099	507.36	261	3	1	0
7	102539368	102539591	MACS_peak_19100	1589.86	223	3	1	0
7	102544052	102544256	MACS_peak_19101	334.37	204	1	1	0
7	102551642	102551965	MACS_peak_19102	773.07	323	1	2	0
7	102758203	102758517	MACS_peak_19114	473.97	314	0	1	0
7	102782048	102782461	MACS_peak_19115	139.27	413	0	1	0
7	104156771	104157114	MACS_peak_19122	411.54	343	0	1	0
7	105066961	105067101	MACS_peak_19135	876.68	140	0	1	0
7	105260227	105260591	MACS_peak_19136	82.74	364	0	1	0
7	105362053	105362323	MACS_peak_19137	127.5	270	0	1	0
7	107320074	107320316	MACS_peak_19153	780.06	242	0	1	0
7	107351080	107351426	MACS_peak_19154	114.74	346	0	1	0
7	107479527	107479832	MACS_peak_19155	1236.43	305	0	1	0
7	107501706	107501919	MACS_peak_19156	763.02	213	0	1	0
7	107509872	107510197	MACS_peak_19157	149.64	325	0	1	0
7	107510863	107511207	MACS_peak_19158	84.4	344	0	1	0
7	107545778	107545910	MACS_peak_19159	1090.31	132	0	1	0
7	107598909	107599358	MACS_peak_19160	506.92	449	0	1	0
7	107751362	107751562	MACS_peak_19165	1212.73	200	0	1	0
7	116376478	116376803	MACS_peak_19230	76.15	325	0	1	1
7	116409358	116409554	MACS_peak_19231	217.56	196	0	1	1
7	116526150	116526331	MACS_peak_19232	746.04	181	1	0	0
7	116900576	116900842	MACS_peak_19235	719.85	266	0	1	0
7	120799525	120799898	MACS_peak_19261	619.75	373	0	1	0
7	123537099	123537380	MACS_peak_19285	577.45	281	1	0	0
7	123540999	123541234	MACS_peak_19286	516.86	235	1	0	0
7	124856338	124856659	MACS_peak_19300	431.05	321	0	1	0
7	128293696	128293971	MACS_peak_19317	73.29	275	1	0	0
7	128474295	128474608	MACS_peak_19321	1102.85	313	1	0	1
7	130037814	130038042	MACS_peak_19336	577.34	228	0	1	0
7	131192227	131192508	MACS_peak_19344	1414.71	281	0	1	0
7	132986067	132986323	MACS_peak_19351	242.71	256	0	1	0
7	133854715	133855146	MACS_peak_19353	1103.83	431	0	1	0
7	133990976	133991212	MACS_peak_19354	814.37	236	0	1	0
7	139151259	139151547	MACS_peak_19391	416.97	288	0	1	0
7	139184845	139185068	MACS_peak_19392	513.05	223	0	1	0
7	139399337	139399485	MACS_peak_19395	686.78	148	0	2	0
7	140712111	140712390	MACS_peak_19400	52.99	279	0	1	0
7	141650031	141650272	MACS_peak_19405	797.18	241	0	1	0
7	149149166	149149421	MACS_peak_19466	580.75	255	0	1	0
7	151754173	151754375	MACS_peak_19482	814.37	202	0	1	0
7	151844530	151844712	MACS_peak_19483	729.14	182	0	1	0
7	152208255	152208452	MACS_peak_19486	1065.23	197	0	1	0
7	152336821	152337059	MACS_peak_19487	516.86	238	0	1	0
7	156719910	156720217	MACS_peak_19506	96.97	307	0	1	0
7	156778251	156778573	MACS_peak_19507	673.67	322	0	1	0
7	156827581	156827962	MACS_peak_19508	514.63	381	0	1	0
7	156949573	156949762	MACS_peak_19510	695.57	189	1	0	0
7	157250664	157251046	MACS_peak_19511	755.85	382	0	1	0
7	158885737	158886009	MACS_peak_19518	423.73	272	0	1	0
8	9736458	9736716	MACS_peak_19575	76.3	258	0	1	0
8	9760566	9760897	MACS_peak_19576	381.49	331	0	1	0
8	11314593	11314800	MACS_peak_19579	596.67	207	0	1	0
8	11765529	11765736	MACS_peak_19580	603.96	207	1	0	0
8	18002371	18002681	MACS_peak_19614	100.2	310	0	1	0
8	18002731	18003017	MACS_peak_19615	124.29	286	0	1	0
8	19346439	19346761	MACS_peak_19623	673.67	322	0	1	0
8	19372120	19372354	MACS_peak_19624	662.31	234	0	1	0
8	22422594	22422929	MACS_peak_19638	565.1	335	0	1	0
8	22489475	22489820	MACS_peak_19639	783.88	345	0	1	0
8	22561894	22562090	MACS_peak_19640	662.31	196	0	1	0
8	22574497	22574756	MACS_peak_19641	726.32	259	1	1	0
8	25281631	25281911	MACS_peak_19655	578.19	280	0	1	0
8	26499288	26499562	MACS_peak_19663	458.32	274	0	1	0
8	26571298	26571497	MACS_peak_19664	831.63	199	0	1	0
8	27426232	27426506	MACS_peak_19670	458.32	274	0	1	0
8	27597216	27597497	MACS_peak_19672	577.45	281	1	0	0
8	28619017	28619398	MACS_peak_19674	199.17	381	0	1	0
8	28839699	28840042	MACS_peak_19675	51.97	343	0	1	0
8	29004383	29004649	MACS_peak_19676	463.44	266	0	1	0
8	33495597	33495737	MACS_peak_19688	1111.4	140	0	2	0
8	41581568	41581918	MACS_peak_19716	171.16	350	1	0	0
8	47917376	47917620	MACS_peak_19776	635.03	244	0	1	0
8	52622275	52622584	MACS_peak_19801	437.6	309	1	0	0
8	52698585	52698725	MACS_peak_19802	791.44	140	0	1	0
8	52737149	52737411	MACS_peak_19803	466.05	262	0	1	0
8	53808837	53809086	MACS_peak_19812	901.33	249	0	1	0
8	54010450	54010732	MACS_peak_19813	576.71	282	0	1	0
8	56970738	56971065	MACS_peak_19836	427.87	327	0	1	0
8	60546788	60547146	MACS_peak_19854	172.39	358	0	1	0
8	60617215	60617394	MACS_peak_19855	954.29	179	0	1	0
8	66577124	66577414	MACS_peak_19894	64.51	290	0	1	0
8	66579017	66579362	MACS_peak_19895	118.46	345	0	1	0
8	70113676	70113890	MACS_peak_19915	596.79	214	1	0	0
8	70114778	70115020	MACS_peak_19916	402.63	242	0	1	0
8	73037588	73037868	MACS_peak_19935	1267.54	280	0	1	0
8	73467901	73468265	MACS_peak_19941	82.74	364	0	1	0
8	73687130	73687452	MACS_peak_19942	386.17	322	1	1	1
8	79986663	79986924	MACS_peak_19992	66.48	261	0	2	0
8	80006593	80006839	MACS_peak_19993	84.34	246	0	2	0
8	80008070	80008484	MACS_peak_19994	94.8	414	0	2	0
8	80023542	80023957	MACS_peak_19995	959.75	415	0	2	0
8	80067229	80067446	MACS_peak_19996	1805.04	217	0	2	0
8	80085092	80085334	MACS_peak_19997	501.16	242	0	1	0
8	80118458	80118650	MACS_peak_19998	884.92	192	0	1	0
8	86514197	86514392	MACS_peak_20065	640.49	195	1	0	0
8	86558158	86558534	MACS_peak_20066	349.84	376	1	1	0
8	89954528	89954666	MACS_peak_20125	989.14	138	0	1	0
8	89984027	89984395	MACS_peak_20126	766.12	368	0	1	0
8	89984641	89984993	MACS_peak_20127	415.24	352	0	1	0
8	89994275	89994632	MACS_peak_20128	774.47	357	0	1	0
8	89994702	89994936	MACS_peak_20129	532.66	234	0	1	0
8	90000587	90001027	MACS_peak_20130	646.41	440	1	1	0
8	95137190	95137403	MACS_peak_20191	596.79	213	1	0	0
8	96695153	96695493	MACS_peak_20203	78.43	340	0	1	0
8	96695891	96696208	MACS_peak_20204	54.21	317	0	1	0
8	96777892	96778246	MACS_peak_20205	492.82	354	0	1	0
8	96856647	96856867	MACS_peak_20206	564.54	220	0	1	0
8	96964088	96964464	MACS_peak_20207	505.64	376	0	1	0
8	96988100	96988368	MACS_peak_20208	506.92	268	0	1	0
8	97142239	97142506	MACS_peak_20210	534.37	267	0	1	0
8	97145333	97145587	MACS_peak_20211	453.3	254	0	1	0
8	102407757	102407999	MACS_peak_20287	518.84	242	0	1	0
8	103046814	103047047	MACS_peak_20295	1094.86	233	0	1	0
8	109261577	109261818	MACS_peak_20392	729.92	241	0	1	0
8	109282190	109282567	MACS_peak_20393	759.47	377	0	1	0
8	109325957	109326173	MACS_peak_20395	712.64	216	0	1	0
8	109552035	109552310	MACS_peak_20399	717.3	275	0	1	0
8	109561684	109561974	MACS_peak_20400	1704.82	290	0	1	0
8	116766127	116766460	MACS_peak_20464	424.75	333	1	1	0
8	120063747	120063996	MACS_peak_20493	763.02	249	1	0	0
8	120084660	120084870	MACS_peak_20494	780.06	210	0	1	0
8	120118688	120119150	MACS_peak_20495	640.09	462	0	1	0
8	120123512	120123771	MACS_peak_20496	1297.26	259	0	1	0
8	120218054	120218322	MACS_peak_20497	587.27	268	0	1	0
8	120350320	120350664	MACS_peak_20498	96.73	344	0	1	0
8	120388666	120388905	MACS_peak_20499	516.86	239	0	1	0
8	120421502	120421981	MACS_peak_20500	1193.97	479	0	1	0
8	120452820	120453180	MACS_peak_20501	1671.3	360	0	1	0
8	123804393	123804600	MACS_peak_20559	585.19	207	0	1	0
8	125129862	125130137	MACS_peak_20575	2344.71	275	0	1	0
8	125148393	125148591	MACS_peak_20576	509.17	198	0	1	0
8	125215206	125215475	MACS_peak_20577	50.92	269	0	1	0
8	125230676	125230961	MACS_peak_20578	784.02	285	0	1	0
8	125432094	125432346	MACS_peak_20580	1025.76	252	1	0	0
8	132600573	132600850	MACS_peak_20650	75.37	277	0	1	0
8	132789617	132790009	MACS_peak_20651	626.35	392	0	1	0
8	132819880	132820094	MACS_peak_20652	596.79	214	0	1	0
8	140099283	140099487	MACS_peak_20687	629.38	204	0	1	1
8	140338737	140339183	MACS_peak_20688	406.81	446	0	1	0
8	140393807	140394185	MACS_peak_20689	516.25	378	0	1	0
8	140432060	140432298	MACS_peak_20690	662.31	238	0	1	0
8	140595696	140596024	MACS_peak_20691	427.34	328	0	1	0
8	140668327	140668546	MACS_peak_20692	580.62	219	0	1	0
8	140977873	140978301	MACS_peak_20693	81.72	428	0	1	0
8	142255518	142255802	MACS_peak_20703	358.74	284	0	1	0
8	142726874	142727240	MACS_peak_20706	408.57	366	1	0	0
8	143314757	143315090	MACS_peak_20715	634.13	333	0	1	0
8	143748611	143748918	MACS_peak_20717	685.18	307	0	1	0
8	143749173	143749478	MACS_peak_20718	439.84	305	0	1	0
8	143836495	143836696	MACS_peak_20719	814.37	201	1	0	0
8	144234269	144234635	MACS_peak_20721	306.6	366	0	1	0
8	144443956	144444246	MACS_peak_20722	448.52	290	0	1	0
8	144509755	144510062	MACS_peak_20723	438.71	307	2	0	0
8	144567128	144567476	MACS_peak_20724	603.06	348	0	1	0
8	144730226	144730594	MACS_peak_20725	505.54	368	0	1	0
8	144805143	144805330	MACS_peak_20726	453.36	187	0	1	0
9	2060118	2060260	MACS_peak_20748	1067.21	142	0	1	0
9	2728151	2728356	MACS_peak_20749	629.38	205	0	2	0
9	5080622	5080886	MACS_peak_20765	395.93	264	0	1	0
9	5679914	5680257	MACS_peak_20769	68.83	343	0	1	0
9	5799216	5799480	MACS_peak_20770	590.39	264	0	1	0
9	5963272	5963633	MACS_peak_20771	102.67	361	0	1	0
9	6488248	6488398	MACS_peak_20774	853.84	150	0	1	0
9	6907725	6908068	MACS_peak_20776	536.24	343	0	1	1
9	21813969	21814214	MACS_peak_20844	780.06	245	0	2	0
9	27224830	27225145	MACS_peak_20870	158.81	315	0	1	0
9	32968442	32968690	MACS_peak_20903	485.56	248	1	0	0
9	33111144	33111285	MACS_peak_20905	1025.76	141	0	1	0
9	33886046	33886267	MACS_peak_20909	482.68	221	0	1	0
9	33886640	33886779	MACS_peak_20910	902.92	139	0	1	0
9	33995349	33995721	MACS_peak_20911	638.92	372	0	1	0
9	34176278	34176506	MACS_peak_20912	541.5	228	1	0	0
9	36257463	36257928	MACS_peak_20922	109.53	465	0	2	0
9	36270403	36270535	MACS_peak_20923	857.98	132	0	2	0
9	37808432	37808830	MACS_peak_20930	619.03	398	0	2	0
9	65710542	65710814	MACS_peak_21107	59.86	272	0	1	0
9	75077261	75077458	MACS_peak_21154	662.31	197	0	1	0
9	77215970	77216392	MACS_peak_21167	493.69	422	0	1	0
9	77759944	77760108	MACS_peak_21172	946.88	164	0	1	0
9	77827895	77828198	MACS_peak_21173	534.92	303	0	1	0
9	86287084	86287404	MACS_peak_21230	431.58	320	1	0	0
9	88548046	88548464	MACS_peak_21247	482.54	418	0	1	0
9	88578512	88578808	MACS_peak_21248	693.99	296	0	1	0
9	93109190	93109477	MACS_peak_21277	437.02	287	0	1	0
9	97598798	97599062	MACS_peak_21317	464.74	264	1	1	0
9	99224449	99224662	MACS_peak_21330	914.46	213	1	0	0
9	99947423	99947651	MACS_peak_21334	522.21	228	0	1	0
9	100222761	100223032	MACS_peak_21336	715.34	271	0	1	0
9	100323036	100323257	MACS_peak_21337	729.14	221	0	1	0
9	101530113	101530495	MACS_peak_21349	401.26	382	1	1	0
9	101549614	101549967	MACS_peak_21350	673.34	353	0	1	0
9	107287829	107287962	MACS_peak_21401	1176.51	133	1	0	0
9	107307954	107308240	MACS_peak_21402	518.15	286	0	1	0
9	112711160	112711417	MACS_peak_21459	424.66	257	0	1	0
9	113182066	113182288	MACS_peak_21464	712.32	222	0	1	0
9	113274381	113274806	MACS_peak_21465	492.24	425	1	1	0
9	113285239	113285397	MACS_peak_21466	540.72	158	0	1	0
9	121213292	121213719	MACS_peak_21526	976.47	427	0	2	0
9	121222469	121222730	MACS_peak_21527	705.75	261	0	2	0
9	122809434	122809661	MACS_peak_21548	709.61	227	0	1	0
9	124410353	124410626	MACS_peak_21561	529.8	273	0	1	0
9	125011482	125011895	MACS_peak_21566	90.87	413	0	1	0
9	125089378	125089565	MACS_peak_21567	646.78	187	0	1	0
9	125143716	125144080	MACS_peak_21568	524.01	364	1	0	0
9	126860250	126860526	MACS_peak_21584	581.17	276	1	0	0
9	127786876	127787199	MACS_peak_21591	429.98	323	1	0	0
9	128117661	128117997	MACS_peak_21596	1058.97	336	1	0	1
9	128255286	128255544	MACS_peak_21599	1005.37	258	1	0	0
9	128733175	128733545	MACS_peak_21603	496.77	370	1	0	0
9	128818222	128818499	MACS_peak_21605	610.43	277	2	0	0
9	129139130	129139476	MACS_peak_21609	783.08	346	0	1	0
9	129142896	129143253	MACS_peak_21610	412.83	357	0	1	0
9	129611089	129611307	MACS_peak_21613	580.62	218	2	0	0
9	129617253	129617606	MACS_peak_21614	530.32	353	0	2	0
9	129804836	129804968	MACS_peak_21616	771.26	132	1	0	0
9	130099734	130100016	MACS_peak_21620	142.05	282	0	1	0
9	130107209	130107427	MACS_peak_21621	580.62	218	0	1	0
9	130770970	130771235	MACS_peak_21625	488.85	265	0	1	0
9	130866451	130866798	MACS_peak_21626	655.65	347	0	1	0
9	130870033	130870370	MACS_peak_21627	845.32	337	0	1	0
9	131178373	131178681	MACS_peak_21629	1339.28	308	0	1	0
9	131404105	131404238	MACS_peak_21633	1201.31	133	0	1	0
9	131954379	131954621	MACS_peak_21636	1725.79	242	0	1	0
9	132259233	132259425	MACS_peak_21638	619.53	192	1	0	0
9	132312972	132313221	MACS_peak_21639	763.02	249	0	1	0
9	132651275	132651528	MACS_peak_21640	596.79	253	0	1	0
9	132653236	132653622	MACS_peak_21641	219.32	386	0	1	0
9	132673456	132673661	MACS_peak_21642	608.4	205	1	0	0
9	132768949	132769090	MACS_peak_21643	1025.76	141	0	1	0
9	132800249	132800499	MACS_peak_21644	613.04	250	0	1	0
9	133044042	133044316	MACS_peak_21646	582.68	274	0	1	0
9	133329505	133329725	MACS_peak_21650	1365.09	220	1	0	0
9	133403909	133404181	MACS_peak_21651	849.55	272	1	1	0
9	134698528	134698858	MACS_peak_21660	1065.19	330	0	1	0
9	135500500	135500723	MACS_peak_21663	564.54	223	1	1	0
9	135504637	135504888	MACS_peak_21664	485.56	251	1	0	1
9	135864412	135864747	MACS_peak_21667	423.72	335	0	1	0
9	136791813	136792079	MACS_peak_21671	603.02	266	3	0	0
9	137064156	137064386	MACS_peak_21673	675.38	230	1	0	1
9	137227578	137227801	MACS_peak_21676	712.32	223	3	0	0
9	137262181	137262533	MACS_peak_21678	1207.14	352	0	1	0
9	137559138	137559490	MACS_peak_21684	1402.87	352	1	0	0
10	178212	178666	MACS_peak_1906	591.23	454	0	1	0
10	230883	231132	MACS_peak_1907	471.88	249	0	1	0
10	810565	810800	MACS_peak_1911	662.31	235	1	0	0
10	1050853	1051121	MACS_peak_1912	488.85	268	1	0	0
10	6088653	6089055	MACS_peak_1949	1855.58	402	1	0	0
10	12111036	12111382	MACS_peak_1996	418.18	346	0	1	0
10	12214568	12214946	MACS_peak_1997	516.25	378	0	1	0
10	13171761	13171893	MACS_peak_2011	1116.4	132	0	1	0
10	13206591	13206959	MACS_peak_2012	950.42	368	0	1	0
10	13586686	13586992	MACS_peak_2018	559.8	306	1	0	0
10	13613430	13613850	MACS_peak_2019	506.92	420	1	1	0
10	14904175	14904350	MACS_peak_2025	341.55	175	0	1	0
10	15106483	15106715	MACS_peak_2028	678.9	232	1	1	0
10	18630374	18630754	MACS_peak_2054	74.78	380	0	1	0
10	18630768	18631100	MACS_peak_2055	156.26	332	0	1	0
10	18632877	18633190	MACS_peak_2056	189.21	313	0	1	0
10	19089887	19090200	MACS_peak_2060	78.93	313	0	1	0
10	19090515	19090773	MACS_peak_2061	84.98	258	0	1	0
10	19204331	19204649	MACS_peak_2062	339.76	318	0	1	0
10	19320035	19320169	MACS_peak_2065	1098.16	134	0	1	0
10	19348585	19348810	MACS_peak_2066	346.64	225	0	1	0
10	19609095	19609451	MACS_peak_2067	1316.54	356	0	1	0
10	19684124	19684317	MACS_peak_2068	661.2	193	0	1	0
10	19788217	19788473	MACS_peak_2069	729.14	256	0	1	0
10	19811570	19811883	MACS_peak_2070	422.13	313	1	0	0
10	21781569	21781828	MACS_peak_2089	158.29	259	0	1	0
10	21782523	21782890	MACS_peak_2090	169.77	367	0	1	0
10	21839338	21839628	MACS_peak_2091	104.63	290	0	1	0
10	21907939	21908315	MACS_peak_2092	721.05	376	0	1	0
10	21953498	21953980	MACS_peak_2093	950.42	482	0	1	0
10	21993414	21993653	MACS_peak_2094	797.18	239	0	1	0
10	27046903	27047164	MACS_peak_2135	661.73	261	0	1	0
10	35269387	35269854	MACS_peak_2196	349.84	467	0	1	0
10	35563255	35563562	MACS_peak_2198	816.07	307	0	1	0
10	45539985	45540228	MACS_peak_2378	100.65	243	0	1	0
10	45667234	45667579	MACS_peak_2379	272.37	345	0	1	0
10	46586810	46587014	MACS_peak_2386	797.18	204	0	1	1
10	47460470	47460695	MACS_peak_2395	844.95	225	1	0	0
10	49519119	49519375	MACS_peak_2414	470.06	256	0	1	0
10	49890077	49890301	MACS_peak_2417	564.54	224	0	1	0
10	58216477	58216721	MACS_peak_2482	629.38	244	0	1	0
10	62603564	62603882	MACS_peak_2504	96.1	318	0	2	1
10	63387525	63387730	MACS_peak_2509	321.35	205	0	1	0
10	63446599	63446807	MACS_peak_2510	1108.27	208	0	1	0
10	69289356	69289500	MACS_peak_2556	649.84	144	0	1	0
10	69310419	69310552	MACS_peak_2557	1396.21	133	0	1	0
10	73149979	73150342	MACS_peak_2569	146.63	363	0	1	0
10	74458016	74458322	MACS_peak_2573	623.5	306	0	1	0
10	74570949	74571203	MACS_peak_2574	58.33	254	0	1	0
10	75120279	75120645	MACS_peak_2576	158.81	366	0	1	0
10	75230610	75230857	MACS_peak_2579	471.88	247	1	1	0
10	75235930	75236242	MACS_peak_2580	555.79	312	1	0	0
10	77995270	77995711	MACS_peak_2596	91.01	441	0	1	0
10	78047225	78047658	MACS_peak_2597	602.54	433	0	1	0
10	87081641	87081904	MACS_peak_2667	243.49	263	0	1	0
10	87149180	87149376	MACS_peak_2668	1193.18	196	0	1	0
10	87967122	87967375	MACS_peak_2675	470.06	253	0	1	0
10	88987046	88987336	MACS_peak_2681	448.52	290	1	1	0
10	89764581	89764855	MACS_peak_2686	210.33	274	0	1	0
10	90880140	90880379	MACS_peak_2693	645.81	239	0	1	0
10	92303370	92303635	MACS_peak_2709	406.81	265	0	1	0
10	92524230	92524608	MACS_peak_2710	2991.26	378	0	1	0
10	93916606	93916917	MACS_peak_2722	682.05	311	0	1	0
10	94162339	94162665	MACS_peak_2723	84.24	326	0	1	0
10	94163496	94163748	MACS_peak_2724	124.29	252	0	1	0
10	94320348	94320542	MACS_peak_2725	631.23	194	0	1	0
10	97407184	97407438	MACS_peak_2747	470.06	254	0	1	1
10	98228944	98229277	MACS_peak_2751	76.3	333	0	1	0
10	98230175	98230491	MACS_peak_2752	63.99	316	0	1	0
10	100240862	100241024	MACS_peak_2773	1079.97	162	0	1	0
10	100518824	100519027	MACS_peak_2775	989.9	203	1	2	0
10	100994358	100994537	MACS_peak_2778	746.04	179	1	0	0
10	101012867	101013271	MACS_peak_2779	1232.32	404	0	1	0
10	101034344	101034638	MACS_peak_2780	380.3	294	1	0	0
10	102009938	102010164	MACS_peak_2786	1189.9	226	0	1	0
10	102399527	102399809	MACS_peak_2788	839.55	282	1	1	0
10	102479041	102479299	MACS_peak_2789	468.72	258	0	1	0
10	102596500	102596858	MACS_peak_2790	648.14	358	0	1	0
10	104017126	104017388	MACS_peak_2797	466.05	262	0	1	0
10	109884321	109884572	MACS_peak_2840	746.04	251	0	1	0
10	111007879	111008163	MACS_peak_2843	575.25	284	0	1	0
10	118721107	118721385	MACS_peak_2884	455.81	278	0	1	0
10	119846468	119846707	MACS_peak_2891	588.69	239	0	1	0
10	122142855	122143067	MACS_peak_2898	763.02	212	0	1	0
10	122870523	122870891	MACS_peak_2903	60.54	368	0	1	0
10	125947153	125947526	MACS_peak_2915	59.12	373	0	1	0
10	126344013	126344284	MACS_peak_2916	202.56	271	0	1	0
10	133304725	133304994	MACS_peak_2955	852.62	269	2	1	0
10	133497456	133497669	MACS_peak_2957	451.43	213	0	1	0
11	189731	190106	MACS_peak_2966	352.17	375	1	1	0
11	191875	192263	MACS_peak_2967	628.81	388	2	1	0
11	585244	585533	MACS_peak_2970	76.3	289	0	1	0
11	1953661	1953866	MACS_peak_2972	797.18	205	0	1	0
11	9165970	9166177	MACS_peak_3025	613.04	207	0	1	0
11	13396057	13396492	MACS_peak_3043	66.99	435	0	1	0
11	14455112	14455345	MACS_peak_3058	678.9	233	0	1	0
11	14572408	14572730	MACS_peak_3059	136.91	322	0	1	0
11	14597573	14598025	MACS_peak_3060	178.43	452	0	1	0
11	14628974	14629438	MACS_peak_3061	53.31	464	0	1	0
11	16820370	16820709	MACS_peak_3085	538.66	339	0	1	0
11	16946018	16946351	MACS_peak_3086	424.75	333	0	1	0
11	17864469	17864819	MACS_peak_3090	532.08	350	0	1	0
11	17963361	17963496	MACS_peak_3091	498.22	135	0	1	0
11	17978762	17979026	MACS_peak_3092	464.74	264	0	1	0
11	17979845	17980078	MACS_peak_3093	678.9	233	0	1	0
11	17991772	17992102	MACS_peak_3094	488.85	330	0	1	0
11	18486433	18486811	MACS_peak_3098	153.24	378	0	1	0
11	28360990	28361373	MACS_peak_3179	218.92	383	0	1	0
11	31546099	31546393	MACS_peak_3208	170.9	294	0	1	0
11	31546621	31546980	MACS_peak_3209	52.67	359	0	1	0
11	31696407	31696678	MACS_peak_3210	142.94	271	0	1	1
11	32943341	32943702	MACS_peak_3218	57.34	361	0	1	0
11	34926165	34926357	MACS_peak_3227	833.66	192	0	1	0
11	34951776	34952087	MACS_peak_3228	87.14	311	0	1	0
11	34952537	34952822	MACS_peak_3229	84.69	285	0	1	0
11	35698259	35698638	MACS_peak_3231	125.37	379	0	1	0
11	35705472	35705823	MACS_peak_3232	130.39	351	0	1	0
11	35742396	35742821	MACS_peak_3233	1519.94	425	0	1	0
11	36266095	36266404	MACS_peak_3234	437.6	309	1	0	0
11	46006466	46006872	MACS_peak_3289	1126.43	406	0	1	0
11	46507476	46507608	MACS_peak_3296	857.98	132	0	1	0
11	46537755	46538137	MACS_peak_3297	401.26	382	0	1	0
11	46573888	46574245	MACS_peak_3298	105.65	357	0	1	1
11	46838689	46838825	MACS_peak_3299	1056.36	136	0	1	0
11	47259588	47259932	MACS_peak_3302	657.74	344	0	1	0
11	47355278	47355448	MACS_peak_3303	797.18	170	1	0	0
11	47558519	47558880	MACS_peak_3305	525.71	361	0	1	0
11	47721993	47722149	MACS_peak_3306	784.03	156	0	1	0
11	59802662	59802951	MACS_peak_3431	571.63	289	1	1	0
11	60886577	60886841	MACS_peak_3445	229.33	264	1	0	0
11	61129780	61130117	MACS_peak_3448	834.03	337	1	0	0
11	61446235	61446429	MACS_peak_3450	678.9	194	0	2	0
11	62705565	62705960	MACS_peak_3462	507.23	395	1	2	0
11	63670744	63670963	MACS_peak_3478	580.62	219	0	1	0
11	63738839	63739110	MACS_peak_3479	1737.7	271	0	1	0
11	64887925	64888229	MACS_peak_3482	561.16	304	0	1	0
11	65112544	65112792	MACS_peak_3483	485.56	248	2	0	0
11	65329950	65330315	MACS_peak_3484	495.65	365	1	0	0
11	65593873	65594079	MACS_peak_3486	797.18	206	2	0	0
11	65711836	65712013	MACS_peak_3488	1844.9	177	2	0	0
11	65845028	65845334	MACS_peak_3490	336.45	306	0	2	0
11	65884742	65884927	MACS_peak_3491	901.33	185	1	0	0
11	66094186	66094665	MACS_peak_3494	127.93	479	0	1	0
11	66095005	66095384	MACS_peak_3495	55.29	379	0	1	0
11	66222710	66222921	MACS_peak_3496	596.79	211	0	1	0
11	66282562	66282858	MACS_peak_3497	566.68	296	2	0	0
11	66694646	66694993	MACS_peak_3499	380.3	347	0	1	0
11	67168339	67168537	MACS_peak_3500	831.63	198	0	1	0
11	67345909	67346222	MACS_peak_3501	810.73	313	1	1	0
11	67356922	67357133	MACS_peak_3502	1301.7	211	0	2	0
11	67371377	67371628	MACS_peak_3503	485.56	251	0	3	0
11	68206195	68206412	MACS_peak_3511	580.62	217	0	1	0
11	68409059	68409346	MACS_peak_3512	573.07	287	0	1	0
11	68727905	68728087	MACS_peak_3514	729.14	182	0	1	0
11	69101411	69101761	MACS_peak_3517	416.22	350	0	1	0
11	69670302	69670556	MACS_peak_3518	470.06	254	0	1	0
11	71512621	71513011	MACS_peak_3526	113.09	390	0	1	0
11	71800311	71800787	MACS_peak_3533	815.52	476	0	1	1
11	72025060	72025456	MACS_peak_3536	972.38	396	0	1	0
11	72434154	72434408	MACS_peak_3540	1171.45	254	0	1	0
11	72683729	72684081	MACS_peak_3543	415.24	352	1	0	0
11	73072660	73073011	MACS_peak_3544	371.55	351	0	1	0
11	73351115	73351503	MACS_peak_3550	1102.85	388	0	1	0
11	73393656	73393920	MACS_peak_3551	972.38	264	0	1	0
11	73478776	73479053	MACS_peak_3552	456.44	277	0	1	0
11	73544661	73545026	MACS_peak_3553	643.49	365	0	1	0
11	73729893	73730197	MACS_peak_3555	529.34	304	0	1	0
11	73812197	73812432	MACS_peak_3556	448.43	235	0	1	0
11	74621987	74622394	MACS_peak_3564	473.28	407	0	1	0
11	74757112	74757497	MACS_peak_3566	96.97	385	0	1	0
11	74758221	74758585	MACS_peak_3567	76.89	364	0	1	0
11	74799820	74800033	MACS_peak_3568	370.25	213	0	1	0
11	74830785	74831115	MACS_peak_3569	1069.92	330	0	2	1
11	75121950	75122341	MACS_peak_3575	83.36	391	0	1	1
11	75124685	75124978	MACS_peak_3576	165.91	293	0	1	1
11	75407933	75408266	MACS_peak_3581	1345.06	333	0	1	0
11	76881535	76881748	MACS_peak_3593	511.33	213	0	1	0
11	76908808	76909181	MACS_peak_3594	92.88	373	0	1	0
11	76939804	76940076	MACS_peak_3595	584.2	272	0	1	0
11	77326944	77327354	MACS_peak_3600	82.65	410	0	1	0
11	77329110	77329421	MACS_peak_3601	95.79	311	0	1	0
11	77330156	77330498	MACS_peak_3602	111.37	342	0	1	0
11	77619641	77619864	MACS_peak_3604	564.54	223	0	1	0
11	77758725	77758982	MACS_peak_3605	338.06	257	0	1	0
11	77888606	77888994	MACS_peak_3606	172.39	388	0	2	0
11	77949458	77949750	MACS_peak_3607	142.05	292	0	1	0
11	78104837	78105134	MACS_peak_3608	512.48	297	1	0	0
11	78414155	78414545	MACS_peak_3609	679.18	390	0	1	1
11	82864293	82864528	MACS_peak_3650	972.07	235	0	1	0
11	86041928	86042155	MACS_peak_3676	548.55	227	0	1	0
11	86307891	86308288	MACS_peak_3678	391.67	397	0	1	0
11	86456017	86456498	MACS_peak_3681	671.72	481	0	1	1
11	86571642	86571899	MACS_peak_3682	449.27	257	0	1	1
11	86653304	86653590	MACS_peak_3683	112.91	286	0	1	0
11	86655455	86655908	MACS_peak_3684	57.34	453	0	1	0
11	86826330	86826694	MACS_peak_3685	61.7	364	0	1	0
11	86828322	86828776	MACS_peak_3686	57.09	454	0	1	0
11	95874619	95875059	MACS_peak_3750	119.54	440	0	1	0
11	101456795	101457086	MACS_peak_3776	570.2	291	0	1	0
11	101679425	101679653	MACS_peak_3777	192	228	0	1	0
11	101702969	101703355	MACS_peak_3778	667.43	386	0	1	0
11	101841979	101842355	MACS_peak_3780	114.74	376	0	1	0
11	103138769	103139188	MACS_peak_3786	77.02	419	0	1	0
11	103325943	103326243	MACS_peak_3787	690.75	300	0	1	0
11	107364182	107364564	MACS_peak_3802	78.42	382	0	1	0
11	107364700	107365154	MACS_peak_3803	50.57	454	0	1	0
11	107367080	107367423	MACS_peak_3804	124.94	343	0	1	0
11	107838376	107838752	MACS_peak_3805	265.34	376	0	1	0
11	108359256	108359728	MACS_peak_3807	272.09	472	0	2	0
11	108359933	108360195	MACS_peak_3808	85.37	262	0	2	0
11	108361919	108362382	MACS_peak_3809	100.2	463	0	2	0
11	108684420	108684765	MACS_peak_3811	95.66	345	0	1	0
11	108697922	108698178	MACS_peak_3812	729.14	256	0	1	0
11	113766664	113766986	MACS_peak_3835	229.83	322	0	1	0
11	118198336	118198578	MACS_peak_3867	645.81	242	1	0	0
11	118488535	118488951	MACS_peak_3870	455.81	416	0	1	0
11	118565803	118566217	MACS_peak_3871	497.6	414	0	1	0
11	118772253	118772469	MACS_peak_3875	577.49	216	0	1	0
11	119004064	119004268	MACS_peak_3876	573.39	204	0	1	1
11	126237657	126237887	MACS_peak_3905	762.11	230	0	1	0
11	126310565	126310774	MACS_peak_3906	613.04	209	0	1	0
11	129175073	129175519	MACS_peak_3910	54.32	446	0	1	0
11	129193435	129193835	MACS_peak_3911	889.09	400	0	1	0
11	129245099	129245472	MACS_peak_3912	148.81	373	0	1	0
11	134262103	134262310	MACS_peak_3933	613.04	207	0	1	0
12	2885365	2885586	MACS_peak_3950	1043.77	221	0	2	0
12	4511092	4511528	MACS_peak_3962	81.42	436	0	1	0
12	4512658	4513004	MACS_peak_3963	50.76	346	0	1	0
12	4571515	4571688	MACS_peak_3964	723.41	173	0	1	0
12	6938000	6938332	MACS_peak_3981	542.96	332	1	1	0
12	7319557	7319717	MACS_peak_3983	1472.89	160	0	1	0
12	9748520	9748983	MACS_peak_3996	1076.78	463	1	0	0
12	12409153	12409392	MACS_peak_4021	253.88	239	0	1	0
12	12409864	12410249	MACS_peak_4022	187.51	385	0	1	0
12	13077898	13078249	MACS_peak_4024	114.74	351	0	1	0
12	13098448	13098595	MACS_peak_4025	1087.19	147	0	2	0
12	14630162	14630343	MACS_peak_4032	936.57	181	0	1	0
12	14863592	14863940	MACS_peak_4034	127.5	348	0	1	0
12	26216511	26216811	MACS_peak_4089	69.69	300	0	1	1
12	27039504	27039721	MACS_peak_4095	423.76	217	0	1	0
12	28267592	28267965	MACS_peak_4107	762.41	373	0	1	0
12	28523362	28523680	MACS_peak_4108	133.95	318	0	1	0
12	32717144	32717468	MACS_peak_4127	801.19	324	0	1	0
12	42332334	42332680	MACS_peak_4221	418.18	346	0	1	0
12	45725767	45726011	MACS_peak_4243	918.92	244	1	0	1
12	45762525	45762877	MACS_peak_4244	530.91	352	0	1	0
12	49513987	49514438	MACS_peak_4278	598.13	451	0	1	0
12	49636988	49637187	MACS_peak_4280	831.63	199	1	1	0
12	52894544	52894680	MACS_peak_4319	664.91	136	1	0	0
12	53655229	53655450	MACS_peak_4326	564.54	221	0	1	0
12	53676110	53676481	MACS_peak_4327	520.09	371	0	1	0
12	54032585	54032854	MACS_peak_4330	852.62	269	1	2	1
12	55928417	55928713	MACS_peak_4360	603.02	296	1	1	0
12	55996154	55996384	MACS_peak_4361	532.66	230	1	1	0
12	56271096	56271453	MACS_peak_4366	528	357	2	0	0
12	56594184	56594437	MACS_peak_4373	470.06	253	1	1	0
12	56636801	56637183	MACS_peak_4374	312.33	382	1	0	0
12	64499027	64499167	MACS_peak_4463	1752.27	140	0	1	0
12	65306603	65306809	MACS_peak_4469	629.38	206	0	1	0
12	65351305	65351656	MACS_peak_4470	87.12	351	0	1	0
12	65352473	65352755	MACS_peak_4471	103.45	282	0	1	0
12	68766482	68766614	MACS_peak_4505	977.06	132	0	1	0
12	68830324	68830614	MACS_peak_4506	418.87	290	0	1	0
12	68833044	68833394	MACS_peak_4507	304.28	350	0	1	0
12	70590028	70590322	MACS_peak_4529	625.23	294	0	1	0
12	70630868	70631244	MACS_peak_4530	115.9	376	0	1	0
12	89459403	89459687	MACS_peak_4750	600.96	284	0	1	0
12	89521999	89522280	MACS_peak_4751	1120.76	281	2	1	0
12	93410040	93410315	MACS_peak_4777	581.92	275	1	0	0
12	93735237	93735599	MACS_peak_4779	488.85	362	0	1	1
12	95073652	95073958	MACS_peak_4789	685.97	306	1	0	0
12	100322039	100322334	MACS_peak_4839	243.49	295	0	1	0
12	102091392	102091527	MACS_peak_4857	702.09	135	0	1	0
12	102095706	102095940	MACS_peak_4858	644.94	234	0	1	0
12	106261573	106261828	MACS_peak_4903	866.35	255	0	1	0
12	106357387	106357752	MACS_peak_4904	409.04	365	1	0	0
12	106472038	106472302	MACS_peak_4905	125.63	264	0	1	0
12	106473360	106473777	MACS_peak_4906	82.72	417	0	1	0
12	106778355	106778590	MACS_peak_4908	847.1	235	1	0	0
12	108511978	108512270	MACS_peak_4921	829.92	292	1	0	0
12	108803578	108803828	MACS_peak_4924	485.56	250	0	1	0
12	110430831	110431064	MACS_peak_4935	302.6	233	1	0	1
12	110431204	110431671	MACS_peak_4936	1204.42	467	1	0	1
12	111529320	111529705	MACS_peak_4943	630.67	385	0	1	0
12	111553484	111553709	MACS_peak_4944	181.09	225	0	1	0
12	112058889	112059208	MACS_peak_4948	114.74	319	0	1	0
12	112138736	112138996	MACS_peak_4949	440.77	260	0	1	0
12	112198219	112198476	MACS_peak_4950	469.39	257	0	1	0
12	112411614	112411839	MACS_peak_4951	839.47	225	0	1	0
12	113005822	113006253	MACS_peak_4956	285.42	431	0	1	1
12	113174467	113174636	MACS_peak_4960	1025.76	169	0	1	0
12	113952899	113953114	MACS_peak_4961	453.32	215	0	1	0
12	118377927	118378199	MACS_peak_4984	2566.34	272	1	0	0
12	120552950	120553102	MACS_peak_5004	2041.47	152	0	1	0
12	120583450	120583752	MACS_peak_5005	441.54	302	1	0	0
12	120714050	120714392	MACS_peak_5007	536.84	342	1	0	0
12	120898213	120898421	MACS_peak_5008	760.34	208	0	1	0
12	121255162	121255391	MACS_peak_5013	848.95	229	0	1	0
12	121479018	121479396	MACS_peak_5014	831.33	378	0	1	0
12	121499943	121500214	MACS_peak_5015	1279.99	271	0	1	0
12	121539225	121539366	MACS_peak_5016	1588.16	141	0	1	0
12	122289695	122289828	MACS_peak_5022	1341.63	133	0	1	0
12	122336105	122336442	MACS_peak_5023	922.25	337	0	1	0
12	122471666	122471992	MACS_peak_5024	997.64	326	1	0	0
12	123264081	123264492	MACS_peak_5029	834.03	411	1	0	0
12	123322892	123323130	MACS_peak_5030	690.17	238	0	1	0
12	123582202	123582392	MACS_peak_5033	1167.67	190	1	0	1
12	123801660	123801833	MACS_peak_5034	1208.41	173	0	1	0
12	123810267	123810639	MACS_peak_5035	312.33	372	0	1	0
12	132809461	132809828	MACS_peak_5093	1310.99	367	0	1	0
13	19642444	19642712	MACS_peak_5105	718.04	268	0	1	0
13	19718145	19718437	MACS_peak_5106	447.34	292	0	1	0
13	20828636	20828916	MACS_peak_5112	578.19	280	0	1	0
13	20829194	20829483	MACS_peak_5113	449.12	289	0	1	0
13	21551741	21552117	MACS_peak_5118	91.89	376	0	1	0
13	23781176	23781474	MACS_peak_5136	69	298	0	1	0
13	27580119	27580389	MACS_peak_5157	3100	270	0	1	0
13	27696428	27696713	MACS_peak_5158	703.15	285	0	1	1
13	28293380	28293512	MACS_peak_5164	981.89	132	0	1	0
13	28324299	28324487	MACS_peak_5165	695.57	188	0	1	0
13	29508247	29508448	MACS_peak_5169	645.81	201	1	0	0
13	32604510	32604969	MACS_peak_5186	134.63	459	0	1	0
13	32650778	32651076	MACS_peak_5187	960.47	298	0	1	0
13	32668941	32669331	MACS_peak_5188	722.05	390	0	1	0
13	32713416	32713610	MACS_peak_5189	873.21	194	0	1	0
13	33855777	33856126	MACS_peak_5195	416.71	349	0	1	0
13	39742198	39742448	MACS_peak_5233	157.99	250	0	1	0
13	40737301	40737561	MACS_peak_5240	79.76	260	0	1	0
13	40738050	40738307	MACS_peak_5241	52.18	257	0	1	0
13	40740404	40740783	MACS_peak_5242	108.26	379	0	1	0
13	41075154	41075352	MACS_peak_5246	808.21	198	0	1	0
13	41222273	41222497	MACS_peak_5248	564.54	224	0	1	1
13	41353123	41353305	MACS_peak_5249	710.43	182	0	1	0
13	42141892	42142163	MACS_peak_5253	124.62	271	0	1	0
13	42216072	42216420	MACS_peak_5254	417.2	348	0	1	0
13	42967011	42967371	MACS_peak_5257	164.26	360	0	1	0
13	44483678	44483969	MACS_peak_5271	674.68	291	0	1	0
13	45511633	45511851	MACS_peak_5276	577.49	218	0	1	0
13	45515955	45516307	MACS_peak_5277	415.24	352	0	1	0
13	47784177	47784602	MACS_peak_5306	119.11	425	0	1	0
13	47784823	47785284	MACS_peak_5307	62.5	461	0	1	0
13	47785935	47786316	MACS_peak_5308	54.79	381	0	1	0
13	48015860	48016301	MACS_peak_5310	91.01	441	0	1	0
13	48016404	48016755	MACS_peak_5311	68.83	351	0	1	0
13	48037967	48038229	MACS_peak_5312	838.54	262	1	0	0
13	48336418	48336690	MACS_peak_5314	62.38	272	0	1	0
13	48337396	48337760	MACS_peak_5315	140.37	364	0	1	0
13	49281151	49281363	MACS_peak_5317	596.79	212	0	1	0
13	50985036	50985321	MACS_peak_5324	96.14	285	0	1	0
13	50987641	50987962	MACS_peak_5325	141.24	321	0	1	0
13	51435011	51435366	MACS_peak_5327	776.01	355	0	1	0
13	51733803	51733999	MACS_peak_5329	662.31	196	0	1	0
13	51787690	51788006	MACS_peak_5330	433.75	316	0	2	0
13	52665410	52665632	MACS_peak_5338	712.32	222	0	1	0
13	59678139	59678503	MACS_peak_5371	409.51	364	0	1	0
13	59680498	59680823	MACS_peak_5372	1236.43	325	0	1	0
13	59771336	59771594	MACS_peak_5373	595.17	258	0	1	0
13	59906471	59906776	MACS_peak_5375	560.48	305	0	1	0
13	60473620	60473855	MACS_peak_5378	662.31	235	0	1	0
13	72882560	72882816	MACS_peak_5450	729.14	256	0	1	0
13	79491534	79491857	MACS_peak_5488	722.05	323	0	1	0
13	79541425	79541765	MACS_peak_5489	421.18	340	0	1	0
13	98840198	98840402	MACS_peak_5589	629.38	204	0	1	0
13	99266027	99266192	MACS_peak_5590	1061.85	165	0	1	0
13	99269662	99269933	MACS_peak_5591	460.22	271	0	1	0
13	99528642	99528891	MACS_peak_5592	485.56	249	0	1	0
13	100633953	100634269	MACS_peak_5593	678.2	316	0	1	0
13	101642117	101642350	MACS_peak_5596	263.69	233	0	1	0
13	111221106	111221410	MACS_peak_5645	440.4	304	0	1	0
13	112573095	112573359	MACS_peak_5648	857.82	264	0	1	0
13	113241400	113241532	MACS_peak_5649	1116.4	132	0	1	0
13	113450994	113451331	MACS_peak_5650	1485.25	337	1	1	0
13	113621483	113621698	MACS_peak_5651	944.23	215	0	1	0
14	20690992	20691364	MACS_peak_5709	763.14	372	0	3	0
14	21092518	21092833	MACS_peak_5714	434.29	315	1	0	0
14	21456563	21456927	MACS_peak_5718	582.02	364	1	0	0
14	23056189	23056497	MACS_peak_5746	438.15	308	1	1	0
14	23068929	23069191	MACS_peak_5747	723.53	262	0	1	0
14	23120793	23121098	MACS_peak_5748	872.75	305	2	0	0
14	24002940	24003316	MACS_peak_5753	176.43	376	0	1	1
14	24112447	24112819	MACS_peak_5757	64.04	372	1	1	0
14	24308093	24308376	MACS_peak_5759	704.85	283	3	1	0
14	24327933	24328123	MACS_peak_5760	730.64	190	1	1	0
14	24332236	24332444	MACS_peak_5761	780.06	208	2	1	0
14	30656168	30656457	MACS_peak_5830	449.12	289	0	1	0
14	30666197	30666435	MACS_peak_5831	100.83	238	0	1	0
14	30666512	30666816	MACS_peak_5832	132.69	304	0	1	0
14	30681705	30682092	MACS_peak_5833	575.04	387	0	1	0
14	30980230	30980535	MACS_peak_5835	825.19	305	0	1	0
14	31127996	31128246	MACS_peak_5837	485.56	250	0	1	0
14	31355962	31356298	MACS_peak_5839	423.21	336	0	2	0
14	35620301	35620649	MACS_peak_5872	227.21	348	0	1	0
14	36781251	36781491	MACS_peak_5881	936.57	240	0	1	0
14	36892542	36892901	MACS_peak_5883	179.12	359	0	1	0
14	36942332	36942570	MACS_peak_5884	932.35	238	0	1	0
14	37015511	37015838	MACS_peak_5885	121.38	327	0	1	0
14	37015979	37016305	MACS_peak_5886	99.41	326	0	1	0
14	37117632	37117893	MACS_peak_5887	466.72	261	0	1	0
14	37149733	37150160	MACS_peak_5888	611.86	427	0	1	0
14	37230702	37230918	MACS_peak_5889	1079.97	216	0	1	0
14	37295498	37295747	MACS_peak_5890	133.99	249	0	1	0
14	37446218	37446553	MACS_peak_5891	83.8	335	0	1	0
14	37446564	37446938	MACS_peak_5892	119.37	374	0	1	0
14	49586929	49587176	MACS_peak_6045	485.56	247	0	1	0
14	49830176	49830411	MACS_peak_6046	502.51	235	0	1	0
14	50105090	50105285	MACS_peak_6052	869.22	195	1	0	0
14	50236739	50237095	MACS_peak_6053	268.76	356	1	0	0
14	50243545	50243846	MACS_peak_6054	141.59	301	0	1	0
14	50755546	50755781	MACS_peak_6057	516.86	235	0	1	0
14	50773766	50773967	MACS_peak_6058	645.81	201	0	1	0
14	50777850	50778216	MACS_peak_6059	1165.72	366	0	1	0
14	51250173	51250429	MACS_peak_6063	666.39	256	0	1	0
14	54403026	54403301	MACS_peak_6100	69	275	0	1	0
14	54950974	54951332	MACS_peak_6106	63.49	358	0	1	0
14	54981782	54982015	MACS_peak_6107	429.38	233	0	1	0
14	55051430	55051675	MACS_peak_6108	501.16	245	1	0	0
14	55161131	55161326	MACS_peak_6109	490.85	195	0	1	0
14	55280350	55280707	MACS_peak_6113	443.57	357	0	1	0
14	55297934	55298313	MACS_peak_6114	515.71	379	0	1	0
14	55322992	55323345	MACS_peak_6115	272.05	353	0	1	0
14	57202741	57202974	MACS_peak_6140	525.73	233	1	0	0
14	57294225	57294571	MACS_peak_6141	656.34	346	0	1	0
14	58208534	58208739	MACS_peak_6154	612.68	205	0	2	0
14	60268318	60268567	MACS_peak_6172	525.79	249	0	1	0
14	60887653	60888050	MACS_peak_6179	94.4	397	0	1	1
14	60910917	60911259	MACS_peak_6180	90.24	342	0	1	1
14	61011507	61011798	MACS_peak_6181	122.82	291	0	1	0
14	61025316	61025556	MACS_peak_6182	502.51	240	0	1	0
14	63388937	63389202	MACS_peak_6213	464.09	265	0	1	0
14	63398322	63398543	MACS_peak_6214	729.14	221	0	1	0
14	63641464	63641642	MACS_peak_6216	1422.04	178	0	1	0
14	64430063	64430278	MACS_peak_6219	543.04	215	0	1	1
14	64511174	64511379	MACS_peak_6220	573.39	205	0	1	0
14	64983816	64984180	MACS_peak_6224	693.48	364	1	1	0
14	69129320	69129601	MACS_peak_6252	577.45	281	0	1	0
14	69460095	69460496	MACS_peak_6254	393.43	401	0	1	0
14	70330566	70330828	MACS_peak_6265	1336.03	262	1	1	0
14	70938194	70938544	MACS_peak_6269	50.92	350	0	1	0
14	70959886	70960146	MACS_peak_6270	81.88	260	0	1	0
14	70975841	70976029	MACS_peak_6271	687.06	188	0	1	0
14	71037281	71037531	MACS_peak_6272	75.91	250	0	1	0
14	71050280	71050539	MACS_peak_6274	540.64	259	0	1	0
14	71104010	71104220	MACS_peak_6275	613.04	210	0	1	0
14	73023157	73023459	MACS_peak_6296	178.37	302	0	1	0
14	73197843	73198135	MACS_peak_6297	488.85	292	0	1	0
14	73314617	73314812	MACS_peak_6299	649.48	195	0	1	0
14	73387717	73387947	MACS_peak_6300	510.52	230	0	1	1
14	73390188	73390444	MACS_peak_6301	729.14	256	0	1	1
14	73508741	73508879	MACS_peak_6302	1406.54	138	0	1	0
14	73570973	73571285	MACS_peak_6303	1127.86	312	1	0	0
14	74087339	74087542	MACS_peak_6306	654.07	203	1	0	0
14	74096931	74097159	MACS_peak_6307	498.19	228	0	1	0
14	74111672	74111880	MACS_peak_6308	770.35	208	0	1	0
14	74125460	74125919	MACS_peak_6309	157.77	459	0	1	0
14	74180148	74180498	MACS_peak_6310	265.34	350	0	1	0
14	74508391	74508619	MACS_peak_6313	695.57	228	0	1	0
14	74564005	74564419	MACS_peak_6314	1329.38	414	0	1	0
14	74727146	74727504	MACS_peak_6315	56.95	358	0	1	0
14	74878444	74878706	MACS_peak_6316	1136.13	262	1	0	0
14	75088649	75088869	MACS_peak_6318	549.18	220	0	1	0
14	75654235	75654486	MACS_peak_6322	485.56	251	1	2	0
14	75906734	75907008	MACS_peak_6323	582.68	274	1	1	0
14	76149381	76149735	MACS_peak_6324	611.86	354	1	0	1
14	76199014	76199322	MACS_peak_6325	438.15	308	0	1	0
14	77300959	77301315	MACS_peak_6334	775.24	356	0	1	0
14	77315816	77316150	MACS_peak_6335	664.84	334	0	1	0
14	88407507	88407838	MACS_peak_6418	105.65	331	0	1	0
14	88445498	88445762	MACS_peak_6419	50.92	264	0	1	0
14	88459240	88459610	MACS_peak_6420	124.97	370	0	1	0
14	88460023	88460435	MACS_peak_6421	89.02	412	0	1	0
14	88468463	88468780	MACS_peak_6422	3100	317	1	1	0
14	91645552	91645893	MACS_peak_6446	85.73	341	0	1	0
14	91649868	91650240	MACS_peak_6447	413.49	372	0	1	0
14	93234003	93234319	MACS_peak_6457	1053.5	316	1	0	0
14	100242020	100242205	MACS_peak_6487	536.31	185	1	0	0
14	100271186	100271549	MACS_peak_6488	478.36	363	0	1	0
14	101771058	101771470	MACS_peak_6497	552.59	412	0	1	0
14	102096634	102096875	MACS_peak_6499	487.14	241	0	1	0
14	102314299	102314547	MACS_peak_6500	485.56	248	1	0	0
14	102972684	102972850	MACS_peak_6502	527.73	166	0	1	0
14	103031951	103032192	MACS_peak_6503	646.51	241	0	1	0
14	103048518	103048808	MACS_peak_6504	274.91	290	0	1	0
14	103394033	103394297	MACS_peak_6509	986.85	264	0	1	0
14	105317156	105317433	MACS_peak_6525	691.36	277	0	1	0
15	22884430	22884673	MACS_peak_6605	780.06	243	0	1	0
15	24927371	24927597	MACS_peak_6630	243.16	226	0	1	0
15	28305243	28305633	MACS_peak_6639	137.06	390	0	1	0
15	29925960	29926200	MACS_peak_6652	516.86	240	0	1	0
15	30929601	30930024	MACS_peak_6673	722.05	423	0	1	0
15	32610841	32611125	MACS_peak_6690	575.25	284	1	0	1
15	32617486	32617737	MACS_peak_6691	131.01	251	1	0	0
15	34089104	34089390	MACS_peak_6695	277.16	286	0	1	0
15	38449872	38450072	MACS_peak_6717	645.81	200	1	0	0
15	38474209	38474369	MACS_peak_6718	866.35	160	0	1	0
15	40217222	40217551	MACS_peak_6736	544.83	329	1	1	0
15	40320990	40321264	MACS_peak_6738	458.32	274	1	0	0
15	40891841	40892187	MACS_peak_6739	656.34	346	1	0	0
15	41051124	41051256	MACS_peak_6741	1090.31	132	0	1	0
15	41383869	41384121	MACS_peak_6742	164.73	252	1	0	0
15	42177061	42177283	MACS_peak_6747	433.36	222	0	1	0
15	42557248	42557468	MACS_peak_6748	482.68	220	0	1	0
15	43163499	43163783	MACS_peak_6750	398.72	284	0	1	1
15	43177131	43177434	MACS_peak_6751	68.59	303	0	1	1
15	43367856	43368080	MACS_peak_6754	378.09	224	1	1	0
15	43652875	43653189	MACS_peak_6755	89.02	314	0	1	0
15	43689971	43690242	MACS_peak_6756	460.22	271	1	0	0
15	44288350	44288580	MACS_peak_6760	675.15	230	1	0	0
15	44360164	44360483	MACS_peak_6761	86.85	319	0	1	0
15	44363056	44363504	MACS_peak_6762	76.89	448	0	1	0
15	45419896	45420039	MACS_peak_6770	1549.78	143	0	1	0
15	49277047	49277410	MACS_peak_6789	69	363	0	1	0
15	49322956	49323226	MACS_peak_6790	585.73	270	1	1	0
15	49471341	49471737	MACS_peak_6792	1192.27	396	0	2	0
15	49494058	49494290	MACS_peak_6793	571.87	232	0	1	0
15	49638688	49638989	MACS_peak_6794	608.28	301	0	1	0
15	50459886	50460022	MACS_peak_6805	753.52	136	0	1	0
15	50505232	50505458	MACS_peak_6806	700.54	226	1	1	0
15	50598970	50599232	MACS_peak_6807	950.42	262	0	1	0
15	50622245	50622673	MACS_peak_6808	406.81	428	0	1	0
15	50733422	50733716	MACS_peak_6810	815.26	294	0	1	0
15	50908550	50908765	MACS_peak_6814	647.94	215	1	0	0
15	50962707	50962982	MACS_peak_6815	406.81	275	0	1	0
15	50986004	50986366	MACS_peak_6816	85.57	362	0	1	0
15	51777104	51777389	MACS_peak_6838	611.86	285	0	1	0
15	51785413	51785584	MACS_peak_6839	598.96	171	0	1	0
15	51851884	51852099	MACS_peak_6840	644.42	215	0	1	0
15	51888624	51889040	MACS_peak_6841	1065.38	416	0	1	1
15	51897370	51897594	MACS_peak_6842	230.25	224	0	1	1
15	51905946	51906139	MACS_peak_6843	997.5	193	0	1	0
15	51982281	51982540	MACS_peak_6844	663.58	259	0	1	0
15	55433816	55434078	MACS_peak_6872	859.93	262	0	1	1
15	57146442	57146678	MACS_peak_6885	502.51	236	0	1	0
15	57779282	57779551	MACS_peak_6886	406.81	269	0	1	0
15	60444114	60444427	MACS_peak_6896	555.13	313	0	1	0
15	63547772	63548008	MACS_peak_6908	793.98	236	0	1	1
15	64209818	64210066	MACS_peak_6916	613.04	248	0	2	0
15	64364689	64365049	MACS_peak_6917	158.81	360	1	1	0
15	64395985	64396298	MACS_peak_6918	600.44	313	0	1	0
15	64402007	64402271	MACS_peak_6919	540.16	264	0	1	0
15	64681513	64681737	MACS_peak_6920	564.54	224	0	1	0
15	65271083	65271279	MACS_peak_6922	662.31	196	0	1	0
15	65638685	65638878	MACS_peak_6925	1043.77	193	0	1	0
15	65859481	65859616	MACS_peak_6926	1358.26	135	0	1	0
15	65885691	65885947	MACS_peak_6927	722.05	256	0	1	0
15	66449967	66450259	MACS_peak_6929	99.97	292	0	1	0
15	66451843	66452134	MACS_peak_6930	218.29	291	0	1	0
15	66497774	66498032	MACS_peak_6931	727.26	258	1	0	0
15	67433638	67433805	MACS_peak_6933	814.37	167	0	1	1
15	67449234	67449536	MACS_peak_6934	123.52	302	0	1	1
15	67456935	67457363	MACS_peak_6935	431.4	428	0	1	1
15	68154954	68155274	MACS_peak_6936	550.56	320	0	1	0
15	68161375	68161509	MACS_peak_6937	1377.21	134	0	1	0
15	68829083	68829352	MACS_peak_6946	461.5	269	0	1	0
15	69059207	69059587	MACS_peak_6947	402.16	380	0	1	0
15	70984334	70984571	MACS_peak_6955	189.9	237	0	1	0
15	70986490	70986831	MACS_peak_6956	55.24	341	0	1	0
15	70988472	70988759	MACS_peak_6957	66.55	287	0	1	0
15	70990017	70990272	MACS_peak_6958	169.18	255	0	1	0
15	71011586	71011834	MACS_peak_6959	1140.18	248	0	1	0
15	72473641	72473847	MACS_peak_6974	629.38	206	1	0	1
15	72498859	72499077	MACS_peak_6975	442.94	218	0	1	0
15	74631871	74632262	MACS_peak_6998	626.96	391	1	1	0
15	74635251	74635516	MACS_peak_6999	1141.07	265	1	1	0
15	74901647	74901880	MACS_peak_7004	831.63	233	1	1	0
15	74925682	74926049	MACS_peak_7005	296.48	367	0	1	0
15	75084439	75084883	MACS_peak_7007	87.04	444	0	1	0
15	75410866	75411296	MACS_peak_7013	437.12	430	0	1	0
15	75481987	75482359	MACS_peak_7014	103.45	372	0	1	0
15	78432696	78432960	MACS_peak_7036	451.4	264	1	0	0
15	78860176	78860540	MACS_peak_7040	374.08	364	0	1	0
15	82139830	82140120	MACS_peak_7070	698.94	290	0	1	0
15	88455044	88455301	MACS_peak_7129	1006.59	257	2	0	0
15	90362076	90362320	MACS_peak_7152	469.89	244	0	1	0
15	90990038	90990469	MACS_peak_7158	349.84	431	0	2	0
15	99213296	99213589	MACS_peak_7233	490.12	293	0	1	0
15	99273023	99273219	MACS_peak_7234	1226.97	196	0	1	0
15	99286415	99286693	MACS_peak_7235	970.76	278	0	1	0
15	100572473	100572674	MACS_peak_7244	651.96	201	0	1	0
15	100627832	100628126	MACS_peak_7245	446.16	294	0	1	0
15	101269891	101270171	MACS_peak_7253	562.2	280	1	0	0
15	101629591	101629856	MACS_peak_7256	60.31	265	0	1	0
15	101639194	101639503	MACS_peak_7257	488.85	309	0	1	0
15	101641210	101641496	MACS_peak_7258	973.26	286	0	1	0
16	52608	52894	MACS_peak_7275	265.34	286	1	1	0
16	612094	612563	MACS_peak_7277	398.43	469	0	1	0
16	612712	613081	MACS_peak_7278	236.35	369	0	1	0
16	1236490	1236893	MACS_peak_7280	741.16	403	1	0	0
16	2907226	2907557	MACS_peak_7292	527.67	331	1	0	0
16	4330373	4330637	MACS_peak_7301	1142.38	264	1	1	0
16	4823623	4823761	MACS_peak_7302	1043.77	138	0	1	0
16	5084841	5085073	MACS_peak_7303	532.66	232	1	1	0
16	5092403	5092593	MACS_peak_7304	677.53	190	0	1	0
16	8905261	8905549	MACS_peak_7323	449.72	288	0	1	0
16	14249570	14249808	MACS_peak_7361	468.75	238	0	1	0
16	14833424	14833793	MACS_peak_7363	434.03	369	1	0	0
16	14873094	14873452	MACS_peak_7364	399.16	358	0	1	0
16	14941357	14941700	MACS_peak_7366	119.24	343	0	1	0
16	18415826	18416216	MACS_peak_7391	1993.08	390	1	0	0
16	18522720	18523078	MACS_peak_7392	368.21	358	0	1	0
16	19179931	19180270	MACS_peak_7399	421.69	339	0	1	0
16	19794216	19794486	MACS_peak_7406	716.24	270	0	1	0
16	21640768	21640985	MACS_peak_7419	580.62	217	1	1	0
16	22318789	22319026	MACS_peak_7430	814.37	237	0	1	0
16	23182403	23182754	MACS_peak_7439	415.73	351	1	0	1
16	23278941	23279105	MACS_peak_7441	810.9	164	1	0	0
16	23296982	23297114	MACS_peak_7442	972.31	132	0	1	0
16	23431600	23431834	MACS_peak_7443	342.45	234	0	1	0
16	23434465	23434714	MACS_peak_7444	471.88	249	0	1	0
16	23435430	23435769	MACS_peak_7445	661.26	339	0	1	0
16	24645717	24645973	MACS_peak_7450	596.79	256	0	1	0
16	24664393	24664689	MACS_peak_7451	445	296	0	1	1
16	24689918	24690137	MACS_peak_7452	446.78	219	0	1	0
16	24800757	24801004	MACS_peak_7453	485.56	247	0	1	0
16	24961411	24961615	MACS_peak_7456	268.92	204	0	1	0
16	27605586	27605908	MACS_peak_7467	936.39	322	0	1	0
16	27642660	27642800	MACS_peak_7468	1301.7	140	0	1	0
16	27690667	27690945	MACS_peak_7469	442.5	278	0	1	1
16	28160189	28160371	MACS_peak_7471	687.62	182	0	1	0
16	29815579	29815774	MACS_peak_7497	604.07	195	5	0	1
16	29881615	29881956	MACS_peak_7499	201.59	341	0	1	0
16	30430171	30430434	MACS_peak_7503	412.35	263	0	1	0
16	30694067	30694249	MACS_peak_7507	1785.17	182	1	0	0
16	31105630	31105914	MACS_peak_7510	596.03	284	1	0	0
16	31465280	31465481	MACS_peak_7515	793.98	201	0	1	0
16	31764671	31764997	MACS_peak_7518	114.74	326	0	1	0
16	31775516	31775745	MACS_peak_7519	541.5	229	0	1	0
16	46589971	46590320	MACS_peak_7641	149.86	349	0	1	0
16	46810905	46811150	MACS_peak_7645	507.55	245	0	1	0
16	46889114	46889271	MACS_peak_7646	1377.21	157	1	0	0
16	47187772	47188161	MACS_peak_7648	139.91	389	0	1	0
16	47222731	47223070	MACS_peak_7649	85.26	339	0	1	0
16	47325480	47325857	MACS_peak_7650	126.19	377	0	1	0
16	48400522	48400878	MACS_peak_7654	178.37	356	0	1	0
16	53054868	53055209	MACS_peak_7665	641.27	341	1	0	0
16	53278605	53278891	MACS_peak_7666	139.71	286	0	1	0
16	56513957	56514137	MACS_peak_7681	746.04	180	0	1	0
16	56808542	56808895	MACS_peak_7684	414.75	353	0	1	0
16	56826953	56827174	MACS_peak_7685	354.64	221	0	1	0
16	58005416	58005818	MACS_peak_7689	662.91	402	0	1	0
16	66867943	66868124	MACS_peak_7741	746.04	181	0	1	0
16	67942060	67942340	MACS_peak_7747	454.58	280	2	0	0
16	68000973	68001245	MACS_peak_7748	459.58	272	0	1	0
16	68855906	68856105	MACS_peak_7753	831.63	199	0	1	0
16	68902417	68902754	MACS_peak_7754	790.35	337	0	1	0
16	69122433	69122581	MACS_peak_7755	1012.48	148	1	0	0
16	69309964	69310203	MACS_peak_7758	1022.22	239	1	1	0
16	69428217	69428500	MACS_peak_7759	490.8	283	1	0	0
16	69912907	69913047	MACS_peak_7761	352.36	140	0	1	0
16	70331606	70331826	MACS_peak_7763	1061.85	220	0	2	1
16	70370140	70370312	MACS_peak_7764	1686.4	172	0	2	1
16	71736265	71736622	MACS_peak_7775	268.31	357	0	1	0
16	71746417	71746774	MACS_peak_7776	481.76	357	0	1	0
16	71882476	71882869	MACS_peak_7777	611.86	393	0	3	0
16	74650985	74651228	MACS_peak_7803	1396.21	243	0	1	0
16	75233719	75234143	MACS_peak_7806	492.72	424	0	1	0
16	75385640	75385962	MACS_peak_7807	513.75	322	0	1	0
16	75394649	75394789	MACS_peak_7808	960	140	0	1	0
16	75402921	75403209	MACS_peak_7809	447.07	288	0	1	0
16	75655202	75655484	MACS_peak_7812	464.3	282	0	1	0
16	75723631	75723863	MACS_peak_7813	124.31	232	0	2	0
16	75737614	75738023	MACS_peak_7814	71.7	409	0	1	0
16	80974665	80974837	MACS_peak_7861	983.72	172	0	1	0
16	81035585	81035860	MACS_peak_7862	711.8	275	1	1	0
16	81086060	81086312	MACS_peak_7863	369.08	252	1	2	0
16	84726071	84726315	MACS_peak_7905	596.07	244	0	1	0
16	84738513	84738992	MACS_peak_7906	422.76	479	0	1	0
16	84746858	84747117	MACS_peak_7907	1448.62	259	0	1	0
16	84754456	84754655	MACS_peak_7908	645.81	199	0	1	0
16	85253254	85253552	MACS_peak_7910	565.28	298	0	1	0
16	85275725	85276047	MACS_peak_7911	549.27	322	0	1	0
16	85409308	85409671	MACS_peak_7912	339.96	363	0	1	0
16	85420776	85421084	MACS_peak_7913	815.17	308	0	1	0
16	85610566	85610909	MACS_peak_7914	658.44	343	0	1	0
16	85901922	85902055	MACS_peak_7917	1291.76	133	1	0	0
16	86563655	86564107	MACS_peak_7926	1352.74	452	1	0	0
16	87394543	87394845	MACS_peak_7933	562.53	302	0	1	0
16	87420686	87420941	MACS_peak_7934	470.06	255	0	1	0
16	89333858	89334184	MACS_peak_7952	312.33	326	0	1	0
16	89557414	89557754	MACS_peak_7953	421.18	340	1	1	0
16	89641318	89641544	MACS_peak_7955	548.55	226	1	0	0
16	90019514	90019817	MACS_peak_7960	561.84	303	1	1	0
17	412285	412579	MACS_peak_7972	446.16	294	1	0	1
17	592343	592651	MACS_peak_7974	77.98	308	0	1	0
17	599398	599752	MACS_peak_7975	84.4	354	0	1	0
17	636867	637262	MACS_peak_7976	57.86	395	0	1	0
17	649094	649550	MACS_peak_7977	590.18	456	0	1	0
17	700580	700885	MACS_peak_7978	439.84	305	0	1	0
17	1354960	1355274	MACS_peak_7983	710.55	314	0	1	0
17	1365475	1365721	MACS_peak_7984	763.02	246	0	1	0
17	1720840	1721061	MACS_peak_7985	729.14	221	1	0	0
17	3647880	3648089	MACS_peak_7993	780.06	209	0	1	0
17	3788623	3788858	MACS_peak_7994	213.21	235	0	1	0
17	4304533	4304821	MACS_peak_7995	890.5	288	0	1	0
17	4889092	4889312	MACS_peak_7999	394.77	220	0	1	0
17	5439114	5439467	MACS_peak_8000	1179.44	353	1	1	0
17	7913000	7913231	MACS_peak_8014	1491.86	231	1	0	0
17	8138641	8138815	MACS_peak_8017	780.06	174	1	0	0
17	8157352	8157727	MACS_peak_8018	404.42	375	1	1	0
17	9554890	9555065	MACS_peak_8025	1760.85	175	0	1	1
17	9559581	9559819	MACS_peak_8026	375.48	238	0	1	0
17	10683906	10684162	MACS_peak_8036	470.06	256	0	1	0
17	12103033	12103222	MACS_peak_8044	883.81	189	0	1	0
17	14203493	14203676	MACS_peak_8056	729.14	183	0	1	0
17	15248193	15248485	MACS_peak_8059	447.34	292	0	1	0
17	15502893	15503114	MACS_peak_8061	729.14	221	1	2	0
17	18094013	18094276	MACS_peak_8074	722.6	263	0	1	0
17	19766509	19766796	MACS_peak_8089	450.32	287	1	0	0
17	21020233	21020435	MACS_peak_8100	2606.56	202	0	1	0
17	21129112	21129459	MACS_peak_8103	404.48	347	0	1	0
17	28548200	28548401	MACS_peak_8138	645.81	201	1	1	0
17	28719542	28719929	MACS_peak_8139	511.42	387	2	0	0
17	28726876	28727098	MACS_peak_8140	564.54	222	2	0	0
17	28750117	28750341	MACS_peak_8141	564.54	224	0	1	0
17	28903062	28903351	MACS_peak_8142	449.12	289	1	0	0
17	28916395	28916679	MACS_peak_8143	442.3	284	0	1	0
17	29252195	29252630	MACS_peak_8146	601.44	435	1	1	0
17	29274779	29275007	MACS_peak_8147	848.95	228	0	1	0
17	31949569	31949783	MACS_peak_8153	1007.79	214	0	1	0
17	39271012	39271270	MACS_peak_8184	458.45	258	0	1	0
17	39485058	39485430	MACS_peak_8185	614.03	372	0	1	0
17	41801659	41801867	MACS_peak_8199	1108.27	208	1	0	0
17	41985418	41985550	MACS_peak_8200	1116.4	132	0	1	0
17	42144922	42145150	MACS_peak_8201	519.64	228	0	2	0
17	43222929	43223267	MACS_peak_8206	522.76	338	0	1	0
17	43483568	43483891	MACS_peak_8209	488.85	323	1	0	0
17	43576719	43576944	MACS_peak_8210	548.55	225	0	2	0
17	46286708	46287045	MACS_peak_8222	359.79	337	0	1	0
17	46641935	46642167	MACS_peak_8223	532.66	232	0	1	0
17	46642378	46642591	MACS_peak_8224	596.79	213	0	1	0
17	47946919	47947190	MACS_peak_8238	1102.85	271	0	1	2
17	48074322	48074646	MACS_peak_8243	399.92	324	1	0	0
17	48080300	48080516	MACS_peak_8244	683.05	216	0	1	0
17	48097639	48097838	MACS_peak_8245	624.41	199	0	1	0
17	48131351	48131560	MACS_peak_8246	876.89	209	1	0	0
17	48153712	48154064	MACS_peak_8247	2153.35	352	0	1	0
17	48259750	48260086	MACS_peak_8248	764.45	336	0	1	0
17	48262904	48263369	MACS_peak_8249	1489.77	465	0	1	0
17	48307873	48308194	MACS_peak_8250	611.86	321	0	1	1
17	48351908	48352205	MACS_peak_8251	380.3	297	0	1	0
17	48374668	48374962	MACS_peak_8252	446.16	294	0	1	0
17	48585393	48585666	MACS_peak_8255	458.95	273	0	1	1
17	48593822	48594303	MACS_peak_8256	577.46	481	2	1	1
17	48940060	48940206	MACS_peak_8265	387.38	146	0	1	0
17	49290783	49291083	MACS_peak_8271	1175.7	300	1	0	0
17	49315432	49315840	MACS_peak_8272	643.45	408	0	1	0
17	49407907	49408348	MACS_peak_8274	1095.16	441	1	0	1
17	49708311	49708693	MACS_peak_8280	1149.5	382	1	1	0
17	50079717	50079925	MACS_peak_8283	594.99	208	0	1	0
17	50085977	50086359	MACS_peak_8284	547.82	382	0	1	0
17	50139965	50140204	MACS_peak_8285	797.18	239	0	1	1
17	50198298	50198692	MACS_peak_8286	1137.79	394	0	1	0
17	50200448	50200776	MACS_peak_8287	427.34	328	0	1	0
17	50482490	50482891	MACS_peak_8289	522.55	401	1	0	0
17	51056849	51057070	MACS_peak_8294	767.82	221	0	1	1
17	51113674	51114037	MACS_peak_8295	389.8	363	0	1	0
17	51153234	51153546	MACS_peak_8296	486.01	312	2	0	0
17	54993158	54993341	MACS_peak_8337	597.36	183	0	1	0
17	55023815	55023957	MACS_peak_8338	2062.26	142	0	1	0
17	55034239	55034495	MACS_peak_8339	576.65	256	0	1	0
17	55053922	55054184	MACS_peak_8340	397.45	262	0	1	0
17	55094167	55094372	MACS_peak_8341	573.39	205	0	1	0
17	57833331	57833645	MACS_peak_8386	1600.31	314	1	0	1
17	57857949	57858213	MACS_peak_8387	1408.55	264	1	0	0
17	57875445	57875793	MACS_peak_8388	380.3	348	0	1	0
17	57892404	57892777	MACS_peak_8389	572.27	373	0	1	0
17	57938951	57939291	MACS_peak_8390	348.12	340	0	1	0
17	58351155	58351387	MACS_peak_8398	504.09	232	1	2	1
17	58562383	58562667	MACS_peak_8402	360.32	284	0	1	0
17	58587669	58587974	MACS_peak_8404	2291.8	305	0	1	0
17	58591291	58591753	MACS_peak_8405	727.52	462	0	1	0
17	58629101	58629484	MACS_peak_8406	350.24	383	0	1	0
17	58631591	58631924	MACS_peak_8407	217.28	333	0	1	0
17	58659011	58659378	MACS_peak_8408	272.61	367	1	1	0
17	58667866	58668024	MACS_peak_8409	664.76	158	0	2	0
17	58995399	58995626	MACS_peak_8423	629.32	227	0	1	0
17	59003404	59003742	MACS_peak_8424	396.63	338	0	1	0
17	59003919	59004210	MACS_peak_8425	222.55	291	0	1	0
17	59038715	59038900	MACS_peak_8427	308.59	185	0	1	0
17	59061423	59061791	MACS_peak_8429	158.24	368	0	1	0
17	59072966	59073262	MACS_peak_8430	162.76	296	0	1	0
17	59076069	59076303	MACS_peak_8431	290.02	234	0	1	0
17	59087603	59087840	MACS_peak_8433	186.7	237	0	1	0
17	59091361	59091804	MACS_peak_8434	356.5	443	0	1	0
17	59097268	59097568	MACS_peak_8435	86.12	300	0	1	0
17	59101020	59101152	MACS_peak_8436	511.39	132	0	1	0
17	59569937	59570343	MACS_peak_8446	832.63	406	1	0	0
17	59574260	59574682	MACS_peak_8447	87.91	422	0	1	0
17	59592253	59592552	MACS_peak_8448	147.3	299	0	1	0
17	59855498	59855874	MACS_peak_8461	114.09	376	1	0	0
17	59857379	59857611	MACS_peak_8462	170.22	232	1	0	0
17	59874709	59875089	MACS_peak_8465	166.6	380	0	1	0
17	59909145	59909299	MACS_peak_8466	508.47	154	0	1	0
17	59918663	59918851	MACS_peak_8468	634.81	188	0	1	0
17	59929362	59929710	MACS_peak_8469	120.35	348	0	1	0
17	59938059	59938495	MACS_peak_8470	100.62	436	1	1	0
17	59941205	59941430	MACS_peak_8471	309.39	225	1	1	0
17	60059593	60059953	MACS_peak_8478	137.66	360	0	1	0
17	60068608	60069062	MACS_peak_8479	181.44	454	0	1	0
17	60174633	60175035	MACS_peak_8485	1578.28	402	1	0	0
17	60188293	60188651	MACS_peak_8486	117.9	358	0	1	0
17	60216260	60216640	MACS_peak_8487	74.78	380	0	1	0
17	60229432	60229780	MACS_peak_8488	690.03	348	0	1	0
17	60230183	60230567	MACS_peak_8489	146.15	384	0	1	0
17	60242299	60242506	MACS_peak_8491	211.96	207	0	1	0
17	60254691	60255065	MACS_peak_8493	206.31	374	0	1	0
17	60256426	60256803	MACS_peak_8494	106.43	377	0	1	0
17	60256897	60257131	MACS_peak_8495	174.8	234	0	1	1
17	60281903	60282350	MACS_peak_8496	125.63	447	0	1	0
17	60283139	60283505	MACS_peak_8497	103.45	366	0	1	0
17	60283863	60284101	MACS_peak_8498	415.7	238	0	1	0
17	60284921	60285262	MACS_peak_8499	93.4	341	0	1	0
17	60288113	60288341	MACS_peak_8500	451.74	228	0	1	0
17	60319219	60319553	MACS_peak_8502	84.4	334	0	1	0
17	60329677	60330057	MACS_peak_8503	343.7	380	0	1	0
17	60346663	60347143	MACS_peak_8504	329.83	480	0	1	0
17	60358846	60359214	MACS_peak_8505	181.4	368	0	1	0
17	60362801	60363036	MACS_peak_8506	167.64	235	0	1	0
17	60373331	60373464	MACS_peak_8507	625.5	133	0	1	0
17	60392222	60392545	MACS_peak_8508	221.26	323	1	1	0
17	60420082	60420422	MACS_peak_8509	171.96	340	0	2	0
17	60421294	60421596	MACS_peak_8510	186.16	302	0	2	0
17	60447739	60447871	MACS_peak_8513	517.86	132	1	0	0
17	60462946	60463283	MACS_peak_8514	126.47	337	0	1	0
17	60463322	60463628	MACS_peak_8515	195.04	306	0	1	0
17	60517657	60518050	MACS_peak_8516	137.55	393	0	1	0
17	60519664	60519932	MACS_peak_8517	651.39	268	0	1	0
17	60610205	60610461	MACS_peak_8524	151	256	0	1	0
17	60638695	60639174	MACS_peak_8525	3100	479	0	1	0
17	60640026	60640283	MACS_peak_8526	198.02	257	0	1	0
17	60641806	60642219	MACS_peak_8528	960.88	413	0	1	0
17	60647378	60647592	MACS_peak_8529	176.28	214	0	1	0
17	60656576	60656789	MACS_peak_8530	185.02	213	0	1	0
17	60656910	60657305	MACS_peak_8531	480.11	395	0	1	0
17	60660222	60660591	MACS_peak_8532	112.17	369	0	1	0
17	61676846	61677289	MACS_peak_8642	64.68	443	1	0	0
17	61678138	61678510	MACS_peak_8643	92.17	372	1	0	0
17	61680291	61680610	MACS_peak_8644	93.82	319	1	0	0
17	61687279	61687725	MACS_peak_8645	371.68	446	0	1	0
17	61688394	61688754	MACS_peak_8646	58.9	360	0	1	0
17	61697223	61697702	MACS_peak_8648	66.39	479	0	1	0
17	61713130	61713524	MACS_peak_8650	133.25	394	0	1	0
17	61714970	61715358	MACS_peak_8651	62.5	388	0	1	0
17	61723088	61723523	MACS_peak_8652	105.42	435	0	1	0
17	61729731	61730135	MACS_peak_8653	417.23	404	0	1	0
17	61730612	61730911	MACS_peak_8654	51.77	299	0	1	0
17	61744118	61744480	MACS_peak_8655	50.92	362	0	1	0
17	61745751	61745975	MACS_peak_8656	290.28	224	0	1	0
17	61748872	61749148	MACS_peak_8657	61.68	276	0	1	0
17	61757174	61757512	MACS_peak_8659	133.59	338	0	1	0
17	61765936	61766296	MACS_peak_8661	54.82	360	0	1	0
17	61768363	61768757	MACS_peak_8662	70.01	394	0	1	0
17	61783074	61783369	MACS_peak_8664	80.61	295	0	1	0
17	61783902	61784235	MACS_peak_8665	72.43	333	0	1	0
17	61803488	61803731	MACS_peak_8667	153.99	243	0	1	0
17	61810772	61811145	MACS_peak_8668	67.08	373	0	1	0
17	61811284	61811605	MACS_peak_8669	54.52	321	0	1	0
17	61813045	61813403	MACS_peak_8670	73.11	358	0	1	0
17	61819330	61819706	MACS_peak_8671	50.79	376	0	1	0
17	61824308	61824760	MACS_peak_8673	62.57	452	0	1	0
17	61825506	61825826	MACS_peak_8674	74.54	320	0	1	0
17	61826334	61826774	MACS_peak_8675	52.06	440	0	1	0
17	61829574	61829949	MACS_peak_8676	60.82	375	0	1	0
17	61837918	61838231	MACS_peak_8678	145.8	313	0	1	0
17	61840595	61840909	MACS_peak_8680	68.03	314	0	1	0
17	61843309	61843668	MACS_peak_8681	55.04	359	0	1	0
17	61847914	61848290	MACS_peak_8682	56.1	376	0	1	0
17	61849703	61850100	MACS_peak_8684	81.33	397	0	1	0
17	61853135	61853420	MACS_peak_8685	67.31	285	0	1	0
17	61863604	61863946	MACS_peak_8686	72.36	342	1	0	0
17	61865299	61865736	MACS_peak_8687	187.59	437	1	0	0
17	61875561	61875809	MACS_peak_8688	97.98	248	0	1	0
17	61878674	61879056	MACS_peak_8689	62.39	382	0	1	0
17	61879394	61879827	MACS_peak_8690	150.9	433	0	1	0
17	61880708	61881009	MACS_peak_8691	83.91	301	0	1	0
17	61891949	61892310	MACS_peak_8692	100.3	361	0	1	0
17	61893087	61893396	MACS_peak_8693	76.3	309	0	1	0
17	61906959	61907094	MACS_peak_8695	753.78	135	0	1	0
17	61908343	61908736	MACS_peak_8696	67.53	393	0	1	0
17	61992198	61992575	MACS_peak_8697	342.79	377	0	1	0
17	62030622	62030866	MACS_peak_8699	491.61	244	0	1	0
17	62421392	62421871	MACS_peak_8708	2036.87	479	1	0	0
17	62421988	62422294	MACS_peak_8709	233.14	306	1	0	0
17	62423683	62423963	MACS_peak_8710	334.08	280	1	0	0
17	62484116	62484332	MACS_peak_8711	1396.66	216	0	1	0
17	62484836	62485248	MACS_peak_8712	2259.35	412	0	1	0
17	62553056	62553446	MACS_peak_8713	1258.57	390	0	1	0
17	62592684	62592969	MACS_peak_8714	398.02	285	0	1	0
17	63688767	63689011	MACS_peak_8738	483.55	244	0	2	0
17	63697911	63698170	MACS_peak_8739	594.37	259	2	1	0
17	63809780	63810025	MACS_peak_8740	986.28	245	0	1	0
17	64473346	64473478	MACS_peak_8761	940.81	132	1	0	0
17	64480337	64480638	MACS_peak_8762	790.81	301	1	0	0
17	64492581	64492799	MACS_peak_8764	666.39	218	0	1	0
17	64507448	64507801	MACS_peak_8765	611.86	353	1	1	0
17	64514415	64514762	MACS_peak_8766	1129.64	347	0	1	0
17	64540658	64540794	MACS_peak_8767	927.9	136	1	1	0
17	65027243	65027599	MACS_peak_8779	1091.17	356	0	1	0
17	67195832	67195974	MACS_peak_8818	921.89	142	0	1	0
17	67200729	67201043	MACS_peak_8819	322.23	314	0	1	0
17	67359898	67360112	MACS_peak_8821	460.03	214	0	1	0
17	67717692	67717989	MACS_peak_8831	626.7	297	1	0	0
17	67825308	67825565	MACS_peak_8834	714.38	257	1	0	0
17	67891813	67892260	MACS_peak_8835	1617	447	0	1	0
17	67942865	67943071	MACS_peak_8836	655.89	206	0	1	0
17	67953862	67954086	MACS_peak_8837	86.67	224	0	1	0
17	67963280	67963650	MACS_peak_8838	911.5	370	0	1	0
17	68263146	68263347	MACS_peak_8845	478.76	201	2	0	0
17	68410865	68411260	MACS_peak_8846	87.49	395	0	1	0
17	68436481	68436685	MACS_peak_8847	617.05	204	0	1	1
17	68972197	68972514	MACS_peak_8860	731.28	317	1	0	1
17	69085062	69085457	MACS_peak_8862	825.48	395	0	1	0
17	69138762	69138984	MACS_peak_8863	103.93	222	0	1	0
17	73310853	73311235	MACS_peak_8909	401.26	382	0	1	0
17	74791471	74791762	MACS_peak_8915	549.74	291	0	1	0
17	75105889	75106114	MACS_peak_8916	529.68	225	1	1	0
17	75201808	75202112	MACS_peak_8917	488.85	304	1	0	0
17	75323091	75323362	MACS_peak_8918	599.17	271	0	1	0
17	75404247	75404629	MACS_peak_8919	1320.51	382	0	1	0
17	75504212	75504542	MACS_peak_8921	928.77	330	1	0	0
17	75515679	75516087	MACS_peak_8922	616.76	408	1	0	0
17	75625906	75626236	MACS_peak_8925	1642.21	330	1	1	0
17	75632955	75633204	MACS_peak_8926	1162.47	249	1	1	0
17	75633794	75634087	MACS_peak_8927	828.97	293	1	1	0
17	75653031	75653250	MACS_peak_8928	528	219	0	1	0
17	75674928	75675209	MACS_peak_8929	460.95	281	0	1	0
17	75778977	75779166	MACS_peak_8932	616.5	189	1	0	0
17	75783440	75783688	MACS_peak_8933	1399.91	248	1	1	0
17	75792110	75792406	MACS_peak_8934	810.4	296	0	1	0
17	76062424	76062732	MACS_peak_8935	1576.26	308	0	1	0
17	76398044	76398364	MACS_peak_8936	550.56	320	0	1	0
17	78422051	78422433	MACS_peak_8948	388.11	382	1	1	0
17	78745455	78745693	MACS_peak_8950	662.31	238	0	1	0
17	79960595	79960814	MACS_peak_8956	901.33	219	0	1	0
17	79991744	79991938	MACS_peak_8957	678.9	194	0	1	0
17	80005783	80006062	MACS_peak_8958	455.19	279	0	1	0
17	80548071	80548414	MACS_peak_8961	419.68	343	1	0	0
17	80575402	80575594	MACS_peak_8962	866.35	192	0	1	0
17	80672259	80672489	MACS_peak_8963	429.38	230	0	1	0
17	80740639	80740937	MACS_peak_8964	960.47	298	0	1	0
17	81200911	81201149	MACS_peak_8966	516.86	238	0	1	0
17	82021198	82021436	MACS_peak_8970	662.31	238	2	0	0
17	82424497	82424939	MACS_peak_8971	964.62	442	0	1	0
17	82551819	82552087	MACS_peak_8972	442.05	268	0	1	0
17	82777869	82778128	MACS_peak_8973	953.02	259	0	1	0
17	82781811	82782005	MACS_peak_8974	1434.33	194	0	1	0
18	171006	171251	MACS_peak_8991	629.38	245	0	1	0
18	730101	730397	MACS_peak_8995	438.73	296	0	1	0
18	2541999	2542346	MACS_peak_9009	843.52	347	1	0	0
18	2692486	2692707	MACS_peak_9010	564.54	221	0	1	1
18	3246135	3246338	MACS_peak_9011	814.37	203	1	0	1
18	9549383	9549770	MACS_peak_9036	511.42	387	1	0	0
18	9951360	9951542	MACS_peak_9037	729.14	182	0	1	0
18	12333048	12333422	MACS_peak_9050	518.44	374	1	1	0
18	12827756	12828134	MACS_peak_9052	403.06	378	0	1	0
18	13003452	13003657	MACS_peak_9053	797.18	205	0	1	0
18	13031110	13031266	MACS_peak_9054	840.92	156	0	1	0
18	20958793	20959235	MACS_peak_9077	1094.3	442	0	1	0
18	20972026	20972277	MACS_peak_9078	485.56	251	0	1	0
18	21591605	21591991	MACS_peak_9079	89.02	386	0	1	0
18	21738805	21738957	MACS_peak_9080	446.36	152	0	1	0
18	21805889	21806031	MACS_peak_9081	877.38	142	0	1	0
18	23248503	23248644	MACS_peak_9097	676.31	141	0	2	0
18	23565733	23566021	MACS_peak_9098	681.96	288	0	1	0
18	24176841	24177137	MACS_peak_9099	826.15	296	0	1	0
18	24186905	24187039	MACS_peak_9100	877.68	134	0	1	0
18	24315612	24315863	MACS_peak_9101	746.04	251	0	1	0
18	31506292	31506616	MACS_peak_9143	338.74	324	0	1	0
18	36133793	36133929	MACS_peak_9165	753.52	136	1	0	0
18	36136822	36137145	MACS_peak_9166	845.32	323	0	1	0
18	37027744	37028126	MACS_peak_9172	76.3	382	0	1	0
18	37053873	37054076	MACS_peak_9173	814.37	203	0	1	0
18	37075318	37075727	MACS_peak_9174	69.67	409	0	1	0
18	37076432	37076850	MACS_peak_9175	70.01	418	0	1	0
18	37078545	37078821	MACS_peak_9176	125.63	276	0	1	0
18	37215080	37215356	MACS_peak_9177	107.89	276	0	1	0
18	45910457	45910796	MACS_peak_9218	421.69	339	0	1	0
18	46044462	46044714	MACS_peak_9220	108.7	252	0	1	0
18	46044785	46045195	MACS_peak_9221	85.66	410	0	1	0
18	46081430	46081785	MACS_peak_9222	269.22	355	1	0	0
18	46195469	46195694	MACS_peak_9223	346.64	225	0	1	0
18	49219087	49219423	MACS_peak_9236	57.49	336	0	1	0
18	49292572	49292955	MACS_peak_9238	678.93	383	0	1	0
18	49447902	49448114	MACS_peak_9240	596.79	212	0	1	0
18	50043267	50043674	MACS_peak_9243	584.98	407	0	1	0
18	51173818	51173950	MACS_peak_9245	1116.4	132	1	0	0
18	54728799	54729012	MACS_peak_9259	671.02	213	0	1	0
18	54769673	54769884	MACS_peak_9260	596.79	211	0	1	0
18	56716026	56716162	MACS_peak_9267	1061.85	136	0	1	0
18	56869131	56869444	MACS_peak_9268	435.38	313	0	1	0
18	57721664	57722031	MACS_peak_9271	84.48	367	0	1	1
18	57723292	57723603	MACS_peak_9272	72.19	311	0	1	1
18	58262435	58262651	MACS_peak_9273	746.04	216	0	1	0
18	62052374	62052713	MACS_peak_9290	220.21	339	0	1	0
18	62183627	62183927	MACS_peak_9291	1387.53	300	1	1	0
18	62584353	62584612	MACS_peak_9292	468.05	259	0	1	0
18	62911236	62911681	MACS_peak_9295	87.54	445	0	1	0
18	62911864	62912091	MACS_peak_9296	164.16	227	0	1	0
18	74751826	74752169	MACS_peak_9337	149.97	343	0	1	0
18	79287494	79287786	MACS_peak_9346	62.38	292	0	1	0
18	79287817	79288155	MACS_peak_9347	57.94	338	0	1	0
19	1194579	1194950	MACS_peak_9361	262.11	371	0	1	0
19	1813030	1813193	MACS_peak_9364	848.95	163	1	0	0
19	3021062	3021224	MACS_peak_9367	270.22	162	0	1	0
19	3545169	3545442	MACS_peak_9368	458.95	273	0	1	1
19	4352504	4352913	MACS_peak_9373	616.18	409	0	1	1
19	10000237	10000504	MACS_peak_9393	843.52	267	0	1	0
19	10388884	10389170	MACS_peak_9397	450.92	286	1	0	0
19	10404195	10404569	MACS_peak_9398	404.88	374	0	1	0
19	10413596	10413847	MACS_peak_9399	272.3	251	1	1	0
19	10551698	10551831	MACS_peak_9401	1396.21	133	1	1	0
19	10581053	10581363	MACS_peak_9402	803.33	310	0	1	0
19	11939141	11939451	MACS_peak_9408	102.5	310	0	2	0
19	12394068	12394276	MACS_peak_9410	613.04	208	2	1	0
19	12676353	12676635	MACS_peak_9413	453.35	282	1	1	0
19	12796642	12797039	MACS_peak_9416	871.49	397	1	1	0
19	15264161	15264409	MACS_peak_9432	901.33	248	0	1	0
19	15278366	15278681	MACS_peak_9433	312.33	315	0	1	0
19	15302654	15302801	MACS_peak_9434	1836.32	147	0	1	0
19	18279491	18279773	MACS_peak_9451	705.71	282	1	0	0
19	19342746	19343074	MACS_peak_9455	545.46	328	0	1	0
19	19724567	19724922	MACS_peak_9458	71.69	355	0	1	0
19	19869659	19869792	MACS_peak_9460	877.68	133	1	0	0
19	19919832	19920135	MACS_peak_9461	60.7	303	0	1	0
19	19920989	19921210	MACS_peak_9462	140.69	221	0	1	0
19	19959365	19959586	MACS_peak_9463	492.22	221	0	1	0
19	20628016	20628236	MACS_peak_9465	227.1	220	0	1	1
19	21718560	21718692	MACS_peak_9471	963	132	1	0	0
19	21722547	21722840	MACS_peak_9472	132.1	293	1	0	0
19	22476433	22476775	MACS_peak_9475	380.3	342	0	1	0
19	23362291	23362544	MACS_peak_9479	378.3	253	0	1	0
19	37021808	37021971	MACS_peak_9566	772.28	163	0	1	0
19	37120130	37120571	MACS_peak_9567	129.96	441	0	3	0
19	38930301	38930545	MACS_peak_9578	629.38	244	1	2	0
19	39443973	39444314	MACS_peak_9580	216.22	341	0	1	0
19	39881548	39881855	MACS_peak_9583	685.18	307	0	1	0
19	44095210	44095482	MACS_peak_9616	584.2	272	1	0	0
19	44224816	44225123	MACS_peak_9617	129.01	307	1	1	0
19	44415352	44415722	MACS_peak_9619	383.44	370	1	0	1
19	44667525	44667833	MACS_peak_9621	424.89	308	0	1	1
19	44951585	44951870	MACS_peak_9625	574.52	285	1	0	1
19	46728830	46729085	MACS_peak_9644	470.06	255	0	1	1
19	46840595	46840747	MACS_peak_9646	1965.34	152	1	0	0
19	47367325	47367621	MACS_peak_9653	170.16	296	0	1	0
19	48187390	48187712	MACS_peak_9696	413.88	322	0	2	0
19	48320105	48320319	MACS_peak_9698	596.79	214	1	1	0
19	48993218	48993580	MACS_peak_9702	410.45	362	1	0	0
19	48999729	49000179	MACS_peak_9703	622.87	450	0	1	0
19	49821817	49821949	MACS_peak_9706	771.26	132	1	0	0
19	51016751	51017099	MACS_peak_9745	912.29	348	1	0	0
19	52047721	52047938	MACS_peak_9754	553.1	217	0	1	0
19	53189856	53190159	MACS_peak_9756	1232.34	303	0	1	0
19	54172924	54173286	MACS_peak_9761	410.92	362	1	0	0
19	54580430	54580744	MACS_peak_9763	183.74	314	0	1	0
19	55632401	55632742	MACS_peak_9769	659.85	341	2	0	0
19	56396244	56396572	MACS_peak_9773	429.01	328	1	0	1
19	58513933	58514161	MACS_peak_9778	695.57	228	1	0	0
19	58519003	58519241	MACS_peak_9779	516.86	238	0	1	0
20	2506039	2506401	MACS_peak_11676	72.08	362	0	2	0
20	2910206	2910637	MACS_peak_11678	306.6	431	0	1	0
20	3494337	3494614	MACS_peak_11679	250.69	277	0	1	0
20	3496247	3496668	MACS_peak_11680	108.17	421	0	1	0
20	3513723	3513988	MACS_peak_11681	56.38	265	0	1	0
20	3563662	3563991	MACS_peak_11682	426.82	329	0	1	0
20	3630832	3631057	MACS_peak_11683	442.71	225	0	1	0
20	3753100	3753289	MACS_peak_11684	695.57	189	1	0	0
20	4008258	4008553	MACS_peak_11685	567.38	295	0	1	0
20	6011560	6011709	MACS_peak_11691	843.6	149	0	1	0
20	7980709	7981026	MACS_peak_11699	552.5	317	1	0	0
20	8661893	8662287	MACS_peak_11701	873.84	394	0	1	0
20	8759524	8759906	MACS_peak_11702	603.02	382	0	1	0
20	8790537	8790783	MACS_peak_11703	927.9	246	0	1	0
20	8853889	8854083	MACS_peak_11704	778.31	194	0	1	0
20	13436978	13437388	MACS_peak_11733	60	410	0	1	0
20	13458815	13459186	MACS_peak_11734	763.88	371	0	1	0
20	13483671	13483882	MACS_peak_11735	386.13	211	0	1	0
20	13788273	13788427	MACS_peak_11736	918.92	154	1	0	0
20	18537247	18537546	MACS_peak_11768	265.34	299	0	1	0
20	20054006	20054140	MACS_peak_11786	1666.76	134	1	1	0
20	24552963	24553253	MACS_peak_11823	89.02	290	0	1	0
20	24554914	24555335	MACS_peak_11824	84.14	421	0	1	0
20	25262992	25263438	MACS_peak_11829	86.87	446	0	1	0
20	25332673	25333045	MACS_peak_11830	67.63	372	0	1	0
20	25383850	25384089	MACS_peak_11831	513.53	239	0	1	0
20	31927110	31927312	MACS_peak_11874	705.57	202	0	1	0
20	32790112	32790430	MACS_peak_11880	432.66	318	0	1	0
20	34874145	34874342	MACS_peak_11888	831.63	197	1	0	0
20	35713652	35713789	MACS_peak_11893	1081.35	137	0	1	0
20	35954426	35954782	MACS_peak_11895	413.31	356	2	0	0
20	37368439	37368642	MACS_peak_11900	343.13	203	0	1	0
20	37384743	37384991	MACS_peak_11901	1208.41	248	0	1	0
20	38512188	38512424	MACS_peak_11908	465.7	236	0	1	0
20	38751330	38751685	MACS_peak_11909	529.16	355	1	0	0
20	41411505	41411742	MACS_peak_11929	516.86	237	0	1	0
20	41571134	41571401	MACS_peak_11930	391.8	267	0	1	0
20	41571994	41572307	MACS_peak_11931	429.13	313	0	1	0
20	45373958	45374113	MACS_peak_11973	1134.69	155	1	2	0
20	45422880	45423092	MACS_peak_11974	423.63	212	0	1	0
20	45446030	45446197	MACS_peak_11975	814.37	167	0	1	1
20	45799222	45799466	MACS_peak_11980	409.44	244	0	1	0
20	49065208	49065347	MACS_peak_12071	471.15	139	0	1	0
20	49082684	49083032	MACS_peak_12072	480.06	348	0	1	0
20	49132946	49133243	MACS_peak_12073	565.98	297	0	1	0
20	49858144	49858392	MACS_peak_12080	763.02	248	0	1	0
20	49888465	49888806	MACS_peak_12081	659.85	341	0	1	0
20	49943768	49943908	MACS_peak_12083	1345.15	140	0	1	0
20	50085439	50085720	MACS_peak_12087	925.1	281	2	0	0
20	50929307	50929720	MACS_peak_12126	968.33	413	0	1	0
20	51594946	51595390	MACS_peak_12135	388.99	444	1	0	0
20	51624362	51624600	MACS_peak_12136	415.95	238	0	1	0
20	51700801	51701070	MACS_peak_12137	1091.86	269	0	1	0
20	51704091	51704310	MACS_peak_12138	566.67	219	0	1	0
20	51712505	51712776	MACS_peak_12139	777.55	271	0	1	0
20	52083749	52083958	MACS_peak_12143	525.79	209	0	1	0
20	52150599	52151039	MACS_peak_12144	717.1	440	0	1	0
20	54207693	54207989	MACS_peak_12267	3100	296	1	0	0
20	54214769	54215075	MACS_peak_12269	118.28	306	0	1	0
20	54224193	54224327	MACS_peak_12271	514.05	134	0	1	0
20	56400108	56400336	MACS_peak_12358	465.76	228	0	1	0
20	56505631	56506022	MACS_peak_12359	594.54	391	0	2	0
20	56516133	56516556	MACS_peak_12360	611.86	423	1	2	0
20	57346420	57346691	MACS_peak_12397	1183.08	271	1	0	0
20	58403100	58403341	MACS_peak_12416	208.93	241	0	1	0
20	58447699	58448169	MACS_peak_12417	812.61	470	0	1	0
20	58650547	58650935	MACS_peak_12420	1857.04	388	2	0	0
20	59222426	59222791	MACS_peak_12429	409.04	365	0	1	0
20	59234686	59234941	MACS_peak_12430	506	255	0	1	0
20	61981123	61981285	MACS_peak_12468	1320.51	162	0	1	0
20	62010900	62011120	MACS_peak_12469	564.54	220	0	1	0
20	62136887	62137168	MACS_peak_12470	1192.27	281	1	0	0
20	62156858	62157188	MACS_peak_12471	426.3	330	0	1	0
20	62260264	62260643	MACS_peak_12472	402.61	379	0	1	0
20	62270687	62271076	MACS_peak_12473	202.06	389	0	1	0
20	62302632	62302849	MACS_peak_12474	580.62	217	1	0	0
20	62791573	62791805	MACS_peak_12476	1824.95	232	1	0	0
20	62808319	62808561	MACS_peak_12477	645.81	242	1	0	0
20	62900203	62900525	MACS_peak_12479	802.9	322	0	1	0
20	62900776	62901115	MACS_peak_12480	421.69	339	0	1	0
20	62907439	62907645	MACS_peak_12481	629.38	206	0	1	0
20	63614270	63614524	MACS_peak_12489	629.32	254	0	1	0
20	63706798	63707167	MACS_peak_12490	640.87	369	2	1	0
20	63909644	63909936	MACS_peak_12491	634.74	292	0	1	0
21	25591074	25591210	MACS_peak_12657	1061.85	136	0	1	0
21	31683944	31684175	MACS_peak_12690	532.66	231	0	1	0
21	32601128	32601313	MACS_peak_12692	1348.66	185	0	2	0
21	32653360	32653582	MACS_peak_12693	712.32	222	0	1	0
21	33605689	33606087	MACS_peak_12697	381.26	398	0	2	0
21	33701990	33702233	MACS_peak_12698	333.51	243	0	2	0
21	36388368	36388596	MACS_peak_12715	675.78	228	1	0	0
21	39244769	39244955	MACS_peak_12732	421.25	186	0	1	0
21	39248547	39248784	MACS_peak_12733	511.17	237	0	1	0
21	43789245	43789578	MACS_peak_12765	793.64	333	1	0	0
21	43907014	43907157	MACS_peak_12767	2712.67	143	0	1	0
21	43975580	43975856	MACS_peak_12768	845.51	276	0	1	0
21	44793259	44793626	MACS_peak_12772	394.93	367	0	1	0
21	44800180	44800438	MACS_peak_12773	468.72	258	0	1	0
21	45270236	45270473	MACS_peak_12777	498.83	237	0	1	0
21	46147417	46147762	MACS_peak_12784	1329.55	345	0	1	0
21	46285548	46285894	MACS_peak_12785	325.68	346	1	1	0
22	18076134	18076328	MACS_peak_12819	678.9	194	1	0	0
22	19037038	19037233	MACS_peak_12836	662.31	195	1	0	0
22	19947829	19948061	MACS_peak_12837	514.21	232	0	1	0
22	20317648	20317932	MACS_peak_12839	575.25	284	1	0	0
22	20460511	20460655	MACS_peak_12849	2638.81	144	0	1	0
22	20496427	20496694	MACS_peak_12850	462.79	267	1	0	0
22	20564217	20564577	MACS_peak_12851	488.85	360	0	1	0
22	20741940	20742253	MACS_peak_12852	638.96	313	0	1	0
22	20813763	20814081	MACS_peak_12853	432.66	318	0	1	0
22	21773330	21773602	MACS_peak_12861	265.34	272	0	1	0
22	23178489	23178702	MACS_peak_12877	1453.47	213	1	0	0
22	24064427	24064842	MACS_peak_12883	115.17	415	0	1	0
22	25129652	25129882	MACS_peak_12894	517.97	230	0	1	0
22	27880875	27881118	MACS_peak_12898	501.16	243	0	1	0
22	29406094	29406250	MACS_peak_12912	1506.46	156	0	1	1
22	31345834	31346054	MACS_peak_12918	564.54	220	0	1	0
22	31687710	31688041	MACS_peak_12919	127.5	331	0	1	0
22	39514453	39514733	MACS_peak_12945	454.58	280	0	1	0
22	39529271	39529452	MACS_peak_12946	936.57	181	1	0	0
22	40372014	40372313	MACS_peak_12949	429.01	299	1	2	0
22	40487702	40487986	MACS_peak_12950	452.13	284	0	1	0
22	41125015	41125297	MACS_peak_12951	229.83	282	0	1	0
22	42253851	42254109	MACS_peak_12952	380.3	258	0	1	0
22	49874273	49874416	MACS_peak_12961	983.72	143	0	1	0
22	50273284	50273554	MACS_peak_12962	476.21	270	1	0	0
22	50276153	50276497	MACS_peak_12963	535.64	344	1	0	0
22	25057278	25057471	MACS_peak_22007	678.9	193	0	1	1
X	7132480	7132779	MACS_peak_22030	443.26	299	0	1	0
X	9791900	9792225	MACS_peak_22041	1104.73	325	0	1	0
X	9875077	9875236	MACS_peak_22042	485.23	159	0	1	0
X	14016832	14017083	MACS_peak_22064	356.87	251	0	1	0
X	16953446	16953660	MACS_peak_22081	1453.47	214	0	1	0
X	56871608	56871983	MACS_peak_22256	79.24	375	0	1	0
X	56879687	56880068	MACS_peak_22257	56.38	381	0	1	0
X	65528815	65529016	MACS_peak_22328	645.81	201	0	1	0
X	70365418	70365750	MACS_peak_22366	79.37	332	0	1	0
X	71516533	71516858	MACS_peak_22375	405.72	325	0	1	0
X	72271163	72271398	MACS_peak_22382	502.51	235	0	2	0
X	77739953	77740185	MACS_peak_22413	941.25	232	0	1	0
X	81147884	81148140	MACS_peak_22435	127.5	256	0	1	0
X	101439765	101440114	MACS_peak_22536	104.89	349	0	1	0
X	101474638	101474925	MACS_peak_22537	74.44	287	0	1	0
X	106768467	106768832	MACS_peak_22593	124.55	365	0	1	0
X	106788268	106788510	MACS_peak_22594	645.81	242	0	1	0
X	106788649	106788975	MACS_peak_22595	546.72	326	0	1	0
X	154051264	154051469	MACS_peak_22941	972.07	205	0	1	0
X	154129115	154129250	MACS_peak_22942	1554.14	135	0	1	0
X	154534807	154535060	MACS_peak_22949	470.06	253	1	0	0
